space_1,distinct_id,2,3,4,5,6,7,week_login_total
KLS3551 Kulturledelse,5698d6ac41a9d72100240122,0,0,1,0,0,0,1
KLS3551 Kulturledelse,5698d6ac2fb0de2600f225b2,0,0,1,0,1,0,2
KLS3551 Kulturledelse,5698d6a941a9d721002400f8,0,0,0,2,0,0,2
KLS3551 Kulturledelse,5698d6aa41a9d721002400ff,0,3,0,0,0,0,3
KLS3551 Kulturledelse,5698d6a841a9d721002400f6,0,1,0,2,0,0,3
KLS3551 Kulturledelse,5698d6ac2fb0de2600f225b5,0,0,1,3,0,0,4
KLS3551 Kulturledelse,5698d6a841a9d721002400f4,0,2,0,3,0,0,5
KLS3551 Kulturledelse,5698d6a82fb0de2600f22587,0,0,2,3,2,0,7
KLS3551 Kulturledelse,5698d6aa41a9d72100240100,0,1,3,3,0,0,7
KLS3551 Kulturledelse,5698d6aa41a9d72100240105,0,4,1,2,0,0,7
KLS3551 Kulturledelse,5698d6aa2fb0de2600f22594,0,0,4,1,3,0,8
KLS3551 Kulturledelse,5698d6a841a9d721002400f3,0,2,3,3,0,0,8
KLS3551 Kulturledelse,5698d6a82fb0de2600f22585,0,2,1,5,0,0,8
KLS3551 Kulturledelse,5698d6aa41a9d72100240101,0,4,1,4,0,0,9
KLS3551 Kulturledelse,5698d6ab41a9d7210024011b,0,3,4,2,0,0,9
KLS3551 Kulturledelse,5698d6aa2fb0de2600f22590,0,2,3,4,0,0,9
KLS3551 Kulturledelse,5698d6ac2fb0de2600f225b7,0,2,6,2,0,0,10
KLS3551 Kulturledelse,5698d6ab2fb0de2600f225b0,1,3,4,0,2,0,10
KLS3551 Kulturledelse,5698d6ac41a9d72100240129,1,2,3,4,1,0,11
KLS3551 Kulturledelse,5698d6ac41a9d72100240123,0,4,2,3,2,0,11
KLS3551 Kulturledelse,5698d6ac41a9d7210024011e,0,1,4,4,2,0,11
KLS3551 Kulturledelse,5698d6a82fb0de2600f22589,2,3,2,4,1,0,12
KLS3551 Kulturledelse,5698d6a841a9d721002400f5,0,5,4,4,0,0,13
KLS3551 Kulturledelse,5698d6ac41a9d72100240120,0,3,3,6,1,0,13
KLS3551 Kulturledelse,5698d6ab2fb0de2600f225ad,2,6,1,3,1,0,13
KLS3551 Kulturledelse,5698d6ac2fb0de2600f225b3,0,3,0,8,3,0,14
KLS3551 Kulturledelse,5698d6aa2fb0de2600f22591,1,5,2,4,2,0,14
KLS3551 Kulturledelse,5698d6aa41a9d72100240102,0,2,4,8,0,0,14
KLS3551 Kulturledelse,5698d6a92fb0de2600f2258c,0,5,4,5,3,0,17
KLS3551 Kulturledelse,5698d6ab41a9d7210024011d,0,1,6,8,2,0,17
KLS3551 Kulturledelse,5698d6ac2fb0de2600f225bc,3,1,1,10,5,0,20
KLS3551 Kulturledelse,5698d6a82fb0de2600f22586,0,9,5,6,1,0,21
KLS3551 Kulturledelse,5698d6aa2fb0de2600f22592,2,5,6,5,3,0,21
KLS3551 Kulturledelse,5698d6ac41a9d72100240121,0,4,11,10,0,0,25
KLS3551 Kulturledelse,5698d6ab2fb0de2600f225b1,2,5,7,6,5,0,25
KLS3551 Kulturledelse,5698d6aa2fb0de2600f22598,0,10,16,12,4,0,42
MRK3480 Forbrukeratferd,5698da5a2fb0de2600f22a71,0,1,0,0,0,0,1
MRK3480 Forbrukeratferd,5698da712fb0de2600f22b94,0,0,0,0,1,0,1
MRK3480 Forbrukeratferd,5698da692fb0de2600f22b3b,0,0,1,0,0,0,1
MRK3480 Forbrukeratferd,5698da4b41a9d721002406e1,0,0,0,0,1,0,1
MRK3480 Forbrukeratferd,5698da5041a9d72100240716,0,0,0,1,0,0,1
MRK3480 Forbrukeratferd,5698da642fb0de2600f22af7,0,0,0,1,0,0,1
MRK3480 Forbrukeratferd,56b31a1bd4d43f260091a6c9,0,0,0,0,1,0,1
MRK3480 Forbrukeratferd,5698da6941a9d72100240924,0,0,1,0,0,0,1
MRK3480 Forbrukeratferd,5698da5141a9d7210024072f,0,0,0,0,1,0,1
MRK3480 Forbrukeratferd,5698da5c2fb0de2600f22a96,0,0,0,1,0,0,1
MRK3480 Forbrukeratferd,5698da4c41a9d721002406ea,0,1,0,0,0,0,1
MRK3480 Forbrukeratferd,5698da7741a9d721002409c5,0,0,1,0,0,0,1
MRK3480 Forbrukeratferd,5698da5f41a9d721002407ce,0,0,1,0,0,0,1
MRK3480 Forbrukeratferd,5698da4c41a9d721002406e7,0,1,0,0,0,0,1
MRK3480 Forbrukeratferd,5698da482fb0de2600f229a4,0,0,1,0,0,0,1
MRK3480 Forbrukeratferd,5698da7a41a9d721002409e8,0,0,0,0,1,0,1
MRK3480 Forbrukeratferd,5698da4f2fb0de2600f229f8,0,1,0,0,0,0,1
MRK3480 Forbrukeratferd,5698da622fb0de2600f22ae9,0,0,1,0,0,0,1
MRK3480 Forbrukeratferd,5698da7a41a9d721002409e9,0,0,0,0,1,0,1
MRK3480 Forbrukeratferd,5698da522fb0de2600f22a1a,0,1,0,0,0,0,1
MRK3480 Forbrukeratferd,5698da632fb0de2600f22af0,0,1,0,0,0,0,1
MRK3480 Forbrukeratferd,5698da7141a9d7210024097e,0,0,0,1,0,0,1
MRK3480 Forbrukeratferd,5698da5341a9d7210024073a,0,0,1,0,0,0,1
MRK3480 Forbrukeratferd,5698da5f41a9d721002407d1,0,0,1,0,0,0,1
MRK3480 Forbrukeratferd,5698da7041a9d72100240970,1,0,0,0,0,0,1
MRK3480 Forbrukeratferd,5698da4541a9d72100240696,0,0,1,0,0,0,1
MRK3480 Forbrukeratferd,5698da5141a9d7210024072e,0,0,2,0,0,0,2
MRK3480 Forbrukeratferd,5698da542fb0de2600f22a3e,0,1,0,1,0,0,2
MRK3480 Forbrukeratferd,5698da5c2fb0de2600f22a97,0,0,2,0,0,0,2
MRK3480 Forbrukeratferd,5698da632fb0de2600f22aef,0,0,0,0,2,0,2
MRK3480 Forbrukeratferd,5698da4a2fb0de2600f229c2,0,2,0,0,0,0,2
MRK3480 Forbrukeratferd,5698da6e2fb0de2600f22b73,0,0,0,0,2,0,2
MRK3480 Forbrukeratferd,5698da5a2fb0de2600f22a74,0,0,0,2,0,0,2
MRK3480 Forbrukeratferd,5698da522fb0de2600f22a17,0,1,1,0,0,0,2
MRK3480 Forbrukeratferd,5698da6441a9d721002408e3,0,0,1,0,1,0,2
MRK3480 Forbrukeratferd,5698da712fb0de2600f22b8f,0,1,0,1,0,0,2
MRK3480 Forbrukeratferd,5698da7a2fb0de2600f22c0a,0,0,2,0,0,0,2
MRK3480 Forbrukeratferd,5698da632fb0de2600f22aee,0,2,0,0,0,0,2
MRK3480 Forbrukeratferd,5698da7741a9d721002409ca,0,0,0,0,2,0,2
MRK3480 Forbrukeratferd,5698da7b41a9d721002409f3,0,1,1,0,0,0,2
MRK3480 Forbrukeratferd,5698da6e41a9d72100240956,0,0,1,1,0,0,2
MRK3480 Forbrukeratferd,5698da582fb0de2600f22a6b,1,1,0,0,0,0,2
MRK3480 Forbrukeratferd,5698da692fb0de2600f22b3c,0,1,0,0,1,0,2
MRK3480 Forbrukeratferd,5698da5341a9d72100240738,0,1,0,1,0,0,2
MRK3480 Forbrukeratferd,5698da4b2fb0de2600f229c5,0,2,0,0,0,0,2
MRK3480 Forbrukeratferd,5698da492fb0de2600f229a8,0,2,0,0,0,0,2
MRK3480 Forbrukeratferd,5698da512fb0de2600f22a12,0,0,1,0,1,0,2
MRK3480 Forbrukeratferd,5698da7541a9d7210024099f,1,1,0,0,0,0,2
MRK3480 Forbrukeratferd,5698da6f2fb0de2600f22b8a,1,0,1,0,0,0,2
MRK3480 Forbrukeratferd,5698da552fb0de2600f22a3f,0,0,1,1,0,0,2
MRK3480 Forbrukeratferd,5698da522fb0de2600f22a1c,0,1,1,0,0,0,2
MRK3480 Forbrukeratferd,5698da4b41a9d721002406e0,0,1,1,0,0,0,2
MRK3480 Forbrukeratferd,5698da472fb0de2600f2299c,0,1,0,0,1,0,2
MRK3480 Forbrukeratferd,56a6b09c37f619210097cc6a,0,0,1,0,1,0,2
MRK3480 Forbrukeratferd,5698da452fb0de2600f22972,0,0,1,0,1,0,2
MRK3480 Forbrukeratferd,5698da6641a9d721002408fe,0,0,0,0,3,0,3
MRK3480 Forbrukeratferd,5698da7141a9d7210024097c,0,2,1,0,0,0,3
MRK3480 Forbrukeratferd,5698da6c41a9d72100240948,1,0,2,0,0,0,3
MRK3480 Forbrukeratferd,5698da5241a9d72100240736,0,0,2,0,1,0,3
MRK3480 Forbrukeratferd,5698da562fb0de2600f22a4b,0,2,0,0,1,0,3
MRK3480 Forbrukeratferd,5698da4e2fb0de2600f229ec,0,1,1,1,0,0,3
MRK3480 Forbrukeratferd,5698da6041a9d721002407d3,0,1,1,0,1,0,3
MRK3480 Forbrukeratferd,5698da4d41a9d72100240706,0,3,0,0,0,0,3
MRK3480 Forbrukeratferd,56a8ed7d29028e2600913141,0,0,1,2,0,0,3
MRK3480 Forbrukeratferd,5698da6941a9d72100240925,0,0,2,0,1,0,3
MRK3480 Forbrukeratferd,5698da712fb0de2600f22b93,0,0,3,0,0,0,3
MRK3480 Forbrukeratferd,5698da652fb0de2600f22b12,0,1,2,0,0,0,3
MRK3480 Forbrukeratferd,5698da5b41a9d7210024079f,0,0,2,1,0,0,3
MRK3480 Forbrukeratferd,5698da4c2fb0de2600f229cc,0,0,3,0,0,0,3
MRK3480 Forbrukeratferd,5698da4f2fb0de2600f229fb,0,0,3,0,0,0,3
MRK3480 Forbrukeratferd,5698da5841a9d72100240777,1,1,0,1,0,0,3
MRK3480 Forbrukeratferd,5698da7141a9d7210024097a,1,1,1,0,0,0,3
MRK3480 Forbrukeratferd,5698da6e41a9d72100240954,0,1,1,1,0,0,3
MRK3480 Forbrukeratferd,5698da742fb0de2600f22bbc,0,1,0,2,0,0,3
MRK3480 Forbrukeratferd,5698da6e41a9d72100240958,0,3,0,0,0,0,3
MRK3480 Forbrukeratferd,5698da5941a9d7210024077b,1,0,2,0,0,0,3
MRK3480 Forbrukeratferd,5698da5541a9d7210024075d,0,2,0,0,1,0,3
MRK3480 Forbrukeratferd,5698da5f41a9d721002407d0,0,0,3,0,0,0,3
MRK3480 Forbrukeratferd,5698da5b41a9d721002407a0,1,1,1,0,0,0,3
MRK3480 Forbrukeratferd,5698da6e2fb0de2600f22b6f,0,0,0,1,2,0,3
MRK3480 Forbrukeratferd,5698da4b2fb0de2600f229c9,0,1,0,1,2,0,4
MRK3480 Forbrukeratferd,5698da7a2fb0de2600f22c07,0,0,1,3,0,0,4
MRK3480 Forbrukeratferd,5698da6341a9d721002408cf,0,2,1,1,0,0,4
MRK3480 Forbrukeratferd,5698da5b41a9d721002407a1,0,0,1,3,0,0,4
MRK3480 Forbrukeratferd,5698da5d41a9d721002407b8,0,0,3,0,1,0,4
MRK3480 Forbrukeratferd,5698da472fb0de2600f2299b,0,1,2,0,1,0,4
MRK3480 Forbrukeratferd,5698da6a2fb0de2600f22b44,0,0,4,0,0,0,4
MRK3480 Forbrukeratferd,5698da4a41a9d721002406de,0,0,4,0,0,0,4
MRK3480 Forbrukeratferd,5698da7841a9d721002409d0,0,1,2,1,0,0,4
MRK3480 Forbrukeratferd,5698da772fb0de2600f22bde,0,3,1,0,0,0,4
MRK3480 Forbrukeratferd,5698da452fb0de2600f22973,2,0,1,0,1,0,4
MRK3480 Forbrukeratferd,5698da5941a9d7210024078d,0,2,2,0,0,0,4
MRK3480 Forbrukeratferd,5698da592fb0de2600f22a70,1,2,0,0,1,0,4
MRK3480 Forbrukeratferd,5698da452fb0de2600f2297b,0,1,2,0,1,0,4
MRK3480 Forbrukeratferd,5698da4641a9d72100240698,0,1,2,0,1,0,4
MRK3480 Forbrukeratferd,5698da5541a9d7210024075e,0,0,0,1,3,0,4
MRK3480 Forbrukeratferd,5698da6341a9d721002408ce,0,1,3,0,0,0,4
MRK3480 Forbrukeratferd,5698da4541a9d72100240694,0,0,2,1,1,0,4
MRK3480 Forbrukeratferd,5698da732fb0de2600f22bb4,1,0,3,0,0,0,4
MRK3480 Forbrukeratferd,5698da532fb0de2600f22a1f,0,1,2,0,1,0,4
MRK3480 Forbrukeratferd,5698da4b2fb0de2600f229c6,0,2,1,0,1,0,4
MRK3480 Forbrukeratferd,5698da6841a9d7210024090c,1,0,1,1,1,0,4
MRK3480 Forbrukeratferd,5698da732fb0de2600f22bb3,0,0,3,0,1,0,4
MRK3480 Forbrukeratferd,5698da482fb0de2600f229a3,0,0,1,0,3,0,4
MRK3480 Forbrukeratferd,5698da7a2fb0de2600f22c08,0,2,0,0,2,0,4
MRK3480 Forbrukeratferd,5698da6a41a9d72100240934,0,0,3,1,0,0,4
MRK3480 Forbrukeratferd,5698da4741a9d721002406b6,0,1,2,1,0,0,4
MRK3480 Forbrukeratferd,5698d6aa2fb0de2600f22592,0,1,2,0,1,0,4
MRK3480 Forbrukeratferd,5698da452fb0de2600f22974,0,1,1,1,1,0,4
MRK3480 Forbrukeratferd,5698da7141a9d72100240980,0,2,2,0,0,0,4
MRK3480 Forbrukeratferd,5698da7541a9d721002409a3,2,2,0,0,0,0,4
MRK3480 Forbrukeratferd,5698da4f41a9d72100240710,1,1,2,0,0,0,4
MRK3480 Forbrukeratferd,5698da6c2fb0de2600f22b66,0,1,1,1,1,0,4
MRK3480 Forbrukeratferd,5698da542fb0de2600f22a3a,0,5,0,0,0,0,5
MRK3480 Forbrukeratferd,5698da772fb0de2600f22be0,0,3,1,0,1,0,5
MRK3480 Forbrukeratferd,5698da6c41a9d72100240947,0,1,2,0,2,0,5
MRK3480 Forbrukeratferd,5698da6e41a9d72100240957,0,1,2,2,0,0,5
MRK3480 Forbrukeratferd,5698da4b2fb0de2600f229c4,2,0,2,1,0,0,5
MRK3480 Forbrukeratferd,5698da662fb0de2600f22b19,0,3,2,0,0,0,5
MRK3480 Forbrukeratferd,5698da4941a9d721002406c1,0,1,4,0,0,0,5
MRK3480 Forbrukeratferd,5698da5641a9d7210024076b,0,4,1,0,0,0,5
MRK3480 Forbrukeratferd,5698da4f2fb0de2600f229f9,0,1,1,3,0,0,5
MRK3480 Forbrukeratferd,5698da5c41a9d721002407a6,0,1,0,2,2,0,5
MRK3480 Forbrukeratferd,5698da7741a9d721002409c4,3,0,1,1,0,0,5
MRK3480 Forbrukeratferd,5698da712fb0de2600f22b8d,1,2,1,1,0,0,5
MRK3480 Forbrukeratferd,5698da492fb0de2600f229a9,1,1,1,2,0,0,5
MRK3480 Forbrukeratferd,5698da4541a9d72100240690,0,1,2,0,2,0,5
MRK3480 Forbrukeratferd,5698da5a2fb0de2600f22a7a,0,2,1,1,1,0,5
MRK3480 Forbrukeratferd,5698da6241a9d721002408cb,0,1,1,0,3,0,5
MRK3480 Forbrukeratferd,5698da5c41a9d721002407a3,0,1,1,0,3,0,5
MRK3480 Forbrukeratferd,5698da6241a9d721002408cc,0,2,1,0,2,0,5
MRK3480 Forbrukeratferd,5698da6e41a9d72100240955,0,0,5,0,0,0,5
MRK3480 Forbrukeratferd,5698da622fb0de2600f22ae6,0,2,2,1,0,0,5
MRK3480 Forbrukeratferd,5698da742fb0de2600f22bc2,0,1,2,2,0,0,5
MRK3480 Forbrukeratferd,5698da7741a9d721002409c2,0,3,2,0,0,0,5
MRK3480 Forbrukeratferd,5698da5a2fb0de2600f22a72,0,3,2,0,0,0,5
MRK3480 Forbrukeratferd,5698da6441a9d721002408e0,0,3,0,1,1,0,5
MRK3480 Forbrukeratferd,5698da7b2fb0de2600f22c15,0,1,2,1,1,0,5
MRK3480 Forbrukeratferd,5698da7541a9d721002409a1,0,3,1,1,1,0,6
MRK3480 Forbrukeratferd,5698da712fb0de2600f22b8e,0,4,1,0,1,0,6
MRK3480 Forbrukeratferd,5698da5041a9d72100240714,0,0,4,1,1,0,6
MRK3480 Forbrukeratferd,5698da732fb0de2600f22bb5,0,1,1,1,3,0,6
MRK3480 Forbrukeratferd,5698da732fb0de2600f22bba,0,3,1,0,2,0,6
MRK3480 Forbrukeratferd,5698da4c2fb0de2600f229d2,0,1,4,0,1,0,6
MRK3480 Forbrukeratferd,5698da6041a9d721002407e5,0,1,3,0,2,0,6
MRK3480 Forbrukeratferd,5698da772fb0de2600f22bdf,0,1,4,0,1,0,6
MRK3480 Forbrukeratferd,5698da4541a9d72100240692,0,1,4,1,0,0,6
MRK3480 Forbrukeratferd,5698da452fb0de2600f22977,2,1,2,0,1,0,6
MRK3480 Forbrukeratferd,5698da602fb0de2600f22ac9,0,2,2,1,1,0,6
MRK3480 Forbrukeratferd,5698da5e2fb0de2600f22ab6,0,2,4,1,0,0,7
MRK3480 Forbrukeratferd,5698da6d41a9d72100240952,0,1,5,1,0,0,7
MRK3480 Forbrukeratferd,5698da6941a9d72100240923,0,1,3,0,3,0,7
MRK3480 Forbrukeratferd,5698da6c2fb0de2600f22b62,0,2,5,0,0,0,7
MRK3480 Forbrukeratferd,5698da7141a9d7210024097f,0,1,4,0,2,0,7
MRK3480 Forbrukeratferd,5698da6641a9d721002408fc,1,0,2,1,3,0,7
MRK3480 Forbrukeratferd,5698da782fb0de2600f22bf5,0,2,4,1,0,0,7
MRK3480 Forbrukeratferd,5698da612fb0de2600f22ace,0,4,1,2,0,0,7
MRK3480 Forbrukeratferd,5698da5541a9d72100240758,0,4,0,1,2,0,7
MRK3480 Forbrukeratferd,5698da6941a9d72100240922,0,2,2,1,2,0,7
MRK3480 Forbrukeratferd,5698da5941a9d7210024077c,0,2,0,1,4,0,7
MRK3480 Forbrukeratferd,5698da492fb0de2600f229a5,0,3,2,1,1,0,7
MRK3480 Forbrukeratferd,5698da6641a9d721002408fd,0,2,3,2,0,0,7
MRK3480 Forbrukeratferd,5698da792fb0de2600f22c02,0,2,4,1,0,0,7
MRK3480 Forbrukeratferd,5698da5241a9d72100240735,0,1,4,0,2,0,7
MRK3480 Forbrukeratferd,5698da452fb0de2600f22979,1,1,1,2,2,0,7
MRK3480 Forbrukeratferd,5698da5441a9d72100240756,0,2,3,1,1,0,7
MRK3480 Forbrukeratferd,5698da5841a9d72100240778,1,1,3,1,1,0,7
MRK3480 Forbrukeratferd,5698da4c41a9d721002406e6,0,7,0,0,0,0,7
MRK3480 Forbrukeratferd,5698da7541a9d721002409a2,0,1,5,1,0,0,7
MRK3480 Forbrukeratferd,5698da712fb0de2600f22b91,0,3,4,0,0,0,7
MRK3480 Forbrukeratferd,5698da6041a9d721002407e4,0,2,0,2,4,0,8
MRK3480 Forbrukeratferd,5698da4641a9d721002406a9,0,3,4,1,0,0,8
MRK3480 Forbrukeratferd,5698da742fb0de2600f22bc1,0,4,3,1,0,0,8
MRK3480 Forbrukeratferd,5698da5041a9d72100240717,0,3,2,0,3,0,8
MRK3480 Forbrukeratferd,5698da4341a9d7210024068e,0,3,2,3,0,0,8
MRK3480 Forbrukeratferd,5698da532fb0de2600f22a1e,2,0,5,1,0,0,8
MRK3480 Forbrukeratferd,5698da6b2fb0de2600f22b4b,0,1,3,2,2,0,8
MRK3480 Forbrukeratferd,5698da4c41a9d721002406e4,0,7,1,0,0,0,8
MRK3480 Forbrukeratferd,5698da522fb0de2600f22a19,0,6,1,0,1,0,8
MRK3480 Forbrukeratferd,5698da692fb0de2600f22b3d,1,1,6,0,0,0,8
MRK3480 Forbrukeratferd,5698da4b2fb0de2600f229c8,0,7,0,0,1,0,8
MRK3480 Forbrukeratferd,5698da542fb0de2600f22a3b,0,4,1,0,3,0,8
MRK3480 Forbrukeratferd,5698da4e2fb0de2600f229ea,0,1,4,3,0,0,8
MRK3480 Forbrukeratferd,5698da7841a9d721002409d2,0,2,5,0,1,0,8
MRK3480 Forbrukeratferd,5698da4841a9d721002406bf,1,2,2,1,2,0,8
MRK3480 Forbrukeratferd,5698da4841a9d721002406be,0,3,4,0,1,0,8
MRK3480 Forbrukeratferd,5698da762fb0de2600f22bda,0,2,3,1,3,0,9
MRK3480 Forbrukeratferd,5698da602fb0de2600f22ac7,2,0,0,4,3,0,9
MRK3480 Forbrukeratferd,5698da4941a9d721002406c4,0,0,3,3,3,0,9
MRK3480 Forbrukeratferd,5698da5d2fb0de2600f22a9c,0,1,5,1,2,0,9
MRK3480 Forbrukeratferd,5698da5a2fb0de2600f22a78,0,1,4,3,1,0,9
MRK3480 Forbrukeratferd,5698da5e2fb0de2600f22aa2,0,6,0,1,2,0,9
MRK3480 Forbrukeratferd,5698da572fb0de2600f22a52,1,1,2,3,2,0,9
MRK3480 Forbrukeratferd,5698da4c2fb0de2600f229ce,1,1,4,1,2,0,9
MRK3480 Forbrukeratferd,5698da7a2fb0de2600f22c09,0,4,3,1,1,0,9
MRK3480 Forbrukeratferd,5698da642fb0de2600f22afa,0,1,6,1,1,0,9
MRK3480 Forbrukeratferd,5698da5f41a9d721002407cd,0,1,4,2,2,0,9
MRK3480 Forbrukeratferd,5698da602fb0de2600f22ac5,2,0,5,0,2,0,9
MRK3480 Forbrukeratferd,5698da6a41a9d72100240928,0,2,3,2,2,0,9
MRK3480 Forbrukeratferd,5698da472fb0de2600f2299a,1,2,3,1,2,0,9
MRK3480 Forbrukeratferd,5698da6741a9d72100240900,0,3,1,3,3,0,10
MRK3480 Forbrukeratferd,5698da682fb0de2600f22b25,0,4,6,0,0,0,10
MRK3480 Forbrukeratferd,5698da512fb0de2600f22a13,5,2,3,0,0,0,10
MRK3480 Forbrukeratferd,5698da692fb0de2600f22b3e,0,4,2,4,0,0,10
MRK3480 Forbrukeratferd,5698da712fb0de2600f22b92,1,3,3,2,1,0,10
MRK3480 Forbrukeratferd,5698da7a2fb0de2600f22c06,0,3,4,1,2,0,10
MRK3480 Forbrukeratferd,5698da4e2fb0de2600f229eb,0,3,3,4,0,0,10
MRK3480 Forbrukeratferd,5698da5341a9d7210024073b,2,2,4,1,1,0,10
MRK3480 Forbrukeratferd,5698da562fb0de2600f22a50,1,3,5,0,1,0,10
MRK3480 Forbrukeratferd,5698da4b41a9d721002406e2,0,2,3,0,5,0,10
MRK3480 Forbrukeratferd,5698da782fb0de2600f22bef,0,2,4,1,3,0,10
MRK3480 Forbrukeratferd,5698da6841a9d7210024091f,0,3,4,0,3,0,10
MRK3480 Forbrukeratferd,5698da4541a9d72100240695,1,2,3,1,3,0,10
MRK3480 Forbrukeratferd,5698da6f41a9d7210024096f,2,6,1,1,0,0,10
MRK3480 Forbrukeratferd,5698da7241a9d72100240997,1,4,2,1,2,0,10
MRK3480 Forbrukeratferd,5698da592fb0de2600f22a6d,0,2,8,0,0,0,10
MRK3480 Forbrukeratferd,5698da672fb0de2600f22b1f,3,1,1,3,2,0,10
MRK3480 Forbrukeratferd,5698da672fb0de2600f22b1d,1,4,0,4,1,0,10
MRK3480 Forbrukeratferd,5698da7041a9d72100240971,0,0,5,3,3,0,11
MRK3480 Forbrukeratferd,5698da6a2fb0de2600f22b45,1,2,4,1,3,0,11
MRK3480 Forbrukeratferd,5698da492fb0de2600f229a7,0,2,4,2,3,0,11
MRK3480 Forbrukeratferd,5698da5541a9d72100240759,0,2,4,3,2,0,11
MRK3480 Forbrukeratferd,56a6b0275d52c7250022aa27,0,0,4,6,1,0,11
MRK3480 Forbrukeratferd,5698da732fb0de2600f22bb2,1,1,2,4,3,0,11
MRK3480 Forbrukeratferd,5698da5f2fb0de2600f22ac2,0,6,4,1,0,0,11
MRK3480 Forbrukeratferd,5698da4e41a9d72100240709,1,1,4,2,3,0,11
MRK3480 Forbrukeratferd,5698da6741a9d72100240904,1,4,5,0,2,0,12
MRK3480 Forbrukeratferd,5698da492fb0de2600f229a6,0,3,4,5,0,0,12
MRK3480 Forbrukeratferd,5698da7341a9d72100240999,1,5,5,0,1,0,12
MRK3480 Forbrukeratferd,5698da4f2fb0de2600f229f7,0,5,3,3,1,0,12
MRK3480 Forbrukeratferd,5698da4e41a9d72100240707,1,3,6,2,0,0,12
MRK3480 Forbrukeratferd,5698da452fb0de2600f22978,1,2,4,2,3,0,12
MRK3480 Forbrukeratferd,5698da742fb0de2600f22bbe,2,1,3,3,3,0,12
MRK3480 Forbrukeratferd,5698da5841a9d72100240779,0,5,4,1,2,0,12
MRK3480 Forbrukeratferd,5698da7741a9d721002409c6,0,2,0,3,7,0,12
MRK3480 Forbrukeratferd,5698da6341a9d721002408d0,1,2,2,2,5,0,12
MRK3480 Forbrukeratferd,5698da7041a9d72100240972,1,3,7,2,0,0,13
MRK3480 Forbrukeratferd,5698da5841a9d72100240776,0,2,4,2,5,0,13
MRK3480 Forbrukeratferd,5698da7541a9d721002409a0,0,1,4,6,2,0,13
MRK3480 Forbrukeratferd,5698da5c41a9d721002407a7,0,5,5,2,1,0,13
MRK3480 Forbrukeratferd,5698da4941a9d721002406c3,6,3,3,1,0,0,13
MRK3480 Forbrukeratferd,5698da6341a9d721002408cd,0,2,5,3,3,0,13
MRK3480 Forbrukeratferd,5698da542fb0de2600f22a3c,2,4,2,3,2,0,13
MRK3480 Forbrukeratferd,5698da4941a9d721002406c2,3,3,1,1,5,0,13
MRK3480 Forbrukeratferd,5698da5b2fb0de2600f22a88,3,2,3,3,2,0,13
MRK3480 Forbrukeratferd,5698da6441a9d721002408e4,0,4,6,1,2,0,13
MRK3480 Forbrukeratferd,5698da6b2fb0de2600f22b4d,1,8,3,2,0,0,14
MRK3480 Forbrukeratferd,5698da5e41a9d721002407cb,2,2,7,1,2,0,14
MRK3480 Forbrukeratferd,5698da4f41a9d7210024070f,0,2,3,6,3,0,14
MRK3480 Forbrukeratferd,5698da7a41a9d721002409ea,0,3,6,2,3,0,14
MRK3480 Forbrukeratferd,5698da642fb0de2600f22af5,0,6,8,1,0,0,15
MRK3480 Forbrukeratferd,5698da4c41a9d721002406ec,3,4,5,1,2,0,15
MRK3480 Forbrukeratferd,5698da5e2fb0de2600f22aa3,1,6,7,0,1,0,15
MRK3480 Forbrukeratferd,5698da6e2fb0de2600f22b71,7,2,3,3,0,0,15
MRK3480 Forbrukeratferd,5698da542fb0de2600f22a3d,2,3,3,7,1,0,16
MRK3480 Forbrukeratferd,5698da6341a9d721002408db,2,5,6,2,1,0,16
MRK3480 Forbrukeratferd,5698da612fb0de2600f22acd,2,5,3,3,3,0,16
MRK3480 Forbrukeratferd,5698da5241a9d72100240733,0,7,5,0,4,0,16
MRK3480 Forbrukeratferd,5698da6e2fb0de2600f22b74,2,4,4,3,3,0,16
MRK3480 Forbrukeratferd,5698da4541a9d72100240693,3,5,4,1,3,0,16
MRK3480 Forbrukeratferd,5698da7a41a9d721002409e7,0,8,1,4,3,0,16
MRK3480 Forbrukeratferd,5698da682fb0de2600f22b24,0,4,7,0,6,0,17
MRK3480 Forbrukeratferd,5698da6b2fb0de2600f22b4c,0,3,9,1,4,0,17
MRK3480 Forbrukeratferd,5698da7b41a9d721002409f6,1,9,3,4,0,0,17
MRK3480 Forbrukeratferd,5698da522fb0de2600f22a1d,1,9,4,3,0,0,17
MRK3480 Forbrukeratferd,5698da4c2fb0de2600f229cb,0,8,4,2,3,0,17
MRK3480 Forbrukeratferd,5698da6641a9d721002408fb,0,3,4,3,7,0,17
MRK3480 Forbrukeratferd,5698da4f2fb0de2600f229fa,3,4,4,4,3,0,18
MRK3480 Forbrukeratferd,5698da6541a9d721002408fa,2,5,4,4,3,0,18
MRK3480 Forbrukeratferd,5698da5541a9d7210024075a,0,11,3,3,2,0,19
MRK3480 Forbrukeratferd,5698da7741a9d721002409c3,0,6,6,3,4,0,19
MRK3480 Forbrukeratferd,5698da4541a9d72100240691,1,10,4,2,2,0,19
MRK3480 Forbrukeratferd,5698da712fb0de2600f22b90,0,7,7,2,5,0,21
MRK3480 Forbrukeratferd,5698da6841a9d7210024090a,0,8,6,3,5,0,22
MRK3480 Forbrukeratferd,5698da772fb0de2600f22be4,2,8,5,4,4,0,23
MRK3480 Forbrukeratferd,5698da612fb0de2600f22acb,2,7,7,3,4,0,23
MRK3480 Forbrukeratferd,5698da562fb0de2600f22a4a,0,7,9,5,4,0,25
MRK3480 Forbrukeratferd,5698da602fb0de2600f22ac4,3,6,7,2,8,0,26
MRK3480 Forbrukeratferd,5698da662fb0de2600f22b15,2,3,10,6,6,0,27
MRK3480 Forbrukeratferd,5698da452fb0de2600f22976,0,6,9,7,5,0,27
MRK3480 Forbrukeratferd,5698da7a41a9d721002409ed,2,9,5,7,5,0,28
MRK3480 Forbrukeratferd,5698da5d2fb0de2600f22a9e,5,8,8,2,5,0,28
MRK3480 Forbrukeratferd,5698da6c2fb0de2600f22b64,4,7,4,12,2,0,29
MRK3480 Forbrukeratferd,5698da4e41a9d72100240708,1,13,6,5,6,0,31
ORG3402 Organisasjonsatferd og ledelse,5698db922fb0de2600f22fd3,0,0,0,0,1,0,1
ORG3402 Organisasjonsatferd og ledelse,5698db9041a9d72100240e58,0,0,0,1,0,0,1
ORG3402 Organisasjonsatferd og ledelse,5698dc512fb0de2600f232af,0,0,0,1,0,0,1
ORG3402 Organisasjonsatferd og ledelse,5698dc5141a9d721002410e1,0,0,0,0,1,0,1
ORG3402 Organisasjonsatferd og ledelse,5698db832fb0de2600f22f07,0,0,0,0,1,0,1
ORG3402 Organisasjonsatferd og ledelse,5698dc4f2fb0de2600f23293,0,0,1,0,0,0,1
ORG3402 Organisasjonsatferd og ledelse,5698dc412fb0de2600f231c9,0,0,1,0,0,0,1
ORG3402 Organisasjonsatferd og ledelse,5698db6f41a9d72100240cba,0,0,0,0,1,0,1
ORG3402 Organisasjonsatferd og ledelse,56bc6166ca1c4522006796ed,0,0,0,0,1,0,1
ORG3402 Organisasjonsatferd og ledelse,5698db7d2fb0de2600f22ec2,0,1,0,0,0,0,1
ORG3402 Organisasjonsatferd og ledelse,5698dc422fb0de2600f231d6,0,0,1,0,0,0,1
ORG3402 Organisasjonsatferd og ledelse,5698db902fb0de2600f22faf,0,0,0,1,0,0,1
ORG3402 Organisasjonsatferd og ledelse,5698db8941a9d72100240e00,0,0,1,0,0,0,1
ORG3402 Organisasjonsatferd og ledelse,5698db8e2fb0de2600f22f8a,0,0,0,0,1,0,1
ORG3402 Organisasjonsatferd og ledelse,5698db6a2fb0de2600f22dcd,1,0,0,0,0,0,1
ORG3402 Organisasjonsatferd og ledelse,56b061be29028e260091487e,0,0,0,0,1,0,1
ORG3402 Organisasjonsatferd og ledelse,5698dc422fb0de2600f231d8,1,0,0,0,0,0,1
ORG3402 Organisasjonsatferd og ledelse,5698dc4541a9d7210024103f,0,0,0,0,1,0,1
ORG3402 Organisasjonsatferd og ledelse,5698db8a41a9d72100240e04,0,1,0,0,0,0,1
ORG3402 Organisasjonsatferd og ledelse,5698dc3b41a9d72100240fcf,0,0,0,0,1,0,1
ORG3402 Organisasjonsatferd og ledelse,5698db952fb0de2600f22ff8,0,0,1,0,0,0,1
ORG3402 Organisasjonsatferd og ledelse,5698db852fb0de2600f22f13,1,0,0,0,0,0,1
ORG3402 Organisasjonsatferd og ledelse,5698dc5d2fb0de2600f23341,0,0,0,0,1,0,1
ORG3402 Organisasjonsatferd og ledelse,5698db8e2fb0de2600f22f87,0,0,0,1,0,0,1
ORG3402 Organisasjonsatferd og ledelse,5698dc3a41a9d72100240fc8,0,0,1,0,0,0,1
ORG3402 Organisasjonsatferd og ledelse,5698db8641a9d72100240dd6,0,0,0,0,1,0,1
ORG3402 Organisasjonsatferd og ledelse,5698dc4a2fb0de2600f23244,0,0,0,1,0,0,1
ORG3402 Organisasjonsatferd og ledelse,5698dc5e41a9d721002411a1,0,0,0,0,1,0,1
ORG3402 Organisasjonsatferd og ledelse,5698dc3b2fb0de2600f23183,0,0,0,1,0,0,1
ORG3402 Organisasjonsatferd og ledelse,5698dc4941a9d72100241088,0,1,0,0,0,0,1
ORG3402 Organisasjonsatferd og ledelse,5698dc4f2fb0de2600f23290,0,1,0,0,0,0,1
ORG3402 Organisasjonsatferd og ledelse,5698dc4a41a9d7210024108d,1,0,0,0,0,0,1
ORG3402 Organisasjonsatferd og ledelse,5698db792fb0de2600f22e93,0,0,0,1,0,0,1
ORG3402 Organisasjonsatferd og ledelse,5698dc3e41a9d72100240ff7,0,1,0,0,0,0,1
ORG3402 Organisasjonsatferd og ledelse,5698dc4341a9d72100241038,0,1,0,0,0,0,1
ORG3402 Organisasjonsatferd og ledelse,5698db8f41a9d72100240e4f,0,1,0,0,0,0,1
ORG3402 Organisasjonsatferd og ledelse,5698db612fb0de2600f22d5a,0,0,1,0,0,0,1
ORG3402 Organisasjonsatferd og ledelse,5698db7d41a9d72100240d5e,0,0,0,1,0,0,1
ORG3402 Organisasjonsatferd og ledelse,5698db672fb0de2600f22da6,0,0,0,1,0,0,1
ORG3402 Organisasjonsatferd og ledelse,5698db7141a9d72100240cc2,0,0,0,0,1,0,1
ORG3402 Organisasjonsatferd og ledelse,5698dc5441a9d72100241118,0,0,1,0,0,0,1
ORG3402 Organisasjonsatferd og ledelse,56b0c11fa55f242200a2e6f3,0,0,0,1,0,0,1
ORG3402 Organisasjonsatferd og ledelse,5698dc3d41a9d72100240fed,0,0,1,0,0,0,1
ORG3402 Organisasjonsatferd og ledelse,56bc4c2bca1c45220067964e,0,0,0,0,1,0,1
ORG3402 Organisasjonsatferd og ledelse,5698dc4e41a9d721002410bf,0,0,0,1,0,0,1
ORG3402 Organisasjonsatferd og ledelse,5698db712fb0de2600f22e23,0,1,0,0,0,0,1
ORG3402 Organisasjonsatferd og ledelse,5698dc4741a9d72100241065,1,0,0,0,0,0,1
ORG3402 Organisasjonsatferd og ledelse,5698db8141a9d72100240d98,0,0,0,0,1,0,1
ORG3402 Organisasjonsatferd og ledelse,5698da5541a9d72100240758,0,0,0,1,0,0,1
ORG3402 Organisasjonsatferd og ledelse,5698db722fb0de2600f22e41,0,0,0,0,1,0,1
ORG3402 Organisasjonsatferd og ledelse,5698db7241a9d72100240ce6,0,0,1,0,0,0,1
ORG3402 Organisasjonsatferd og ledelse,5698dc4d41a9d721002410b7,0,0,1,0,0,0,1
ORG3402 Organisasjonsatferd og ledelse,5698db7941a9d72100240d32,0,1,0,0,0,0,1
ORG3402 Organisasjonsatferd og ledelse,5698db9341a9d72100240e7e,0,0,1,0,0,0,1
ORG3402 Organisasjonsatferd og ledelse,56b9f7fcb1682626003620bf,0,0,0,0,1,0,1
ORG3402 Organisasjonsatferd og ledelse,5698db6041a9d72100240bf4,0,0,0,1,0,0,1
ORG3402 Organisasjonsatferd og ledelse,5698db612fb0de2600f22d53,0,0,1,0,0,0,1
ORG3402 Organisasjonsatferd og ledelse,5698dc382fb0de2600f2314b,0,1,0,0,0,0,1
ORG3402 Organisasjonsatferd og ledelse,5698dc572fb0de2600f232ef,0,0,1,0,0,0,1
ORG3402 Organisasjonsatferd og ledelse,5698db7c2fb0de2600f22eb9,0,1,0,0,0,0,1
ORG3402 Organisasjonsatferd og ledelse,5698dc3841a9d72100240fa0,0,0,0,1,0,0,1
ORG3402 Organisasjonsatferd og ledelse,5698db612fb0de2600f22d51,0,0,0,0,1,0,1
ORG3402 Organisasjonsatferd og ledelse,56ab96eb29028e2600913e42,0,0,0,1,0,0,1
ORG3402 Organisasjonsatferd og ledelse,5698db7d41a9d72100240d5f,0,0,1,0,0,0,1
ORG3402 Organisasjonsatferd og ledelse,5698db852fb0de2600f22f10,1,0,0,0,0,0,1
ORG3402 Organisasjonsatferd og ledelse,5698db7c2fb0de2600f22eb7,0,1,0,0,0,0,1
ORG3402 Organisasjonsatferd og ledelse,5698db882fb0de2600f22f3e,0,0,0,1,0,0,1
ORG3402 Organisasjonsatferd og ledelse,5698db8a41a9d72100240e07,0,0,0,1,0,0,1
ORG3402 Organisasjonsatferd og ledelse,5698db962fb0de2600f23000,0,0,0,0,1,0,1
ORG3402 Organisasjonsatferd og ledelse,56b893de457365210022d06b,0,0,0,0,1,0,1
ORG3402 Organisasjonsatferd og ledelse,56ab659e29028e2600913d57,0,0,0,1,0,0,1
ORG3402 Organisasjonsatferd og ledelse,5698dc522fb0de2600f232b9,0,0,0,0,1,0,1
ORG3402 Organisasjonsatferd og ledelse,56b8b74f457365210022d1ff,0,0,0,0,1,0,1
ORG3402 Organisasjonsatferd og ledelse,5698db6b2fb0de2600f22dee,0,1,0,0,0,0,1
ORG3402 Organisasjonsatferd og ledelse,5698dc3c41a9d72100240fe8,0,0,0,0,1,0,1
ORG3402 Organisasjonsatferd og ledelse,5698db6e2fb0de2600f22dfc,1,0,0,0,0,0,1
ORG3402 Organisasjonsatferd og ledelse,5698db712fb0de2600f22e22,0,0,1,0,0,0,1
ORG3402 Organisasjonsatferd og ledelse,5698db6e2fb0de2600f22dfb,0,0,0,1,0,0,1
ORG3402 Organisasjonsatferd og ledelse,5698db7e41a9d72100240d64,0,1,0,0,0,0,1
ORG3402 Organisasjonsatferd og ledelse,5698dc3e41a9d72100240ff0,0,1,0,0,0,0,1
ORG3402 Organisasjonsatferd og ledelse,5698dc3d2fb0de2600f231a1,0,0,2,0,0,0,2
ORG3402 Organisasjonsatferd og ledelse,5698db7241a9d72100240ce8,0,1,0,1,0,0,2
ORG3402 Organisasjonsatferd og ledelse,5698dc5a41a9d7210024115b,0,0,0,1,1,0,2
ORG3402 Organisasjonsatferd og ledelse,5698db9141a9d72100240e60,0,1,0,0,1,0,2
ORG3402 Organisasjonsatferd og ledelse,5698db9441a9d72100240e8b,0,0,0,0,2,0,2
ORG3402 Organisasjonsatferd og ledelse,5698dc5041a9d721002410e0,0,0,0,2,0,0,2
ORG3402 Organisasjonsatferd og ledelse,5698db9341a9d72100240e7b,0,1,1,0,0,0,2
ORG3402 Organisasjonsatferd og ledelse,5698dc4841a9d7210024106b,0,0,0,2,0,0,2
ORG3402 Organisasjonsatferd og ledelse,5698db942fb0de2600f22fe3,0,2,0,0,0,0,2
ORG3402 Organisasjonsatferd og ledelse,5698db702fb0de2600f22e1d,0,1,1,0,0,0,2
ORG3402 Organisasjonsatferd og ledelse,5698db8e41a9d72100240e35,1,0,1,0,0,0,2
ORG3402 Organisasjonsatferd og ledelse,5698dc582fb0de2600f2330d,0,0,0,2,0,0,2
ORG3402 Organisasjonsatferd og ledelse,5698dc5d2fb0de2600f23344,0,0,1,1,0,0,2
ORG3402 Organisasjonsatferd og ledelse,5698db752fb0de2600f22e66,0,1,0,1,0,0,2
ORG3402 Organisasjonsatferd og ledelse,5698db7e41a9d72100240d66,0,0,0,0,2,0,2
ORG3402 Organisasjonsatferd og ledelse,5698db762fb0de2600f22e6d,0,0,0,0,2,0,2
ORG3402 Organisasjonsatferd og ledelse,5698db632fb0de2600f22d78,0,2,0,0,0,0,2
ORG3402 Organisasjonsatferd og ledelse,5698dc412fb0de2600f231d5,0,0,0,2,0,0,2
ORG3402 Organisasjonsatferd og ledelse,5698dc3d2fb0de2600f2319f,0,0,0,1,1,0,2
ORG3402 Organisasjonsatferd og ledelse,5698dc442fb0de2600f231ee,0,0,2,0,0,0,2
ORG3402 Organisasjonsatferd og ledelse,5698db642fb0de2600f22d83,0,0,0,0,2,0,2
ORG3402 Organisasjonsatferd og ledelse,5698db6b41a9d72100240c75,0,0,0,1,1,0,2
ORG3402 Organisasjonsatferd og ledelse,5698dc5c2fb0de2600f23339,0,0,1,1,0,0,2
ORG3402 Organisasjonsatferd og ledelse,5698db732fb0de2600f22e44,0,1,0,0,1,0,2
ORG3402 Organisasjonsatferd og ledelse,5698db902fb0de2600f22fad,2,0,0,0,0,0,2
ORG3402 Organisasjonsatferd og ledelse,5698db6241a9d72100240c19,0,0,0,2,0,0,2
ORG3402 Organisasjonsatferd og ledelse,5698dc4541a9d72100241040,0,1,0,1,0,0,2
ORG3402 Organisasjonsatferd og ledelse,5698dc4841a9d7210024106a,0,0,1,1,0,0,2
ORG3402 Organisasjonsatferd og ledelse,5698da4e41a9d72100240708,0,0,0,0,2,0,2
ORG3402 Organisasjonsatferd og ledelse,5698db8741a9d72100240dda,0,0,1,0,1,0,2
ORG3402 Organisasjonsatferd og ledelse,5698db612fb0de2600f22d59,0,1,0,1,0,0,2
ORG3402 Organisasjonsatferd og ledelse,5698dc4941a9d7210024108b,0,0,0,1,1,0,2
ORG3402 Organisasjonsatferd og ledelse,5698db6641a9d72100240c47,0,0,0,2,0,0,2
ORG3402 Organisasjonsatferd og ledelse,5698db9341a9d72100240e75,0,1,1,0,0,0,2
ORG3402 Organisasjonsatferd og ledelse,5698db8a41a9d72100240e05,0,0,2,0,0,0,2
ORG3402 Organisasjonsatferd og ledelse,5698db8b2fb0de2600f22f62,0,0,1,0,1,0,2
ORG3402 Organisasjonsatferd og ledelse,5698dc3941a9d72100240fc0,0,0,0,1,1,0,2
ORG3402 Organisasjonsatferd og ledelse,5698db7441a9d72100240ceb,0,0,0,1,1,0,2
ORG3402 Organisasjonsatferd og ledelse,5698dc542fb0de2600f232c2,0,1,0,1,0,0,2
ORG3402 Organisasjonsatferd og ledelse,5698db792fb0de2600f22e92,0,1,0,0,1,0,2
ORG3402 Organisasjonsatferd og ledelse,5698dc4641a9d72100241061,0,0,0,1,1,0,2
ORG3402 Organisasjonsatferd og ledelse,5698dc4e41a9d721002410b8,0,0,0,2,0,0,2
ORG3402 Organisasjonsatferd og ledelse,5698db6041a9d72100240bf5,0,0,0,2,0,0,2
ORG3402 Organisasjonsatferd og ledelse,5698db7f2fb0de2600f22edf,0,2,0,0,0,0,2
ORG3402 Organisasjonsatferd og ledelse,5698dc4841a9d72100241069,0,0,2,0,0,0,2
ORG3402 Organisasjonsatferd og ledelse,5698dc542fb0de2600f232c9,0,0,2,0,0,0,2
ORG3402 Organisasjonsatferd og ledelse,5698dc552fb0de2600f232e8,0,0,0,1,1,0,2
ORG3402 Organisasjonsatferd og ledelse,5698db922fb0de2600f22fd7,1,0,0,1,0,0,2
ORG3402 Organisasjonsatferd og ledelse,5698db6341a9d72100240c1b,0,1,0,0,1,0,2
ORG3402 Organisasjonsatferd og ledelse,5698db762fb0de2600f22e6e,0,0,0,0,2,0,2
ORG3402 Organisasjonsatferd og ledelse,5698dc3741a9d72100240f97,0,0,2,0,0,0,2
ORG3402 Organisasjonsatferd og ledelse,5698dc4741a9d72100241067,0,0,1,1,0,0,2
ORG3402 Organisasjonsatferd og ledelse,5698db682fb0de2600f22daa,0,1,0,0,1,0,2
ORG3402 Organisasjonsatferd og ledelse,5698dc5a41a9d72100241158,2,0,0,0,0,0,2
ORG3402 Organisasjonsatferd og ledelse,5698db8d2fb0de2600f22f81,0,0,1,0,1,0,2
ORG3402 Organisasjonsatferd og ledelse,5698db732fb0de2600f22e45,1,0,0,0,1,0,2
ORG3402 Organisasjonsatferd og ledelse,5698db612fb0de2600f22d55,0,0,0,0,2,0,2
ORG3402 Organisasjonsatferd og ledelse,5698db7941a9d72100240d34,0,0,0,1,1,0,2
ORG3402 Organisasjonsatferd og ledelse,5698dc5441a9d7210024110a,0,0,1,1,0,0,2
ORG3402 Organisasjonsatferd og ledelse,5698db6041a9d72100240bf2,0,0,0,1,1,0,2
ORG3402 Organisasjonsatferd og ledelse,5698dc382fb0de2600f2314d,0,0,1,0,1,0,2
ORG3402 Organisasjonsatferd og ledelse,5698dc5d2fb0de2600f2333d,0,0,0,0,2,0,2
ORG3402 Organisasjonsatferd og ledelse,5698dc4b2fb0de2600f2324c,0,1,0,1,0,0,2
ORG3402 Organisasjonsatferd og ledelse,5698dc472fb0de2600f2321b,0,0,0,1,1,0,2
ORG3402 Organisasjonsatferd og ledelse,5698dc5f41a9d721002411a4,0,0,0,0,2,0,2
ORG3402 Organisasjonsatferd og ledelse,5698db632fb0de2600f22d7c,0,0,1,0,1,0,2
ORG3402 Organisasjonsatferd og ledelse,5698db862fb0de2600f22f34,0,1,0,0,1,0,2
ORG3402 Organisasjonsatferd og ledelse,5698db7f41a9d72100240d85,0,0,0,0,2,0,2
ORG3402 Organisasjonsatferd og ledelse,5698db7741a9d72100240d0f,0,2,0,0,0,0,2
ORG3402 Organisasjonsatferd og ledelse,5698db8f41a9d72100240e4e,0,1,1,0,0,0,2
ORG3402 Organisasjonsatferd og ledelse,56ab6d41a55f242200a2d713,0,0,1,1,0,0,2
ORG3402 Organisasjonsatferd og ledelse,5698db862fb0de2600f22f32,0,0,0,2,0,0,2
ORG3402 Organisasjonsatferd og ledelse,5698db832fb0de2600f22f08,2,0,0,0,0,0,2
ORG3402 Organisasjonsatferd og ledelse,5698db6e41a9d72100240c9e,0,0,2,0,0,0,2
ORG3402 Organisasjonsatferd og ledelse,5698dc5d41a9d7210024117c,0,1,0,0,1,0,2
ORG3402 Organisasjonsatferd og ledelse,5698dc5741a9d7210024113e,0,0,0,1,1,0,2
ORG3402 Organisasjonsatferd og ledelse,5698db7d41a9d72100240d62,0,0,2,0,0,0,2
ORG3402 Organisasjonsatferd og ledelse,5698db882fb0de2600f22f3f,1,0,1,0,1,0,3
ORG3402 Organisasjonsatferd og ledelse,5698dc4041a9d72100241012,0,0,1,1,1,0,3
ORG3402 Organisasjonsatferd og ledelse,5698dc3c41a9d72100240fd1,0,0,0,3,0,0,3
ORG3402 Organisasjonsatferd og ledelse,5698db912fb0de2600f22fc5,1,2,0,0,0,0,3
ORG3402 Organisasjonsatferd og ledelse,5698db8e2fb0de2600f22f89,0,0,0,2,1,0,3
ORG3402 Organisasjonsatferd og ledelse,5698db702fb0de2600f22e1f,0,0,0,3,0,0,3
ORG3402 Organisasjonsatferd og ledelse,5698dc442fb0de2600f231f0,0,2,1,0,0,0,3
ORG3402 Organisasjonsatferd og ledelse,5698db612fb0de2600f22d52,0,0,1,1,1,0,3
ORG3402 Organisasjonsatferd og ledelse,56a8d93229028e260091301a,0,0,2,1,0,0,3
ORG3402 Organisasjonsatferd og ledelse,5698db6f2fb0de2600f22e16,0,1,1,0,1,0,3
ORG3402 Organisasjonsatferd og ledelse,5698db932fb0de2600f22fdb,1,0,1,0,1,0,3
ORG3402 Organisasjonsatferd og ledelse,5698dc542fb0de2600f232c3,1,1,1,0,0,0,3
ORG3402 Organisasjonsatferd og ledelse,5698db902fb0de2600f22fae,0,0,0,2,1,0,3
ORG3402 Organisasjonsatferd og ledelse,5698dc4f41a9d721002410d9,2,0,1,0,0,0,3
ORG3402 Organisasjonsatferd og ledelse,5698dc4e2fb0de2600f23278,0,0,1,0,2,0,3
ORG3402 Organisasjonsatferd og ledelse,5698db612fb0de2600f22d54,0,3,0,0,0,0,3
ORG3402 Organisasjonsatferd og ledelse,5698db632fb0de2600f22d7b,0,0,1,1,1,0,3
ORG3402 Organisasjonsatferd og ledelse,5698dc5a2fb0de2600f2331b,0,0,1,0,2,0,3
ORG3402 Organisasjonsatferd og ledelse,5698db9041a9d72100240e59,0,0,0,3,0,0,3
ORG3402 Organisasjonsatferd og ledelse,5698dc542fb0de2600f232c5,0,2,0,0,1,0,3
ORG3402 Organisasjonsatferd og ledelse,5698db7a41a9d72100240d37,0,0,0,2,1,0,3
ORG3402 Organisasjonsatferd og ledelse,5698dc5a2fb0de2600f2331e,0,1,1,0,1,0,3
ORG3402 Organisasjonsatferd og ledelse,5698dc5d41a9d7210024117f,0,2,0,0,1,0,3
ORG3402 Organisasjonsatferd og ledelse,5698dc3b2fb0de2600f2317e,0,0,2,1,0,0,3
ORG3402 Organisasjonsatferd og ledelse,5698db7141a9d72100240cbe,0,1,0,1,1,0,3
ORG3402 Organisasjonsatferd og ledelse,5698dc382fb0de2600f2314e,0,0,0,1,2,0,3
ORG3402 Organisasjonsatferd og ledelse,5698dc3841a9d72100240f9f,0,0,1,0,2,0,3
ORG3402 Organisasjonsatferd og ledelse,5698dc412fb0de2600f231d4,0,1,1,1,0,0,3
ORG3402 Organisasjonsatferd og ledelse,5698db8f2fb0de2600f22fab,1,1,0,0,1,0,3
ORG3402 Organisasjonsatferd og ledelse,5698dc3b2fb0de2600f2317f,0,0,0,0,3,0,3
ORG3402 Organisasjonsatferd og ledelse,5698db672fb0de2600f22da5,0,1,0,0,2,0,3
ORG3402 Organisasjonsatferd og ledelse,5698db6041a9d72100240bf1,0,2,0,0,1,0,3
ORG3402 Organisasjonsatferd og ledelse,5698db6441a9d72100240c20,0,0,1,0,2,0,3
ORG3402 Organisasjonsatferd og ledelse,56af69874377f52300234db8,0,0,0,2,1,0,3
ORG3402 Organisasjonsatferd og ledelse,5698dc4e2fb0de2600f23277,0,1,1,0,1,0,3
ORG3402 Organisasjonsatferd og ledelse,5698db862fb0de2600f22f33,0,0,0,1,2,0,3
ORG3402 Organisasjonsatferd og ledelse,5698db6641a9d72100240c44,1,0,0,1,1,0,3
ORG3402 Organisasjonsatferd og ledelse,5698db662fb0de2600f22da2,0,2,0,0,1,0,3
ORG3402 Organisasjonsatferd og ledelse,5698db842fb0de2600f22f0b,0,1,0,0,2,0,3
ORG3402 Organisasjonsatferd og ledelse,5698dc472fb0de2600f2321c,0,0,0,2,1,0,3
ORG3402 Organisasjonsatferd og ledelse,5698db962fb0de2600f23001,1,1,0,0,1,0,3
ORG3402 Organisasjonsatferd og ledelse,5698dc5141a9d721002410e3,0,1,0,0,2,0,3
ORG3402 Organisasjonsatferd og ledelse,5698dc442fb0de2600f231f1,0,1,2,0,0,0,3
ORG3402 Organisasjonsatferd og ledelse,56b895097d442d26004a7a34,0,0,0,0,3,0,3
ORG3402 Organisasjonsatferd og ledelse,5698db8d41a9d72100240e31,0,0,0,2,1,0,3
ORG3402 Organisasjonsatferd og ledelse,5698db6c2fb0de2600f22df4,0,0,2,1,0,0,3
ORG3402 Organisasjonsatferd og ledelse,5698db882fb0de2600f22f40,0,0,1,0,2,0,3
ORG3402 Organisasjonsatferd og ledelse,5698dc3741a9d72100240f9a,0,2,0,0,1,0,3
ORG3402 Organisasjonsatferd og ledelse,5698dc5241a9d72100241100,0,0,2,0,1,0,3
ORG3402 Organisasjonsatferd og ledelse,5698db8a2fb0de2600f22f61,0,0,1,0,2,0,3
ORG3402 Organisasjonsatferd og ledelse,5698dc5b2fb0de2600f23335,0,1,0,1,1,0,3
ORG3402 Organisasjonsatferd og ledelse,5698db6c2fb0de2600f22df1,0,0,1,1,1,0,3
ORG3402 Organisasjonsatferd og ledelse,5698db8d41a9d72100240e2a,0,2,0,1,0,0,3
ORG3402 Organisasjonsatferd og ledelse,5698db7b41a9d72100240d5a,0,4,0,0,0,0,4
ORG3402 Organisasjonsatferd og ledelse,5698dc3d2fb0de2600f2319d,1,1,2,0,0,0,4
ORG3402 Organisasjonsatferd og ledelse,5698dc392fb0de2600f23159,0,0,4,0,0,0,4
ORG3402 Organisasjonsatferd og ledelse,5698db972fb0de2600f23004,0,0,0,0,4,0,4
ORG3402 Organisasjonsatferd og ledelse,5698da572fb0de2600f22a52,0,0,0,3,1,0,4
ORG3402 Organisasjonsatferd og ledelse,5698db7441a9d72100240cea,1,1,1,0,1,0,4
ORG3402 Organisasjonsatferd og ledelse,5698dc3b41a9d72100240fcc,0,2,2,0,0,0,4
ORG3402 Organisasjonsatferd og ledelse,5698db8741a9d72100240dd9,0,3,0,0,1,0,4
ORG3402 Organisasjonsatferd og ledelse,5698dc482fb0de2600f23231,0,2,1,0,1,0,4
ORG3402 Organisasjonsatferd og ledelse,5698db8441a9d72100240db2,0,0,3,0,1,0,4
ORG3402 Organisasjonsatferd og ledelse,5698dc5d41a9d72100241180,2,1,1,0,0,0,4
ORG3402 Organisasjonsatferd og ledelse,5698db872fb0de2600f22f3c,0,3,1,0,0,0,4
ORG3402 Organisasjonsatferd og ledelse,5698db702fb0de2600f22e1e,0,1,0,3,0,0,4
ORG3402 Organisasjonsatferd og ledelse,5698db792fb0de2600f22e90,0,1,0,0,3,0,4
ORG3402 Organisasjonsatferd og ledelse,5698db642fb0de2600f22d85,0,0,1,2,1,0,4
ORG3402 Organisasjonsatferd og ledelse,5698db6641a9d72100240c46,1,0,2,1,0,0,4
ORG3402 Organisasjonsatferd og ledelse,5698dc492fb0de2600f23241,0,3,0,0,1,0,4
ORG3402 Organisasjonsatferd og ledelse,5698dc5541a9d72100241128,1,0,0,0,3,0,4
ORG3402 Organisasjonsatferd og ledelse,5698dc382fb0de2600f23151,1,2,0,1,0,0,4
ORG3402 Organisasjonsatferd og ledelse,5698dc442fb0de2600f231fa,1,0,1,2,0,0,4
ORG3402 Organisasjonsatferd og ledelse,5698dc572fb0de2600f232ee,0,0,0,1,3,0,4
ORG3402 Organisasjonsatferd og ledelse,5698dc4741a9d72100241068,1,1,0,0,2,0,4
ORG3402 Organisasjonsatferd og ledelse,5698dc5041a9d721002410df,0,0,4,0,0,0,4
ORG3402 Organisasjonsatferd og ledelse,5698da5a2fb0de2600f22a7a,0,2,0,1,1,0,4
ORG3402 Organisasjonsatferd og ledelse,5698db702fb0de2600f22e1c,0,0,2,1,1,0,4
ORG3402 Organisasjonsatferd og ledelse,5698dc4d2fb0de2600f2326d,0,0,2,1,1,0,4
ORG3402 Organisasjonsatferd og ledelse,5698db902fb0de2600f22fb0,0,3,0,1,0,0,4
ORG3402 Organisasjonsatferd og ledelse,5698db9441a9d72100240e89,0,1,0,0,3,0,4
ORG3402 Organisasjonsatferd og ledelse,5698db6e41a9d72100240c9d,1,3,0,0,0,0,4
ORG3402 Organisasjonsatferd og ledelse,5698dc4741a9d72100241064,0,0,1,1,2,0,4
ORG3402 Organisasjonsatferd og ledelse,5698dc472fb0de2600f23219,1,1,1,1,0,0,4
ORG3402 Organisasjonsatferd og ledelse,5698db942fb0de2600f22fe4,0,2,0,0,2,0,4
ORG3402 Organisasjonsatferd og ledelse,5698db7441a9d72100240cf4,0,0,1,0,3,0,4
ORG3402 Organisasjonsatferd og ledelse,5698db7141a9d72100240cbf,1,0,2,1,0,0,4
ORG3402 Organisasjonsatferd og ledelse,5698db8041a9d72100240d95,0,1,2,0,1,0,4
ORG3402 Organisasjonsatferd og ledelse,5698dc502fb0de2600f23298,2,1,1,0,0,0,4
ORG3402 Organisasjonsatferd og ledelse,5698dc3741a9d72100240f9b,0,1,2,1,0,0,4
ORG3402 Organisasjonsatferd og ledelse,5698dc482fb0de2600f2321f,1,1,1,1,0,0,4
ORG3402 Organisasjonsatferd og ledelse,5698db7f41a9d72100240d82,0,3,0,0,1,0,4
ORG3402 Organisasjonsatferd og ledelse,5698dc4041a9d72100241010,1,3,0,0,0,0,4
ORG3402 Organisasjonsatferd og ledelse,5698db662fb0de2600f22da1,0,4,0,0,0,0,4
ORG3402 Organisasjonsatferd og ledelse,5698db6a41a9d72100240c70,1,3,0,0,0,0,4
ORG3402 Organisasjonsatferd og ledelse,5698dc412fb0de2600f231c7,0,0,1,2,1,0,4
ORG3402 Organisasjonsatferd og ledelse,5698dc5141a9d721002410e2,0,3,1,0,0,0,4
ORG3402 Organisasjonsatferd og ledelse,5698db7a41a9d72100240d39,0,0,0,0,4,0,4
ORG3402 Organisasjonsatferd og ledelse,5698dc5d41a9d7210024117b,1,3,0,0,0,0,4
ORG3402 Organisasjonsatferd og ledelse,5698dc5f2fb0de2600f23360,0,2,2,0,0,0,4
ORG3402 Organisasjonsatferd og ledelse,5698dc5741a9d7210024112c,0,1,0,0,3,0,4
ORG3402 Organisasjonsatferd og ledelse,5698dc392fb0de2600f23173,0,0,1,1,2,0,4
ORG3402 Organisasjonsatferd og ledelse,5698db8f2fb0de2600f22faa,0,1,3,0,0,0,4
ORG3402 Organisasjonsatferd og ledelse,5698dc3c41a9d72100240fd2,0,0,0,3,1,0,4
ORG3402 Organisasjonsatferd og ledelse,5698dc3841a9d72100240f9e,0,0,0,0,4,0,4
ORG3402 Organisasjonsatferd og ledelse,5698db6f2fb0de2600f22e17,0,1,0,1,2,0,4
ORG3402 Organisasjonsatferd og ledelse,5698db9441a9d72100240e8c,0,1,1,0,2,0,4
ORG3402 Organisasjonsatferd og ledelse,5698db6441a9d72100240c2b,1,2,0,1,0,0,4
ORG3402 Organisasjonsatferd og ledelse,5698db6041a9d72100240bf3,0,0,3,0,1,0,4
ORG3402 Organisasjonsatferd og ledelse,5698dc5141a9d721002410f3,0,0,0,0,4,0,4
ORG3402 Organisasjonsatferd og ledelse,5698db6341a9d72100240c1d,0,0,0,1,4,0,5
ORG3402 Organisasjonsatferd og ledelse,5698dc4241a9d7210024101b,0,0,2,1,2,0,5
ORG3402 Organisasjonsatferd og ledelse,56b9f76bb1682626003620b9,0,0,0,0,5,0,5
ORG3402 Organisasjonsatferd og ledelse,5698dc3d41a9d72100240fec,0,0,1,0,4,0,5
ORG3402 Organisasjonsatferd og ledelse,5698dc4141a9d72100241017,0,0,0,1,4,0,5
ORG3402 Organisasjonsatferd og ledelse,5698dc502fb0de2600f23297,0,1,1,0,3,0,5
ORG3402 Organisasjonsatferd og ledelse,5698db8441a9d72100240db8,0,2,1,2,0,0,5
ORG3402 Organisasjonsatferd og ledelse,5698db7f41a9d72100240d86,0,1,0,1,3,0,5
ORG3402 Organisasjonsatferd og ledelse,5698db6341a9d72100240c1e,0,1,2,1,1,0,5
ORG3402 Organisasjonsatferd og ledelse,5698db9041a9d72100240e50,0,1,3,0,1,0,5
ORG3402 Organisasjonsatferd og ledelse,5698db8241a9d72100240daa,0,2,2,0,1,0,5
ORG3402 Organisasjonsatferd og ledelse,5698dc5a2fb0de2600f23319,0,0,4,0,1,0,5
ORG3402 Organisasjonsatferd og ledelse,5698dc482fb0de2600f23220,0,0,3,2,0,0,5
ORG3402 Organisasjonsatferd og ledelse,569f7ef4c9741c2500080e46,0,0,2,1,2,0,5
ORG3402 Organisasjonsatferd og ledelse,5698db6641a9d72100240c43,1,2,2,0,0,0,5
ORG3402 Organisasjonsatferd og ledelse,5698dc3a41a9d72100240fc1,2,0,2,1,0,0,5
ORG3402 Organisasjonsatferd og ledelse,5698db782fb0de2600f22e8e,0,4,1,0,0,0,5
ORG3402 Organisasjonsatferd og ledelse,5698db772fb0de2600f22e74,0,0,0,4,1,0,5
ORG3402 Organisasjonsatferd og ledelse,5698db8a2fb0de2600f22f5f,0,0,1,1,3,0,5
ORG3402 Organisasjonsatferd og ledelse,5698dc5341a9d72100241104,3,1,0,0,1,0,5
ORG3402 Organisasjonsatferd og ledelse,5698db7e2fb0de2600f22ecb,0,3,0,0,2,0,5
ORG3402 Organisasjonsatferd og ledelse,5698db7b2fb0de2600f22eb6,0,3,0,2,0,0,5
ORG3402 Organisasjonsatferd og ledelse,569f7f8635827027001cb860,0,2,2,0,1,0,5
ORG3402 Organisasjonsatferd og ledelse,5698dc4e41a9d721002410be,2,1,1,0,1,0,5
ORG3402 Organisasjonsatferd og ledelse,5698dc412fb0de2600f231c8,5,0,0,0,0,0,5
ORG3402 Organisasjonsatferd og ledelse,5698db7f2fb0de2600f22edd,0,4,0,1,0,0,5
ORG3402 Organisasjonsatferd og ledelse,5698dc4641a9d72100241060,0,0,1,2,2,0,5
ORG3402 Organisasjonsatferd og ledelse,5698dc3741a9d72100240f98,1,2,1,0,1,0,5
ORG3402 Organisasjonsatferd og ledelse,5698db7f41a9d72100240d83,0,0,2,1,2,0,5
ORG3402 Organisasjonsatferd og ledelse,5698dc4c2fb0de2600f23268,1,1,2,1,0,0,5
ORG3402 Organisasjonsatferd og ledelse,5698dc5a41a9d7210024116c,2,0,1,2,0,0,5
ORG3402 Organisasjonsatferd og ledelse,5698db8c41a9d72100240e26,0,2,2,0,1,0,5
ORG3402 Organisasjonsatferd og ledelse,5698db8241a9d72100240dac,2,1,1,1,0,0,5
ORG3402 Organisasjonsatferd og ledelse,5698db6c2fb0de2600f22df3,0,4,0,0,1,0,5
ORG3402 Organisasjonsatferd og ledelse,5698db7d41a9d72100240d63,0,3,1,1,0,0,5
ORG3402 Organisasjonsatferd og ledelse,5698dc3b41a9d72100240fca,2,2,0,0,1,0,5
ORG3402 Organisasjonsatferd og ledelse,5698dc3741a9d72100240f99,0,0,2,1,2,0,5
ORG3402 Organisasjonsatferd og ledelse,5698db9341a9d72100240e76,0,1,0,0,4,0,5
ORG3402 Organisasjonsatferd og ledelse,5698db7241a9d72100240ce2,0,0,6,0,0,0,6
ORG3402 Organisasjonsatferd og ledelse,5698db8c41a9d72100240e27,2,2,0,1,1,0,6
ORG3402 Organisasjonsatferd og ledelse,5698db7941a9d72100240d35,0,0,4,1,1,0,6
ORG3402 Organisasjonsatferd og ledelse,5698dc5d2fb0de2600f23342,0,2,1,1,2,0,6
ORG3402 Organisasjonsatferd og ledelse,5698db7441a9d72100240cec,2,2,1,0,1,0,6
ORG3402 Organisasjonsatferd og ledelse,5698db642fb0de2600f22d7d,0,4,1,1,0,0,6
ORG3402 Organisasjonsatferd og ledelse,5698dc3f41a9d72100240ff9,2,2,1,0,1,0,6
ORG3402 Organisasjonsatferd og ledelse,5698db8841a9d72100240def,0,2,1,2,1,0,6
ORG3402 Organisasjonsatferd og ledelse,5698db8041a9d72100240d88,0,1,1,4,0,0,6
ORG3402 Organisasjonsatferd og ledelse,5698db7541a9d72100240d0d,0,1,0,5,0,0,6
ORG3402 Organisasjonsatferd og ledelse,5698dc5241a9d72100241103,2,0,0,2,2,0,6
ORG3402 Organisasjonsatferd og ledelse,56b0c1f4a55f242200a2e702,0,0,0,1,5,0,6
ORG3402 Organisasjonsatferd og ledelse,5698db9341a9d72100240e77,0,1,2,1,2,0,6
ORG3402 Organisasjonsatferd og ledelse,5698dc562fb0de2600f232ea,0,0,0,5,1,0,6
ORG3402 Organisasjonsatferd og ledelse,5698dc492fb0de2600f2323e,0,1,0,3,2,0,6
ORG3402 Organisasjonsatferd og ledelse,5698dc452fb0de2600f231ff,2,2,2,0,0,0,6
ORG3402 Organisasjonsatferd og ledelse,5698db6a2fb0de2600f22dce,0,1,2,1,2,0,6
ORG3402 Organisasjonsatferd og ledelse,5698db7c2fb0de2600f22ebb,2,1,0,1,2,0,6
ORG3402 Organisasjonsatferd og ledelse,5698db942fb0de2600f22fe2,0,1,4,0,1,0,6
ORG3402 Organisasjonsatferd og ledelse,5698db7f41a9d72100240d84,0,5,0,1,0,0,6
ORG3402 Organisasjonsatferd og ledelse,5698db6a41a9d72100240c72,0,0,4,2,0,0,6
ORG3402 Organisasjonsatferd og ledelse,5698db8b2fb0de2600f22f7e,1,2,2,1,0,0,6
ORG3402 Organisasjonsatferd og ledelse,5698dc4541a9d72100241043,2,1,2,1,0,0,6
ORG3402 Organisasjonsatferd og ledelse,5698db6441a9d72100240c21,0,1,2,1,2,0,6
ORG3402 Organisasjonsatferd og ledelse,5698db852fb0de2600f22f14,1,2,0,1,2,0,6
ORG3402 Organisasjonsatferd og ledelse,5698db922fb0de2600f22fd6,2,2,1,0,1,0,6
ORG3402 Organisasjonsatferd og ledelse,5698dc4241a9d72100241018,0,1,0,2,3,0,6
ORG3402 Organisasjonsatferd og ledelse,5698db6e41a9d72100240ca2,0,0,3,0,3,0,6
ORG3402 Organisasjonsatferd og ledelse,5698dc3f41a9d72100240ff8,0,0,1,0,5,0,6
ORG3402 Organisasjonsatferd og ledelse,5698db662fb0de2600f22da3,0,2,2,2,0,0,6
ORG3402 Organisasjonsatferd og ledelse,5698db7a2fb0de2600f22e95,3,2,1,0,1,0,7
ORG3402 Organisasjonsatferd og ledelse,5698db6741a9d72100240c4f,0,0,3,2,2,0,7
ORG3402 Organisasjonsatferd og ledelse,5698db6841a9d72100240c53,1,2,3,0,1,0,7
ORG3402 Organisasjonsatferd og ledelse,5698db6a41a9d72100240c6f,0,3,2,1,1,0,7
ORG3402 Organisasjonsatferd og ledelse,5698dc542fb0de2600f232cd,3,3,0,1,0,0,7
ORG3402 Organisasjonsatferd og ledelse,5698db802fb0de2600f22eea,0,0,4,1,2,0,7
ORG3402 Organisasjonsatferd og ledelse,5698db6b2fb0de2600f22dd9,0,4,1,1,1,0,7
ORG3402 Organisasjonsatferd og ledelse,5698db802fb0de2600f22ef0,1,2,3,1,0,0,7
ORG3402 Organisasjonsatferd og ledelse,5698db6041a9d72100240bf6,0,0,2,2,3,0,7
ORG3402 Organisasjonsatferd og ledelse,5698db722fb0de2600f22e3e,1,3,0,1,2,0,7
ORG3402 Organisasjonsatferd og ledelse,56ba51c4ca1c45220067890f,0,0,0,0,7,0,7
ORG3402 Organisasjonsatferd og ledelse,5698dc5e41a9d72100241185,1,1,1,2,2,0,7
ORG3402 Organisasjonsatferd og ledelse,5698db6941a9d72100240c6d,0,1,2,2,2,0,7
ORG3402 Organisasjonsatferd og ledelse,5698db8141a9d72100240d99,0,1,3,1,2,0,7
ORG3402 Organisasjonsatferd og ledelse,5698db8441a9d72100240db3,0,0,0,6,1,0,7
ORG3402 Organisasjonsatferd og ledelse,5698db8441a9d72100240db9,1,3,1,0,2,0,7
ORG3402 Organisasjonsatferd og ledelse,5698db9641a9d72100240ea8,1,2,2,0,2,0,7
ORG3402 Organisasjonsatferd og ledelse,5698db8641a9d72100240dd5,3,2,0,2,0,0,7
ORG3402 Organisasjonsatferd og ledelse,5698db6d2fb0de2600f22df6,0,1,3,1,2,0,7
ORG3402 Organisasjonsatferd og ledelse,5698dc5b41a9d72100241179,0,1,1,3,2,0,7
ORG3402 Organisasjonsatferd og ledelse,5698db7a41a9d72100240d3c,3,4,0,0,0,0,7
ORG3402 Organisasjonsatferd og ledelse,5698dc382fb0de2600f2314c,1,2,0,4,0,0,7
ORG3402 Organisasjonsatferd og ledelse,5698db752fb0de2600f22e67,0,1,1,3,2,0,7
ORG3402 Organisasjonsatferd og ledelse,5698dc5e41a9d72100241182,0,1,1,4,1,0,7
ORG3402 Organisasjonsatferd og ledelse,5698db932fb0de2600f22fde,0,2,2,2,1,0,7
ORG3402 Organisasjonsatferd og ledelse,5698dc4541a9d72100241041,1,1,3,1,1,0,7
ORG3402 Organisasjonsatferd og ledelse,5698db9141a9d72100240e62,0,4,2,1,0,0,7
ORG3402 Organisasjonsatferd og ledelse,5698dc5e2fb0de2600f2335d,1,4,0,0,2,0,7
ORG3402 Organisasjonsatferd og ledelse,5698db8d41a9d72100240e2d,1,0,1,0,5,0,7
ORG3402 Organisasjonsatferd og ledelse,5698dc5c2fb0de2600f23338,1,2,2,2,0,0,7
ORG3402 Organisasjonsatferd og ledelse,5698dc5341a9d72100241106,1,2,3,0,1,0,7
ORG3402 Organisasjonsatferd og ledelse,5698db8641a9d72100240dd7,2,3,0,2,0,0,7
ORG3402 Organisasjonsatferd og ledelse,5698db8b41a9d72100240e17,0,1,0,3,3,0,7
ORG3402 Organisasjonsatferd og ledelse,5698dc5a41a9d72100241159,0,0,3,1,3,0,7
ORG3402 Organisasjonsatferd og ledelse,5698db722fb0de2600f22e42,0,0,0,0,7,0,7
ORG3402 Organisasjonsatferd og ledelse,5698dc482fb0de2600f2321e,0,0,2,4,1,0,7
ORG3402 Organisasjonsatferd og ledelse,5698db842fb0de2600f22f0d,3,1,2,1,0,0,7
ORG3402 Organisasjonsatferd og ledelse,5698db6f41a9d72100240cbd,2,2,2,0,2,0,8
ORG3402 Organisasjonsatferd og ledelse,5698dc3a41a9d72100240fc2,0,4,4,0,0,0,8
ORG3402 Organisasjonsatferd og ledelse,5698db7441a9d72100240cf0,1,4,1,0,2,0,8
ORG3402 Organisasjonsatferd og ledelse,5698db8e2fb0de2600f22f86,3,4,0,0,1,0,8
ORG3402 Organisasjonsatferd og ledelse,5698dc5941a9d72100241153,2,3,0,1,2,0,8
ORG3402 Organisasjonsatferd og ledelse,5698dc3d41a9d72100240fee,0,3,2,3,0,0,8
ORG3402 Organisasjonsatferd og ledelse,5698dc4d41a9d721002410b3,3,0,1,2,2,0,8
ORG3402 Organisasjonsatferd og ledelse,5698db872fb0de2600f22f3a,2,3,2,1,0,0,8
ORG3402 Organisasjonsatferd og ledelse,569f7f604d946d2400ad1da5,0,1,1,3,3,0,8
ORG3402 Organisasjonsatferd og ledelse,5698db6a2fb0de2600f22dcc,0,3,1,3,1,0,8
ORG3402 Organisasjonsatferd og ledelse,5698db912fb0de2600f22fb3,0,1,4,1,2,0,8
ORG3402 Organisasjonsatferd og ledelse,5698db7441a9d72100240ced,3,2,2,0,1,0,8
ORG3402 Organisasjonsatferd og ledelse,5698db892fb0de2600f22f57,0,3,1,3,1,0,8
ORG3402 Organisasjonsatferd og ledelse,5698dc4a2fb0de2600f23246,1,5,1,0,1,0,8
ORG3402 Organisasjonsatferd og ledelse,5698db9041a9d72100240e5a,0,5,1,0,2,0,8
ORG3402 Organisasjonsatferd og ledelse,569f7f4835827027001cb85c,0,0,0,3,5,0,8
ORG3402 Organisasjonsatferd og ledelse,5698db7141a9d72100240cc0,0,3,4,1,0,0,8
ORG3402 Organisasjonsatferd og ledelse,5698dc4d2fb0de2600f23273,1,0,2,1,4,0,8
ORG3402 Organisasjonsatferd og ledelse,5698db632fb0de2600f22d79,2,4,2,0,0,0,8
ORG3402 Organisasjonsatferd og ledelse,5698dc4d2fb0de2600f23270,1,0,1,2,4,0,8
ORG3402 Organisasjonsatferd og ledelse,5698dc4d2fb0de2600f2326b,1,3,0,3,1,0,8
ORG3402 Organisasjonsatferd og ledelse,5698dc3f41a9d72100240ffa,3,2,0,2,1,0,8
ORG3402 Organisasjonsatferd og ledelse,5698db7a2fb0de2600f22e98,4,0,1,2,1,0,8
ORG3402 Organisasjonsatferd og ledelse,5698db962fb0de2600f22ffe,2,2,1,2,2,0,9
ORG3402 Organisasjonsatferd og ledelse,5698db8541a9d72100240dd2,0,1,4,3,1,0,9
ORG3402 Organisasjonsatferd og ledelse,5698db6a41a9d72100240c71,0,0,3,2,4,0,9
ORG3402 Organisasjonsatferd og ledelse,5698db8d2fb0de2600f22f84,0,1,2,3,3,0,9
ORG3402 Organisasjonsatferd og ledelse,5698dc5741a9d7210024112d,4,2,2,1,0,0,9
ORG3402 Organisasjonsatferd og ledelse,5698dc382fb0de2600f23157,1,3,2,2,1,0,9
ORG3402 Organisasjonsatferd og ledelse,5698dc3f2fb0de2600f231ae,0,1,2,3,3,0,9
ORG3402 Organisasjonsatferd og ledelse,5698db6a2fb0de2600f22dc9,0,2,1,2,4,0,9
ORG3402 Organisasjonsatferd og ledelse,5698db8741a9d72100240ddb,3,1,2,2,1,0,9
ORG3402 Organisasjonsatferd og ledelse,5698dc5a2fb0de2600f2331a,2,4,2,1,0,0,9
ORG3402 Organisasjonsatferd og ledelse,5698db8241a9d72100240dab,1,7,0,1,0,0,9
ORG3402 Organisasjonsatferd og ledelse,5698db6541a9d72100240c42,1,0,3,1,4,0,9
ORG3402 Organisasjonsatferd og ledelse,5698da4941a9d721002406c4,0,0,0,4,5,0,9
ORG3402 Organisasjonsatferd og ledelse,5698dc462fb0de2600f23215,0,2,3,2,2,0,9
ORG3402 Organisasjonsatferd og ledelse,5698dc5941a9d72100241152,0,0,1,4,4,0,9
ORG3402 Organisasjonsatferd og ledelse,5698db7c41a9d72100240d5c,2,1,3,0,3,0,9
ORG3402 Organisasjonsatferd og ledelse,5698dc492fb0de2600f23242,4,3,0,0,2,0,9
ORG3402 Organisasjonsatferd og ledelse,5698db8741a9d72100240dd8,0,4,1,1,3,0,9
ORG3402 Organisasjonsatferd og ledelse,5698dc4a41a9d7210024108f,3,1,0,4,1,0,9
ORG3402 Organisasjonsatferd og ledelse,5698dc4b41a9d72100241094,3,1,3,2,1,0,10
ORG3402 Organisasjonsatferd og ledelse,5698db7a41a9d72100240d3a,3,0,1,4,2,0,10
ORG3402 Organisasjonsatferd og ledelse,5698dc592fb0de2600f23311,4,2,4,0,0,0,10
ORG3402 Organisasjonsatferd og ledelse,5698dc562fb0de2600f232ec,1,3,1,2,3,0,10
ORG3402 Organisasjonsatferd og ledelse,5698db892fb0de2600f22f5c,0,2,0,5,3,0,10
ORG3402 Organisasjonsatferd og ledelse,5698dc4e2fb0de2600f23276,0,1,2,4,3,0,10
ORG3402 Organisasjonsatferd og ledelse,5698db6741a9d72100240c4c,0,0,0,3,6,1,10
ORG3402 Organisasjonsatferd og ledelse,5698db6e41a9d72100240c9f,1,4,3,1,1,0,10
ORG3402 Organisasjonsatferd og ledelse,5698db762fb0de2600f22e70,2,0,2,2,4,0,10
ORG3402 Organisasjonsatferd og ledelse,5698db8a2fb0de2600f22f5e,0,2,2,3,3,0,10
ORG3402 Organisasjonsatferd og ledelse,5698dc392fb0de2600f23174,6,2,2,0,0,0,10
ORG3402 Organisasjonsatferd og ledelse,5698dc5141a9d721002410e4,0,0,5,4,2,0,11
ORG3402 Organisasjonsatferd og ledelse,5698db972fb0de2600f2300b,0,0,5,5,1,0,11
ORG3402 Organisasjonsatferd og ledelse,5698db9341a9d72100240e78,0,3,3,0,5,0,11
ORG3402 Organisasjonsatferd og ledelse,5698db8b41a9d72100240e16,0,8,1,1,1,0,11
ORG3402 Organisasjonsatferd og ledelse,5698db962fb0de2600f22ffb,0,2,4,4,1,0,11
ORG3402 Organisasjonsatferd og ledelse,5698db912fb0de2600f22fb4,1,8,0,1,1,0,11
ORG3402 Organisasjonsatferd og ledelse,5698db702fb0de2600f22e20,6,5,1,0,0,0,12
ORG3402 Organisasjonsatferd og ledelse,5698dc582fb0de2600f2330f,0,3,7,1,1,0,12
ORG3402 Organisasjonsatferd og ledelse,5698dc442fb0de2600f231fc,1,2,4,3,2,0,12
ORG3402 Organisasjonsatferd og ledelse,5698db762fb0de2600f22e6c,0,2,5,2,3,0,12
ORG3402 Organisasjonsatferd og ledelse,5698db6c41a9d72100240c92,2,5,1,4,0,0,12
ORG3402 Organisasjonsatferd og ledelse,5698dc5541a9d72100241124,3,2,2,5,0,0,12
ORG3402 Organisasjonsatferd og ledelse,5698db952fb0de2600f22ff7,1,3,1,3,4,0,12
ORG3402 Organisasjonsatferd og ledelse,5698dc592fb0de2600f23315,1,0,6,3,2,0,12
ORG3402 Organisasjonsatferd og ledelse,5698db7a2fb0de2600f22e97,2,4,1,0,5,0,12
ORG3402 Organisasjonsatferd og ledelse,5698db8e2fb0de2600f22f88,5,1,1,3,2,0,12
ORG3402 Organisasjonsatferd og ledelse,5698db7c2fb0de2600f22eb8,0,7,1,1,4,0,13
ORG3402 Organisasjonsatferd og ledelse,5698dc382fb0de2600f23152,0,1,8,3,1,0,13
ORG3402 Organisasjonsatferd og ledelse,5698dc4d41a9d721002410b6,0,0,5,4,4,0,13
ORG3402 Organisasjonsatferd og ledelse,5698db962fb0de2600f23002,2,8,1,1,1,0,13
ORG3402 Organisasjonsatferd og ledelse,5698dc452fb0de2600f23212,1,2,4,2,4,0,13
ORG3402 Organisasjonsatferd og ledelse,5698dc532fb0de2600f232bf,6,2,3,1,1,0,13
ORG3402 Organisasjonsatferd og ledelse,5698db7141a9d72100240cc4,0,1,6,3,3,0,13
ORG3402 Organisasjonsatferd og ledelse,5698db5f2fb0de2600f22d4e,3,1,3,2,5,0,14
ORG3402 Organisasjonsatferd og ledelse,5698dc4e41a9d721002410b9,2,2,1,4,4,1,14
ORG3402 Organisasjonsatferd og ledelse,5698db6c41a9d72100240c93,0,3,4,2,5,0,14
ORG3402 Organisasjonsatferd og ledelse,569ca43ee62ae22300d1ca40,0,4,4,2,4,0,14
ORG3402 Organisasjonsatferd og ledelse,5698dc4c41a9d721002410b0,4,1,4,2,3,0,14
ORG3402 Organisasjonsatferd og ledelse,5698dc572fb0de2600f232f6,0,0,3,5,6,0,14
ORG3402 Organisasjonsatferd og ledelse,5698db642fb0de2600f22d7e,1,5,2,4,2,0,14
ORG3402 Organisasjonsatferd og ledelse,5698db682fb0de2600f22da9,1,4,6,0,3,0,14
ORG3402 Organisasjonsatferd og ledelse,5698dc5541a9d72100241127,7,2,4,0,2,0,15
ORG3402 Organisasjonsatferd og ledelse,5698db6d2fb0de2600f22df5,3,3,4,4,1,0,15
ORG3402 Organisasjonsatferd og ledelse,5698dc3a41a9d72100240fc7,0,2,5,2,6,0,15
ORG3402 Organisasjonsatferd og ledelse,5698db8b2fb0de2600f22f63,0,5,2,2,6,0,15
ORG3402 Organisasjonsatferd og ledelse,5698dc4a2fb0de2600f23243,0,3,4,4,4,0,15
ORG3402 Organisasjonsatferd og ledelse,5698dc5741a9d7210024112b,0,5,5,3,2,0,15
ORG3402 Organisasjonsatferd og ledelse,5698dc3741a9d72100240f9d,0,0,3,6,6,0,15
ORG3402 Organisasjonsatferd og ledelse,5698db8a41a9d72100240e06,0,6,6,3,2,0,17
ORG3402 Organisasjonsatferd og ledelse,5698dc4141a9d72100241016,0,2,8,5,3,0,18
ORG3402 Organisasjonsatferd og ledelse,5698dc492fb0de2600f23240,4,4,3,4,4,0,19
ORG3402 Organisasjonsatferd og ledelse,5698db722fb0de2600f22e3f,4,7,1,4,5,0,21
ORG3402 Organisasjonsatferd og ledelse,5698db672fb0de2600f22da4,3,5,4,2,7,0,21
ORG3402 Organisasjonsatferd og ledelse,5698db8d41a9d72100240e30,3,5,3,7,3,0,21
ORG3402 Organisasjonsatferd og ledelse,5698dc4341a9d72100241039,3,7,6,5,3,0,24
ORG3402 Organisasjonsatferd og ledelse,5698dc5a41a9d72100241157,0,5,1,7,12,0,25
ORG3402 Organisasjonsatferd og ledelse,5698dc4041a9d72100241013,5,8,5,5,3,0,26
ORG3402 Organisasjonsatferd og ledelse,5698dc3a2fb0de2600f23175,6,5,7,3,7,0,28
ORG3402 Organisasjonsatferd og ledelse,5698db8741a9d72100240ddc,2,9,3,8,6,0,28
ORG3402 Organisasjonsatferd og ledelse,5698dc4941a9d7210024108a,3,4,8,9,7,0,31
ORG3402 Organisasjonsatferd og ledelse,5698dc542fb0de2600f232c6,0,1,8,13,10,0,32
ORG3402 Organisasjonsatferd og ledelse,5698db732fb0de2600f22e47,3,9,8,7,11,0,38
ORG3402 Organisasjonsatferd og ledelse,5698db6141a9d72100240bf7,0,1,1,0,0,0,2
ORG3402 Organisasjonsatferd og ledelse,5698dc3a2fb0de2600f23177,2,0,1,0,0,0,3
ORG3402 Organisasjonsatferd og ledelse,5698db8841a9d72100240dfe,0,4,3,0,5,0,12
ORG3402 Organisasjonsatferd og ledelse,5698dc442fb0de2600f231ef,0,0,1,0,1,0,2
ORG3402 Organisasjonsatferd og ledelse,5698db6941a9d72100240c6c,0,0,0,0,1,0,1
ORG3402 Organisasjonsatferd og ledelse,5698db8441a9d72100240db6,0,0,3,1,4,0,8
ORG3402 Organisasjonsatferd og ledelse,5698db9241a9d72100240e72,0,2,1,0,2,0,5
ORG3402 Organisasjonsatferd og ledelse,5698db772fb0de2600f22e72,0,2,1,1,3,0,7
