distinct_id,session,space_1,time_begin,time_begin_1,time_end,duration
5698d6a82fb0de2600f22585,36589,KLS3551 Kulturledelse,1453202206,2016-01-19 12:16:46,1453202618,412
5698d6a82fb0de2600f22585,8276,KLS3551 Kulturledelse,1453204994,2016-01-19 13:03:14,1453205971,977
5698d6a82fb0de2600f22585,92770,KLS3551 Kulturledelse,1454084815,2016-01-29 17:26:55,1454084835,20
5698d6a82fb0de2600f22585,8170,KLS3551 Kulturledelse,1454286382,2016-02-01 01:26:22,1454286383,1
5698d6a82fb0de2600f22585,71272,KLS3551 Kulturledelse,1454290835,2016-02-01 02:40:35,1454290967,132
5698d6a82fb0de2600f22586,9713,KLS3551 Kulturledelse,1453120924,2016-01-18 13:42:04,1453125977,5053
5698d6a82fb0de2600f22586,74655,KLS3551 Kulturledelse,1453133537,2016-01-18 17:12:17,1453133638,101
5698d6a82fb0de2600f22586,59229,KLS3551 Kulturledelse,1453151952,2016-01-18 22:19:12,1453151995,43
5698d6a82fb0de2600f22586,10284,KLS3551 Kulturledelse,1453196252,2016-01-19 10:37:32,1453196283,31
5698d6a82fb0de2600f22586,60063,KLS3551 Kulturledelse,1453204350,2016-01-19 12:52:30,1453205952,1602
5698d6a82fb0de2600f22586,21890,KLS3551 Kulturledelse,1453209709,2016-01-19 14:21:49,1453209710,1
5698d6a82fb0de2600f22586,86874,KLS3551 Kulturledelse,1453215946,2016-01-19 16:05:46,1453216125,179
5698d6a82fb0de2600f22586,78972,KLS3551 Kulturledelse,1453228410,2016-01-19 19:33:30,1453228595,185
5698d6a82fb0de2600f22586,99554,KLS3551 Kulturledelse,1453305306,2016-01-20 16:55:06,1453305306,0
5698d6a82fb0de2600f22586,7491,KLS3551 Kulturledelse,1453730758,2016-01-25 15:05:58,1453730758,0
5698d6a82fb0de2600f22586,30128,KLS3551 Kulturledelse,1453806356,2016-01-26 12:05:56,1453806356,0
5698d6a82fb0de2600f22586,15460,KLS3551 Kulturledelse,1453815740,2016-01-26 14:42:20,1453815754,14
5698d6a82fb0de2600f22586,2469,KLS3551 Kulturledelse,1453828227,2016-01-26 18:10:27,1453828227,0
5698d6a82fb0de2600f22586,83562,KLS3551 Kulturledelse,1454065069,2016-01-29 11:57:49,1454065250,181
5698d6a82fb0de2600f22587,50621,KLS3551 Kulturledelse,1453771059,2016-01-26 02:17:39,1453771271,212
5698d6a82fb0de2600f22587,84520,KLS3551 Kulturledelse,1453906485,2016-01-27 15:54:45,1453906485,0
5698d6a82fb0de2600f22589,77030,KLS3551 Kulturledelse,1452961762,2016-01-16 17:29:22,1452961882,120
5698d6a82fb0de2600f22589,4059,KLS3551 Kulturledelse,1453060483,2016-01-17 20:54:43,1453060483,0
5698d6a82fb0de2600f22589,25950,KLS3551 Kulturledelse,1453201963,2016-01-19 12:12:43,1453203144,1181
5698d6a82fb0de2600f22589,5678,KLS3551 Kulturledelse,1453484893,2016-01-22 18:48:13,1453484894,1
5698d6a82fb0de2600f22589,59861,KLS3551 Kulturledelse,1453560456,2016-01-23 15:47:36,1453560456,0
5698d6a82fb0de2600f22589,62995,KLS3551 Kulturledelse,1453826945,2016-01-26 17:49:05,1453826971,26
5698d6a82fb0de2600f22589,65777,KLS3551 Kulturledelse,1453832675,2016-01-26 19:24:35,1453832684,9
5698d6a841a9d721002400f3,92232,KLS3551 Kulturledelse,1453204985,2016-01-19 13:03:05,1453205486,501
5698d6a841a9d721002400f3,92331,KLS3551 Kulturledelse,1453209534,2016-01-19 14:18:54,1453209538,4
5698d6a841a9d721002400f3,62093,KLS3551 Kulturledelse,1453722680,2016-01-25 12:51:20,1453722761,81
5698d6a841a9d721002400f3,54252,KLS3551 Kulturledelse,1453981000,2016-01-28 12:36:40,1453981456,456
5698d6a841a9d721002400f3,15011,KLS3551 Kulturledelse,1453985743,2016-01-28 13:55:43,1453985743,0
5698d6a841a9d721002400f4,47480,KLS3551 Kulturledelse,1453204948,2016-01-19 13:02:28,1453206005,1057
5698d6a841a9d721002400f4,32529,KLS3551 Kulturledelse,1453318432,2016-01-20 20:33:52,1453318434,2
5698d6a841a9d721002400f5,74027,KLS3551 Kulturledelse,1453114339,2016-01-18 11:52:19,1453114821,482
5698d6a841a9d721002400f5,68828,KLS3551 Kulturledelse,1453118131,2016-01-18 12:55:31,1453118253,122
5698d6a841a9d721002400f5,34895,KLS3551 Kulturledelse,1453155106,2016-01-18 23:11:46,1453156494,1388
5698d6a841a9d721002400f5,22541,KLS3551 Kulturledelse,1453238676,2016-01-19 22:24:36,1453239067,391
5698d6a841a9d721002400f5,75365,KLS3551 Kulturledelse,1453333415,2016-01-21 00:43:35,1453333418,3
5698d6a841a9d721002400f5,4427,KLS3551 Kulturledelse,1453730138,2016-01-25 14:55:38,1453730147,9
5698d6a841a9d721002400f5,62358,KLS3551 Kulturledelse,1453737993,2016-01-25 17:06:33,1453738603,610
5698d6a841a9d721002400f5,92530,KLS3551 Kulturledelse,1453740768,2016-01-25 17:52:48,1453740768,0
5698d6a841a9d721002400f5,34035,KLS3551 Kulturledelse,1454192740,2016-01-30 23:25:40,1454192742,2
5698d6a841a9d721002400f6,33603,KLS3551 Kulturledelse,1453205114,2016-01-19 13:05:14,1453205115,1
5698d6a92fb0de2600f2258c,55663,KLS3551 Kulturledelse,1453155823,2016-01-18 23:23:43,1453155916,93
5698d6a92fb0de2600f2258c,30672,KLS3551 Kulturledelse,1453199414,2016-01-19 11:30:14,1453199438,24
5698d6a92fb0de2600f2258c,70889,KLS3551 Kulturledelse,1453202217,2016-01-19 12:16:57,1453203018,801
5698d6a92fb0de2600f2258c,2876,KLS3551 Kulturledelse,1453205262,2016-01-19 13:07:42,1453205262,0
5698d6a92fb0de2600f2258c,41665,KLS3551 Kulturledelse,1453649590,2016-01-24 16:33:10,1453649750,160
5698d6a92fb0de2600f2258c,66192,KLS3551 Kulturledelse,1453678012,2016-01-25 00:26:52,1453678033,21
5698d6a92fb0de2600f2258c,1284,KLS3551 Kulturledelse,1453708871,2016-01-25 09:01:11,1453708912,41
5698d6a92fb0de2600f2258c,47243,KLS3551 Kulturledelse,1453806034,2016-01-26 12:00:34,1453806074,40
5698d6a92fb0de2600f2258c,55482,KLS3551 Kulturledelse,1453808313,2016-01-26 12:38:33,1453808482,169
5698d6a941a9d721002400f8,13378,KLS3551 Kulturledelse,1454321136,2016-02-01 11:05:36,1454321137,1
5698d6aa2fb0de2600f22590,44835,KLS3551 Kulturledelse,1453200478,2016-01-19 11:47:58,1453200836,358
5698d6aa2fb0de2600f22590,34150,KLS3551 Kulturledelse,1453204606,2016-01-19 12:56:46,1453205978,1372
5698d6aa2fb0de2600f22590,8174,KLS3551 Kulturledelse,1453805357,2016-01-26 11:49:17,1453806402,1045
5698d6aa2fb0de2600f22590,22388,KLS3551 Kulturledelse,1453813556,2016-01-26 14:05:56,1453813559,3
5698d6aa2fb0de2600f22590,99954,KLS3551 Kulturledelse,1453814794,2016-01-26 14:26:34,1453814800,6
5698d6aa2fb0de2600f22591,48209,KLS3551 Kulturledelse,1452860699,2016-01-15 13:24:59,1452860877,178
5698d6aa2fb0de2600f22591,85316,KLS3551 Kulturledelse,1453124208,2016-01-18 14:36:48,1453124278,70
5698d6aa2fb0de2600f22591,88218,KLS3551 Kulturledelse,1453127850,2016-01-18 15:37:30,1453128162,312
5698d6aa2fb0de2600f22591,93145,KLS3551 Kulturledelse,1453138778,2016-01-18 18:39:38,1453138781,3
5698d6aa2fb0de2600f22591,84122,KLS3551 Kulturledelse,1453298089,2016-01-20 14:54:49,1453298447,358
5698d6aa2fb0de2600f22591,17700,KLS3551 Kulturledelse,1453301611,2016-01-20 15:53:31,1453301612,1
5698d6aa2fb0de2600f22591,35499,KLS3551 Kulturledelse,1453979421,2016-01-28 12:10:21,1453979528,107
5698d6aa2fb0de2600f22591,61053,KLS3551 Kulturledelse,1453981389,2016-01-28 12:43:09,1453983473,2084
5698d6aa2fb0de2600f22591,91006,KLS3551 Kulturledelse,1454320545,2016-02-01 10:55:45,1454320545,0
5698d6aa2fb0de2600f22592,40299,KLS3551 Kulturledelse,1452957103,2016-01-16 16:11:43,1452957229,126
5698d6aa2fb0de2600f22592,65278,KLS3551 Kulturledelse,1453063520,2016-01-17 21:45:20,1453063541,21
5698d6aa2fb0de2600f22592,5597,KLS3551 Kulturledelse,1453201762,2016-01-19 12:09:22,1453201792,30
5698d6aa2fb0de2600f22592,46282,KLS3551 Kulturledelse,1453205142,2016-01-19 13:05:42,1453207238,2096
5698d6aa2fb0de2600f22592,78901,KLS3551 Kulturledelse,1453221836,2016-01-19 17:43:56,1453221861,25
5698d6aa2fb0de2600f22592,58386,KLS3551 Kulturledelse,1453239418,2016-01-19 22:36:58,1453239426,8
5698d6aa2fb0de2600f22592,26625,MRK3480 Forbrukeratferd,1453293852,2016-01-20 13:44:12,1453293887,35
5698d6aa2fb0de2600f22592,3329,KLS3551 Kulturledelse,1453647626,2016-01-24 16:00:26,1453647877,251
5698d6aa2fb0de2600f22592,50471,KLS3551 Kulturledelse,1453708568,2016-01-25 08:56:08,1453708981,413
5698d6aa2fb0de2600f22592,62457,MRK3480 Forbrukeratferd,1453726054,2016-01-25 13:47:34,1453726078,24
5698d6aa2fb0de2600f22592,5589,KLS3551 Kulturledelse,1453809868,2016-01-26 13:04:28,1453809980,112
5698d6aa2fb0de2600f22592,61119,MRK3480 Forbrukeratferd,1453813671,2016-01-26 14:07:51,1453813812,141
5698d6aa2fb0de2600f22592,18365,KLS3551 Kulturledelse,1453826856,2016-01-26 17:47:36,1453827752,896
5698d6aa2fb0de2600f22592,39622,KLS3551 Kulturledelse,1453833290,2016-01-26 19:34:50,1453833293,3
5698d6aa2fb0de2600f22592,81225,KLS3551 Kulturledelse,1453895754,2016-01-27 12:55:54,1453896193,439
5698d6aa2fb0de2600f22592,57219,KLS3551 Kulturledelse,1453902268,2016-01-27 14:44:28,1453902268,0
5698d6aa2fb0de2600f22594,61372,KLS3551 Kulturledelse,1453711077,2016-01-25 09:37:57,1453711169,92
5698d6aa2fb0de2600f22594,89722,KLS3551 Kulturledelse,1453725731,2016-01-25 13:42:11,1453725738,7
5698d6aa2fb0de2600f22594,70094,KLS3551 Kulturledelse,1453728154,2016-01-25 14:22:34,1453728724,570
5698d6aa2fb0de2600f22594,25794,KLS3551 Kulturledelse,1453807445,2016-01-26 12:24:05,1453807445,0
5698d6aa2fb0de2600f22598,84582,KLS3551 Kulturledelse,1453193775,2016-01-19 09:56:15,1453193956,181
5698d6aa2fb0de2600f22598,4076,KLS3551 Kulturledelse,1453198157,2016-01-19 11:09:17,1453198218,61
5698d6aa2fb0de2600f22598,1804,KLS3551 Kulturledelse,1453205037,2016-01-19 13:03:57,1453205966,929
5698d6aa2fb0de2600f22598,80855,KLS3551 Kulturledelse,1453210555,2016-01-19 14:35:55,1453210605,50
5698d6aa2fb0de2600f22598,95899,KLS3551 Kulturledelse,1453212642,2016-01-19 15:10:42,1453212661,19
5698d6aa2fb0de2600f22598,34086,KLS3551 Kulturledelse,1453214666,2016-01-19 15:44:26,1453214666,0
5698d6aa2fb0de2600f22598,97653,KLS3551 Kulturledelse,1453220869,2016-01-19 17:27:49,1453220869,0
5698d6aa2fb0de2600f22598,73429,KLS3551 Kulturledelse,1453303008,2016-01-20 16:16:48,1453303008,0
5698d6aa2fb0de2600f22598,27699,KLS3551 Kulturledelse,1453381922,2016-01-21 14:12:02,1453381922,0
5698d6aa2fb0de2600f22598,91711,KLS3551 Kulturledelse,1453674598,2016-01-24 23:29:58,1453674610,12
5698d6aa2fb0de2600f22598,92685,KLS3551 Kulturledelse,1453764620,2016-01-26 00:30:20,1453764621,1
5698d6aa2fb0de2600f22598,28132,KLS3551 Kulturledelse,1453795827,2016-01-26 09:10:27,1453795865,38
5698d6aa2fb0de2600f22598,52184,KLS3551 Kulturledelse,1453799801,2016-01-26 10:16:41,1453799892,91
5698d6aa2fb0de2600f22598,92111,KLS3551 Kulturledelse,1453808777,2016-01-26 12:46:17,1453808777,0
5698d6aa2fb0de2600f22598,1605,KLS3551 Kulturledelse,1453822319,2016-01-26 16:31:59,1453822322,3
5698d6aa2fb0de2600f22598,58376,KLS3551 Kulturledelse,1453825250,2016-01-26 17:20:50,1453825393,143
5698d6aa2fb0de2600f22598,41262,KLS3551 Kulturledelse,1453828792,2016-01-26 18:19:52,1453828806,14
5698d6aa2fb0de2600f22598,82392,KLS3551 Kulturledelse,1453830230,2016-01-26 18:43:50,1453830239,9
5698d6aa2fb0de2600f22598,10802,KLS3551 Kulturledelse,1453833630,2016-01-26 19:40:30,1453833648,18
5698d6aa2fb0de2600f22598,51682,KLS3551 Kulturledelse,1453839041,2016-01-26 21:10:41,1453839043,2
5698d6aa2fb0de2600f22598,27681,KLS3551 Kulturledelse,1453926685,2016-01-27 21:31:25,1453926685,0
5698d6aa2fb0de2600f22598,26433,KLS3551 Kulturledelse,1453979732,2016-01-28 12:15:32,1453979732,0
5698d6aa2fb0de2600f22598,84923,KLS3551 Kulturledelse,1453983768,2016-01-28 13:22:48,1453985262,1494
5698d6aa2fb0de2600f22598,18044,KLS3551 Kulturledelse,1453991972,2016-01-28 15:39:32,1453991985,13
5698d6aa2fb0de2600f22598,67315,KLS3551 Kulturledelse,1453997148,2016-01-28 17:05:48,1453997161,13
5698d6aa2fb0de2600f22598,15731,KLS3551 Kulturledelse,1454257399,2016-01-31 17:23:19,1454257399,0
5698d6aa2fb0de2600f22598,56841,KLS3551 Kulturledelse,1454320176,2016-02-01 10:49:36,1454320197,21
5698d6aa41a9d721002400ff,47211,KLS3551 Kulturledelse,1453202203,2016-01-19 12:16:43,1453202257,54
5698d6aa41a9d721002400ff,37526,KLS3551 Kulturledelse,1453204774,2016-01-19 12:59:34,1453204778,4
5698d6aa41a9d721002400ff,98894,KLS3551 Kulturledelse,1453206202,2016-01-19 13:23:22,1453206207,5
5698d6aa41a9d72100240100,38299,KLS3551 Kulturledelse,1453206076,2016-01-19 13:21:16,1453206176,100
5698d6aa41a9d72100240100,74997,KLS3551 Kulturledelse,1453835522,2016-01-26 20:12:02,1453836946,1424
5698d6aa41a9d72100240100,34061,KLS3551 Kulturledelse,1453892784,2016-01-27 12:06:24,1453892795,11
5698d6aa41a9d72100240100,15829,KLS3551 Kulturledelse,1454165378,2016-01-30 15:49:38,1454165885,507
5698d6aa41a9d72100240101,25864,KLS3551 Kulturledelse,1453126431,2016-01-18 15:13:51,1453126627,196
5698d6aa41a9d72100240101,59947,KLS3551 Kulturledelse,1453204942,2016-01-19 13:02:22,1453205016,74
5698d6aa41a9d72100240101,25745,KLS3551 Kulturledelse,1453368714,2016-01-21 10:31:54,1453368803,89
5698d6aa41a9d72100240101,67695,KLS3551 Kulturledelse,1453459360,2016-01-22 11:42:40,1453459361,1
5698d6aa41a9d72100240101,65635,KLS3551 Kulturledelse,1453723745,2016-01-25 13:09:05,1453724401,656
5698d6aa41a9d72100240102,36851,KLS3551 Kulturledelse,1453151400,2016-01-18 22:10:00,1453151479,79
5698d6aa41a9d72100240102,62777,KLS3551 Kulturledelse,1453209404,2016-01-19 14:16:44,1453209505,101
5698d6aa41a9d72100240102,32940,KLS3551 Kulturledelse,1453806794,2016-01-26 12:13:14,1453807014,220
5698d6aa41a9d72100240102,48294,KLS3551 Kulturledelse,1453812079,2016-01-26 13:41:19,1453812123,44
5698d6aa41a9d72100240102,38702,KLS3551 Kulturledelse,1453814137,2016-01-26 14:15:37,1453814859,722
5698d6aa41a9d72100240102,30498,KLS3551 Kulturledelse,1453822876,2016-01-26 16:41:16,1453822899,23
5698d6aa41a9d72100240105,26885,KLS3551 Kulturledelse,1453198803,2016-01-19 11:20:03,1453199610,807
5698d6aa41a9d72100240105,93014,KLS3551 Kulturledelse,1453201322,2016-01-19 12:02:02,1453201367,45
5698d6aa41a9d72100240105,76841,KLS3551 Kulturledelse,1453307108,2016-01-20 17:25:08,1453307108,0
5698d6aa41a9d72100240105,48169,KLS3551 Kulturledelse,1453428003,2016-01-22 03:00:03,1453428004,1
5698d6aa41a9d72100240105,48487,KLS3551 Kulturledelse,1453983271,2016-01-28 13:14:31,1453983539,268
5698d6ab2fb0de2600f225ad,56169,KLS3551 Kulturledelse,1452872070,2016-01-15 16:34:30,1452872182,112
5698d6ab2fb0de2600f225ad,44935,KLS3551 Kulturledelse,1452873403,2016-01-15 16:56:43,1452873403,0
5698d6ab2fb0de2600f225ad,34100,KLS3551 Kulturledelse,1453109900,2016-01-18 10:38:20,1453109925,25
5698d6ab2fb0de2600f225ad,22664,KLS3551 Kulturledelse,1453113473,2016-01-18 11:37:53,1453113482,9
5698d6ab2fb0de2600f225ad,19049,KLS3551 Kulturledelse,1453124971,2016-01-18 14:49:31,1453125264,293
5698d6ab2fb0de2600f225ad,66905,KLS3551 Kulturledelse,1453126759,2016-01-18 15:19:19,1453126865,106
5698d6ab2fb0de2600f225ad,37680,KLS3551 Kulturledelse,1453203627,2016-01-19 12:40:27,1453203647,20
5698d6ab2fb0de2600f225ad,40059,KLS3551 Kulturledelse,1453545970,2016-01-23 11:46:10,1453545989,19
5698d6ab2fb0de2600f225ad,77989,KLS3551 Kulturledelse,1453810242,2016-01-26 13:10:42,1453810598,356
5698d6ab2fb0de2600f225b0,31091,KLS3551 Kulturledelse,1452865227,2016-01-15 14:40:27,1452865294,67
5698d6ab2fb0de2600f225b0,663,KLS3551 Kulturledelse,1453204719,2016-01-19 12:58:39,1453205456,737
5698d6ab2fb0de2600f225b0,42285,KLS3551 Kulturledelse,1453210231,2016-01-19 14:30:31,1453210231,0
5698d6ab2fb0de2600f225b0,59157,KLS3551 Kulturledelse,1453226322,2016-01-19 18:58:42,1453226351,29
5698d6ab2fb0de2600f225b0,32020,KLS3551 Kulturledelse,1453819209,2016-01-26 15:40:09,1453819543,334
5698d6ab2fb0de2600f225b0,40074,KLS3551 Kulturledelse,1453821228,2016-01-26 16:13:48,1453821233,5
5698d6ab2fb0de2600f225b0,57942,KLS3551 Kulturledelse,1453823293,2016-01-26 16:48:13,1453823293,0
5698d6ab2fb0de2600f225b0,76148,KLS3551 Kulturledelse,1453824881,2016-01-26 17:14:41,1453824885,4
5698d6ab2fb0de2600f225b1,15164,KLS3551 Kulturledelse,1452862292,2016-01-15 13:51:32,1452862479,187
5698d6ab2fb0de2600f225b1,41669,KLS3551 Kulturledelse,1453047893,2016-01-17 17:24:53,1453048504,611
5698d6ab2fb0de2600f225b1,1096,KLS3551 Kulturledelse,1453130986,2016-01-18 16:29:46,1453130990,4
5698d6ab2fb0de2600f225b1,4146,KLS3551 Kulturledelse,1453205024,2016-01-19 13:03:44,1453205895,871
5698d6ab2fb0de2600f225b1,48799,KLS3551 Kulturledelse,1453209130,2016-01-19 14:12:10,1453209234,104
5698d6ab2fb0de2600f225b1,88859,KLS3551 Kulturledelse,1453671842,2016-01-24 22:44:02,1453672948,1106
5698d6ab2fb0de2600f225b1,81490,KLS3551 Kulturledelse,1453674381,2016-01-24 23:26:21,1453674435,54
5698d6ab2fb0de2600f225b1,41523,KLS3551 Kulturledelse,1453806112,2016-01-26 12:01:52,1453806185,73
5698d6ab2fb0de2600f225b1,10355,KLS3551 Kulturledelse,1453811048,2016-01-26 13:24:08,1453811052,4
5698d6ab2fb0de2600f225b1,33588,KLS3551 Kulturledelse,1453827488,2016-01-26 17:58:08,1453827488,0
5698d6ab2fb0de2600f225b1,15200,KLS3551 Kulturledelse,1453895620,2016-01-27 12:53:40,1453895635,15
5698d6ab2fb0de2600f225b1,11586,KLS3551 Kulturledelse,1453899369,2016-01-27 13:56:09,1453899963,594
5698d6ab2fb0de2600f225b1,27061,KLS3551 Kulturledelse,1453912259,2016-01-27 17:30:59,1453912259,0
5698d6ab2fb0de2600f225b1,59044,KLS3551 Kulturledelse,1454081477,2016-01-29 16:31:17,1454081560,83
5698d6ab41a9d7210024011b,3635,KLS3551 Kulturledelse,1453201464,2016-01-19 12:04:24,1453202497,1033
5698d6ab41a9d7210024011b,87079,KLS3551 Kulturledelse,1453203872,2016-01-19 12:44:32,1453206203,2331
5698d6ab41a9d7210024011b,53531,KLS3551 Kulturledelse,1453211641,2016-01-19 14:54:01,1453211641,0
5698d6ab41a9d7210024011b,43257,KLS3551 Kulturledelse,1453810907,2016-01-26 13:21:47,1453810981,74
5698d6ab41a9d7210024011b,11899,KLS3551 Kulturledelse,1454067127,2016-01-29 12:32:07,1454068140,1013
5698d6ab41a9d7210024011b,56624,KLS3551 Kulturledelse,1454070977,2016-01-29 13:36:17,1454070992,15
5698d6ab41a9d7210024011b,8856,KLS3551 Kulturledelse,1454072754,2016-01-29 14:05:54,1454073057,303
5698d6ab41a9d7210024011d,4181,KLS3551 Kulturledelse,1453658967,2016-01-24 19:09:27,1453659351,384
5698d6ab41a9d7210024011d,37199,KLS3551 Kulturledelse,1453746337,2016-01-25 19:25:37,1453746348,11
5698d6ab41a9d7210024011d,21580,KLS3551 Kulturledelse,1453764015,2016-01-26 00:20:15,1453764020,5
5698d6ab41a9d7210024011d,62743,KLS3551 Kulturledelse,1453804565,2016-01-26 11:36:05,1453804576,11
5698d6ab41a9d7210024011d,5465,KLS3551 Kulturledelse,1453806209,2016-01-26 12:03:29,1453806220,11
5698d6ab41a9d7210024011d,95958,KLS3551 Kulturledelse,1453808027,2016-01-26 12:33:47,1453808800,773
5698d6ab41a9d7210024011d,50947,KLS3551 Kulturledelse,1453813534,2016-01-26 14:05:34,1453813634,100
5698d6ac2fb0de2600f225b2,48628,KLS3551 Kulturledelse,1454269182,2016-01-31 20:39:42,1454269246,64
5698d6ac2fb0de2600f225b3,48983,KLS3551 Kulturledelse,1453113326,2016-01-18 11:35:26,1453113551,225
5698d6ac2fb0de2600f225b3,13885,KLS3551 Kulturledelse,1453125030,2016-01-18 14:50:30,1453125042,12
5698d6ac2fb0de2600f225b3,53239,KLS3551 Kulturledelse,1453134937,2016-01-18 17:35:37,1453135065,128
5698d6ac2fb0de2600f225b3,99257,KLS3551 Kulturledelse,1454317894,2016-02-01 10:11:34,1454318904,1010
5698d6ac2fb0de2600f225b3,34286,KLS3551 Kulturledelse,1454320612,2016-02-01 10:56:52,1454320612,0
5698d6ac2fb0de2600f225b5,63801,KLS3551 Kulturledelse,1454078128,2016-01-29 15:35:28,1454078292,164
5698d6ac2fb0de2600f225b5,2029,KLS3551 Kulturledelse,1454313694,2016-02-01 09:01:34,1454313698,4
5698d6ac2fb0de2600f225b7,93050,KLS3551 Kulturledelse,1453114038,2016-01-18 11:47:18,1453114305,267
5698d6ac2fb0de2600f225b7,40649,KLS3551 Kulturledelse,1453466957,2016-01-22 13:49:17,1453467336,379
5698d6ac2fb0de2600f225b7,26143,KLS3551 Kulturledelse,1453828225,2016-01-26 18:10:25,1453828327,102
5698d6ac2fb0de2600f225b7,34812,KLS3551 Kulturledelse,1453832647,2016-01-26 19:24:07,1453832648,1
5698d6ac2fb0de2600f225b7,68230,KLS3551 Kulturledelse,1453848344,2016-01-26 23:45:44,1453848665,321
5698d6ac2fb0de2600f225b7,40272,KLS3551 Kulturledelse,1453878332,2016-01-27 08:05:32,1453878365,33
5698d6ac2fb0de2600f225b7,71021,KLS3551 Kulturledelse,1454063520,2016-01-29 11:32:00,1454063745,225
5698d6ac2fb0de2600f225b7,7966,KLS3551 Kulturledelse,1454065061,2016-01-29 11:57:41,1454065263,202
5698d6ac2fb0de2600f225bc,58682,KLS3551 Kulturledelse,1452864790,2016-01-15 14:33:10,1452864856,66
5698d6ac2fb0de2600f225bc,13795,KLS3551 Kulturledelse,1452986686,2016-01-17 00:24:46,1452986689,3
5698d6ac2fb0de2600f225bc,7498,KLS3551 Kulturledelse,1453066819,2016-01-17 22:40:19,1453066820,1
5698d6ac2fb0de2600f225bc,57980,KLS3551 Kulturledelse,1453159961,2016-01-19 00:32:41,1453159984,23
5698d6ac2fb0de2600f225bc,61899,KLS3551 Kulturledelse,1453826395,2016-01-26 17:39:55,1453826517,122
5698d6ac41a9d7210024011e,5486,KLS3551 Kulturledelse,1453204999,2016-01-19 13:03:19,1453206004,1005
5698d6ac41a9d7210024011e,6688,KLS3551 Kulturledelse,1453802741,2016-01-26 11:05:41,1453802787,46
5698d6ac41a9d7210024011e,17696,KLS3551 Kulturledelse,1453982537,2016-01-28 13:02:17,1453982560,23
5698d6ac41a9d7210024011e,77620,KLS3551 Kulturledelse,1453986840,2016-01-28 14:14:00,1453987642,802
5698d6ac41a9d7210024011e,64024,KLS3551 Kulturledelse,1454274824,2016-01-31 22:13:44,1454274824,0
5698d6ac41a9d72100240120,73559,KLS3551 Kulturledelse,1453200083,2016-01-19 11:41:23,1453201568,1485
5698d6ac41a9d72100240120,69908,KLS3551 Kulturledelse,1453204636,2016-01-19 12:57:16,1453205868,1232
5698d6ac41a9d72100240120,81947,KLS3551 Kulturledelse,1453207595,2016-01-19 13:46:35,1453208598,1003
5698d6ac41a9d72100240120,50556,KLS3551 Kulturledelse,1453804141,2016-01-26 11:29:01,1453804226,85
5698d6ac41a9d72100240120,8291,KLS3551 Kulturledelse,1453903243,2016-01-27 15:00:43,1453903243,0
5698d6ac41a9d72100240120,57907,KLS3551 Kulturledelse,1453906451,2016-01-27 15:54:11,1453906456,5
5698d6ac41a9d72100240121,51131,KLS3551 Kulturledelse,1453108390,2016-01-18 10:13:10,1453109371,981
5698d6ac41a9d72100240121,8755,nan,1453114720,2016-01-18 11:58:40,1453114844,124
5698d6ac41a9d72100240121,90610,KLS3551 Kulturledelse,1453134141,2016-01-18 17:22:21,1453134346,205
5698d6ac41a9d72100240121,79871,KLS3551 Kulturledelse,1453204337,2016-01-19 12:52:17,1453205865,1528
5698d6ac41a9d72100240121,60272,KLS3551 Kulturledelse,1453386264,2016-01-21 15:24:24,1453386264,0
5698d6ac41a9d72100240121,28666,KLS3551 Kulturledelse,1453740120,2016-01-25 17:42:00,1453740120,0
5698d6ac41a9d72100240121,76190,KLS3551 Kulturledelse,1453819114,2016-01-26 15:38:34,1453819907,793
5698d6ac41a9d72100240121,30323,KLS3551 Kulturledelse,1453823195,2016-01-26 16:46:35,1453823200,5
5698d6ac41a9d72100240121,98816,KLS3551 Kulturledelse,1453825999,2016-01-26 17:33:19,1453826025,26
5698d6ac41a9d72100240121,96869,KLS3551 Kulturledelse,1453899640,2016-01-27 14:00:40,1453899640,0
5698d6ac41a9d72100240121,65820,KLS3551 Kulturledelse,1453903165,2016-01-27 14:59:25,1453905255,2090
5698d6ac41a9d72100240121,50173,KLS3551 Kulturledelse,1453912230,2016-01-27 17:30:30,1453913206,976
5698d6ac41a9d72100240121,36436,KLS3551 Kulturledelse,1453991628,2016-01-28 15:33:48,1453991628,0
5698d6ac41a9d72100240121,8479,KLS3551 Kulturledelse,1454163969,2016-01-30 15:26:09,1454163969,0
5698d6ac41a9d72100240121,57899,KLS3551 Kulturledelse,1454255479,2016-01-31 16:51:19,1454255479,0
5698d6ac41a9d72100240121,71908,KLS3551 Kulturledelse,1454258568,2016-01-31 17:42:48,1454258569,1
5698d6ac41a9d72100240121,69430,KLS3551 Kulturledelse,1454313929,2016-02-01 09:05:29,1454313929,0
5698d6ac41a9d72100240121,77256,KLS3551 Kulturledelse,1454320563,2016-02-01 10:56:03,1454320563,0
5698d6ac41a9d72100240122,23878,KLS3551 Kulturledelse,1454076949,2016-01-29 15:15:49,1454077148,199
5698d6ac41a9d72100240123,48134,KLS3551 Kulturledelse,1453149251,2016-01-18 21:34:11,1453149713,462
5698d6ac41a9d72100240123,13303,KLS3551 Kulturledelse,1453194202,2016-01-19 10:03:22,1453194207,5
5698d6ac41a9d72100240123,92179,KLS3551 Kulturledelse,1453205932,2016-01-19 13:18:52,1453205983,51
5698d6ac41a9d72100240123,92919,KLS3551 Kulturledelse,1453493184,2016-01-22 21:06:24,1453493185,1
5698d6ac41a9d72100240123,73669,KLS3551 Kulturledelse,1453722161,2016-01-25 12:42:41,1453722767,606
5698d6ac41a9d72100240123,92496,KLS3551 Kulturledelse,1453816881,2016-01-26 15:01:21,1453816895,14
5698d6ac41a9d72100240129,96760,KLS3551 Kulturledelse,1452889608,2016-01-15 21:26:48,1452890367,759
5698d6ac41a9d72100240129,63968,KLS3551 Kulturledelse,1453223136,2016-01-19 18:05:36,1453223531,395
5698d6ac41a9d72100240129,431,KLS3551 Kulturledelse,1453238287,2016-01-19 22:18:07,1453238288,1
5698d6ac41a9d72100240129,11836,KLS3551 Kulturledelse,1453817412,2016-01-26 15:10:12,1453817507,95
5698d6ac41a9d72100240129,98888,KLS3551 Kulturledelse,1453919306,2016-01-27 19:28:26,1453921034,1728
5698d6ac41a9d72100240129,22930,KLS3551 Kulturledelse,1454277705,2016-01-31 23:01:45,1454277782,77
5698da4341a9d7210024068e,564,MRK3480 Forbrukeratferd,1453118905,2016-01-18 13:08:25,1453119431,526
5698da4341a9d7210024068e,7335,MRK3480 Forbrukeratferd,1453391293,2016-01-21 16:48:13,1453391302,9
5698da4341a9d7210024068e,17372,MRK3480 Forbrukeratferd,1453393235,2016-01-21 17:20:35,1453393277,42
5698da4341a9d7210024068e,13340,MRK3480 Forbrukeratferd,1453811281,2016-01-26 13:28:01,1453811464,183
5698da4341a9d7210024068e,62780,MRK3480 Forbrukeratferd,1453925726,2016-01-27 21:15:26,1453925727,1
5698da452fb0de2600f22972,41785,MRK3480 Forbrukeratferd,1453898104,2016-01-27 13:35:04,1453899681,1577
5698da452fb0de2600f22973,29465,MRK3480 Forbrukeratferd,1453048890,2016-01-17 17:41:30,1453050620,1730
5698da452fb0de2600f22973,20362,MRK3480 Forbrukeratferd,1453052206,2016-01-17 18:36:46,1453052250,44
5698da452fb0de2600f22973,12098,MRK3480 Forbrukeratferd,1454013444,2016-01-28 21:37:24,1454013664,220
5698da452fb0de2600f22974,39514,MRK3480 Forbrukeratferd,1453333416,2016-01-21 00:43:36,1453333632,216
5698da452fb0de2600f22974,11411,MRK3480 Forbrukeratferd,1453804617,2016-01-26 11:36:57,1453805434,817
5698da452fb0de2600f22976,9800,MRK3480 Forbrukeratferd,1453114166,2016-01-18 11:49:26,1453114205,39
5698da452fb0de2600f22976,68706,MRK3480 Forbrukeratferd,1453366600,2016-01-21 09:56:40,1453366743,143
5698da452fb0de2600f22976,94086,MRK3480 Forbrukeratferd,1453377880,2016-01-21 13:04:40,1453378345,465
5698da452fb0de2600f22976,35591,MRK3480 Forbrukeratferd,1453383152,2016-01-21 14:32:32,1453383177,25
5698da452fb0de2600f22976,75114,MRK3480 Forbrukeratferd,1453389046,2016-01-21 16:10:46,1453389181,135
5698da452fb0de2600f22976,48910,MRK3480 Forbrukeratferd,1453468357,2016-01-22 14:12:37,1453468440,83
5698da452fb0de2600f22976,44900,MRK3480 Forbrukeratferd,1453715011,2016-01-25 10:43:31,1453715026,15
5698da452fb0de2600f22976,16230,MRK3480 Forbrukeratferd,1453718949,2016-01-25 11:49:09,1453718957,8
5698da452fb0de2600f22976,45731,MRK3480 Forbrukeratferd,1453720783,2016-01-25 12:19:43,1453720795,12
5698da452fb0de2600f22976,3762,MRK3480 Forbrukeratferd,1453724164,2016-01-25 13:16:04,1453724183,19
5698da452fb0de2600f22976,954,MRK3480 Forbrukeratferd,1453816685,2016-01-26 14:58:05,1453816686,1
5698da452fb0de2600f22976,65087,MRK3480 Forbrukeratferd,1453929667,2016-01-27 22:21:07,1453929755,88
5698da452fb0de2600f22976,99904,MRK3480 Forbrukeratferd,1453979907,2016-01-28 12:18:27,1453979920,13
5698da452fb0de2600f22976,97706,MRK3480 Forbrukeratferd,1453987106,2016-01-28 14:18:26,1453987136,30
5698da452fb0de2600f22976,44790,MRK3480 Forbrukeratferd,1454060991,2016-01-29 10:49:51,1454061016,25
5698da452fb0de2600f22977,92568,MRK3480 Forbrukeratferd,1453056592,2016-01-17 19:49:52,1453056592,0
5698da452fb0de2600f22977,25020,MRK3480 Forbrukeratferd,1453060345,2016-01-17 20:52:25,1453060345,0
5698da452fb0de2600f22977,79550,MRK3480 Forbrukeratferd,1453283941,2016-01-20 10:59:01,1453283983,42
5698da452fb0de2600f22977,39846,MRK3480 Forbrukeratferd,1453826203,2016-01-26 17:36:43,1453826633,430
5698da452fb0de2600f22977,79581,MRK3480 Forbrukeratferd,1454273237,2016-01-31 21:47:17,1454273237,0
5698da452fb0de2600f22978,55113,MRK3480 Forbrukeratferd,1452899366,2016-01-16 00:09:26,1452899548,182
5698da452fb0de2600f22978,57330,MRK3480 Forbrukeratferd,1453158575,2016-01-19 00:09:35,1453158644,69
5698da452fb0de2600f22978,25113,MRK3480 Forbrukeratferd,1453507086,2016-01-23 00:58:06,1453507086,0
5698da452fb0de2600f22978,70200,MRK3480 Forbrukeratferd,1453795663,2016-01-26 09:07:43,1453795685,22
5698da452fb0de2600f22978,8325,MRK3480 Forbrukeratferd,1453799967,2016-01-26 10:19:27,1453800508,541
5698da452fb0de2600f22978,86962,MRK3480 Forbrukeratferd,1453926878,2016-01-27 21:34:38,1453927064,186
5698da452fb0de2600f22978,40526,MRK3480 Forbrukeratferd,1453995827,2016-01-28 16:43:47,1453996210,383
5698da452fb0de2600f22979,30617,MRK3480 Forbrukeratferd,1453040841,2016-01-17 15:27:21,1453040921,80
5698da452fb0de2600f22979,5568,MRK3480 Forbrukeratferd,1453462236,2016-01-22 12:30:36,1453462462,226
5698da452fb0de2600f22979,73864,MRK3480 Forbrukeratferd,1453805085,2016-01-26 11:44:45,1453805416,331
5698da452fb0de2600f2297b,98063,MRK3480 Forbrukeratferd,1453291144,2016-01-20 12:59:04,1453291144,0
5698da452fb0de2600f2297b,39362,MRK3480 Forbrukeratferd,1453819951,2016-01-26 15:52:31,1453820117,166
5698da452fb0de2600f2297b,2024,MRK3480 Forbrukeratferd,1453931637,2016-01-27 22:53:57,1453931750,113
5698da4541a9d72100240690,55345,MRK3480 Forbrukeratferd,1453664908,2016-01-24 20:48:28,1453665064,156
5698da4541a9d72100240690,68259,MRK3480 Forbrukeratferd,1453715295,2016-01-25 10:48:15,1453715297,2
5698da4541a9d72100240690,13873,MRK3480 Forbrukeratferd,1453970703,2016-01-28 09:45:03,1453970791,88
5698da4541a9d72100240691,41008,MRK3480 Forbrukeratferd,1452948279,2016-01-16 13:44:39,1452948846,567
5698da4541a9d72100240691,18271,MRK3480 Forbrukeratferd,1453124038,2016-01-18 14:33:58,1453124039,1
5698da4541a9d72100240691,83628,MRK3480 Forbrukeratferd,1453188044,2016-01-19 08:20:44,1453188046,2
5698da4541a9d72100240691,87816,MRK3480 Forbrukeratferd,1453328309,2016-01-20 23:18:29,1453328786,477
5698da4541a9d72100240691,54376,MRK3480 Forbrukeratferd,1453371533,2016-01-21 11:18:53,1453371535,2
5698da4541a9d72100240691,89549,MRK3480 Forbrukeratferd,1453383733,2016-01-21 14:42:13,1453383733,0
5698da4541a9d72100240691,5783,MRK3480 Forbrukeratferd,1453386015,2016-01-21 15:20:15,1453386015,0
5698da4541a9d72100240691,6915,MRK3480 Forbrukeratferd,1453455935,2016-01-22 10:45:35,1453456632,697
5698da4541a9d72100240691,23738,MRK3480 Forbrukeratferd,1453490323,2016-01-22 20:18:43,1453490327,4
5698da4541a9d72100240691,84854,MRK3480 Forbrukeratferd,1453547914,2016-01-23 12:18:34,1453547929,15
5698da4541a9d72100240691,21741,MRK3480 Forbrukeratferd,1453592149,2016-01-24 00:35:49,1453592151,2
5698da4541a9d72100240691,14102,MRK3480 Forbrukeratferd,1453889086,2016-01-27 11:04:46,1453889088,2
5698da4541a9d72100240691,77247,MRK3480 Forbrukeratferd,1453892924,2016-01-27 12:08:44,1453892924,0
5698da4541a9d72100240691,16707,MRK3480 Forbrukeratferd,1453919899,2016-01-27 19:38:19,1453920196,297
5698da4541a9d72100240691,72021,MRK3480 Forbrukeratferd,1453931876,2016-01-27 22:57:56,1453931878,2
5698da4541a9d72100240692,14583,MRK3480 Forbrukeratferd,1453131377,2016-01-18 16:36:17,1453131467,90
5698da4541a9d72100240692,76653,MRK3480 Forbrukeratferd,1453979760,2016-01-28 12:16:00,1453979807,47
5698da4541a9d72100240692,5295,MRK3480 Forbrukeratferd,1454000136,2016-01-28 17:55:36,1454000157,21
5698da4541a9d72100240692,31925,MRK3480 Forbrukeratferd,1454011645,2016-01-28 21:07:25,1454011756,111
5698da4541a9d72100240692,61631,MRK3480 Forbrukeratferd,1454071284,2016-01-29 13:41:24,1454071386,102
5698da4541a9d72100240693,86161,MRK3480 Forbrukeratferd,1452861669,2016-01-15 13:41:09,1452861740,71
5698da4541a9d72100240693,30056,MRK3480 Forbrukeratferd,1452872697,2016-01-15 16:44:57,1452872709,12
5698da4541a9d72100240693,57051,MRK3480 Forbrukeratferd,1453067162,2016-01-17 22:46:02,1453067413,251
5698da4541a9d72100240693,41910,MRK3480 Forbrukeratferd,1453125704,2016-01-18 15:01:44,1453125762,58
5698da4541a9d72100240693,85981,MRK3480 Forbrukeratferd,1453138358,2016-01-18 18:32:38,1453138358,0
5698da4541a9d72100240693,25917,MRK3480 Forbrukeratferd,1453375807,2016-01-21 12:30:07,1453375889,82
5698da4541a9d72100240693,34027,MRK3480 Forbrukeratferd,1453653915,2016-01-24 17:45:15,1453655894,1979
5698da4541a9d72100240693,13910,MRK3480 Forbrukeratferd,1453674185,2016-01-24 23:23:05,1453674186,1
5698da4541a9d72100240693,99784,MRK3480 Forbrukeratferd,1453727389,2016-01-25 14:09:49,1453727402,13
5698da4541a9d72100240693,2948,MRK3480 Forbrukeratferd,1453809230,2016-01-26 12:53:50,1453809247,17
5698da4541a9d72100240693,1644,MRK3480 Forbrukeratferd,1453911389,2016-01-27 17:16:29,1453912223,834
5698da4541a9d72100240693,16463,MRK3480 Forbrukeratferd,1453931772,2016-01-27 22:56:12,1453931772,0
5698da4541a9d72100240694,26091,MRK3480 Forbrukeratferd,1453813605,2016-01-26 14:06:45,1453813817,212
5698da4541a9d72100240694,4756,MRK3480 Forbrukeratferd,1453818074,2016-01-26 15:21:14,1453818143,69
5698da4541a9d72100240695,41718,MRK3480 Forbrukeratferd,1452955397,2016-01-16 15:43:17,1452955491,94
5698da4541a9d72100240695,6919,MRK3480 Forbrukeratferd,1453125168,2016-01-18 14:52:48,1453125168,0
5698da4541a9d72100240695,566,MRK3480 Forbrukeratferd,1453148782,2016-01-18 21:26:22,1453148785,3
5698da4541a9d72100240695,65592,MRK3480 Forbrukeratferd,1453980144,2016-01-28 12:22:24,1453980170,26
5698da4541a9d72100240695,67513,MRK3480 Forbrukeratferd,1453987017,2016-01-28 14:16:57,1453987035,18
5698da4541a9d72100240695,39566,MRK3480 Forbrukeratferd,1453990332,2016-01-28 15:12:12,1453990332,0
5698da4541a9d72100240696,26595,MRK3480 Forbrukeratferd,1453827028,2016-01-26 17:50:28,1453827028,0
5698da4641a9d72100240698,96555,MRK3480 Forbrukeratferd,1453142517,2016-01-18 19:41:57,1453142541,24
5698da4641a9d72100240698,84618,MRK3480 Forbrukeratferd,1453723374,2016-01-25 13:02:54,1453723428,54
5698da4641a9d72100240698,52194,MRK3480 Forbrukeratferd,1453909637,2016-01-27 16:47:17,1453909756,119
5698da4641a9d721002406a9,34963,MRK3480 Forbrukeratferd,1453129044,2016-01-18 15:57:24,1453129044,0
5698da4641a9d721002406a9,35521,MRK3480 Forbrukeratferd,1453132043,2016-01-18 16:47:23,1453132043,0
5698da4641a9d721002406a9,35265,MRK3480 Forbrukeratferd,1453376848,2016-01-21 12:47:28,1453376894,46
5698da4641a9d721002406a9,37915,MRK3480 Forbrukeratferd,1453724975,2016-01-25 13:29:35,1453725015,40
5698da4641a9d721002406a9,34562,MRK3480 Forbrukeratferd,1453753228,2016-01-25 21:20:28,1453753276,48
5698da4641a9d721002406a9,12555,MRK3480 Forbrukeratferd,1453811730,2016-01-26 13:35:30,1453811731,1
5698da4641a9d721002406a9,96596,MRK3480 Forbrukeratferd,1453923333,2016-01-27 20:35:33,1453923334,1
5698da472fb0de2600f2299a,10052,MRK3480 Forbrukeratferd,1452861603,2016-01-15 13:40:03,1452861648,45
5698da472fb0de2600f2299a,96399,MRK3480 Forbrukeratferd,1453374372,2016-01-21 12:06:12,1453374402,30
5698da472fb0de2600f2299a,2252,MRK3480 Forbrukeratferd,1453376526,2016-01-21 12:42:06,1453376552,26
5698da472fb0de2600f2299a,23266,MRK3480 Forbrukeratferd,1453813880,2016-01-26 14:11:20,1453813967,87
5698da472fb0de2600f2299a,36760,MRK3480 Forbrukeratferd,1453893625,2016-01-27 12:20:25,1453893704,79
5698da472fb0de2600f2299a,34872,MRK3480 Forbrukeratferd,1453896295,2016-01-27 13:04:55,1453896318,23
5698da472fb0de2600f2299b,56511,MRK3480 Forbrukeratferd,1453446773,2016-01-22 08:12:53,1453446818,45
5698da472fb0de2600f2299b,50996,MRK3480 Forbrukeratferd,1453980719,2016-01-28 12:31:59,1453980891,172
5698da472fb0de2600f2299b,70005,MRK3480 Forbrukeratferd,1453984441,2016-01-28 13:34:01,1453984493,52
5698da472fb0de2600f2299c,90264,MRK3480 Forbrukeratferd,1453377811,2016-01-21 13:03:31,1453377812,1
5698da4741a9d721002406b6,50507,MRK3480 Forbrukeratferd,1453378207,2016-01-21 13:10:07,1453378261,54
5698da4741a9d721002406b6,747,MRK3480 Forbrukeratferd,1454089268,2016-01-29 18:41:08,1454089332,64
5698da4741a9d721002406b6,93340,MRK3480 Forbrukeratferd,1454097434,2016-01-29 20:57:14,1454097580,146
5698da482fb0de2600f229a3,46300,MRK3480 Forbrukeratferd,1454025268,2016-01-29 00:54:28,1454025435,167
5698da482fb0de2600f229a4,85905,MRK3480 Forbrukeratferd,1454000526,2016-01-28 18:02:06,1454000634,108
5698da4841a9d721002406be,45161,MRK3480 Forbrukeratferd,1453375595,2016-01-21 12:26:35,1453375842,247
5698da4841a9d721002406be,5000,MRK3480 Forbrukeratferd,1453377729,2016-01-21 13:02:09,1453378174,445
5698da4841a9d721002406be,43364,MRK3480 Forbrukeratferd,1453381018,2016-01-21 13:56:58,1453381021,3
5698da4841a9d721002406be,38720,MRK3480 Forbrukeratferd,1453979830,2016-01-28 12:17:10,1453979891,61
5698da4841a9d721002406be,55013,MRK3480 Forbrukeratferd,1453986679,2016-01-28 14:11:19,1453987270,591
5698da4841a9d721002406be,73580,MRK3480 Forbrukeratferd,1454190344,2016-01-30 22:45:44,1454190492,148
5698da4841a9d721002406be,26981,MRK3480 Forbrukeratferd,1454255890,2016-01-31 16:58:10,1454256284,394
5698da4841a9d721002406bf,94845,MRK3480 Forbrukeratferd,1453043971,2016-01-17 16:19:31,1453043990,19
5698da4841a9d721002406bf,25983,MRK3480 Forbrukeratferd,1453374556,2016-01-21 12:09:16,1453375399,843
5698da4841a9d721002406bf,34280,MRK3480 Forbrukeratferd,1453378214,2016-01-21 13:10:14,1453378430,216
5698da4841a9d721002406bf,51633,MRK3480 Forbrukeratferd,1453979854,2016-01-28 12:17:34,1453979966,112
5698da4841a9d721002406bf,77307,MRK3480 Forbrukeratferd,1453983099,2016-01-28 13:11:39,1453983111,12
5698da492fb0de2600f229a5,35280,MRK3480 Forbrukeratferd,1453374831,2016-01-21 12:13:51,1453374831,0
5698da492fb0de2600f229a5,3768,MRK3480 Forbrukeratferd,1453376554,2016-01-21 12:42:34,1453378032,1478
5698da492fb0de2600f229a5,55329,MRK3480 Forbrukeratferd,1453380139,2016-01-21 13:42:19,1453380143,4
5698da492fb0de2600f229a5,28477,MRK3480 Forbrukeratferd,1453979039,2016-01-28 12:03:59,1453979921,882
5698da492fb0de2600f229a5,83691,MRK3480 Forbrukeratferd,1454024802,2016-01-29 00:46:42,1454026889,2087
5698da492fb0de2600f229a6,4921,MRK3480 Forbrukeratferd,1453141300,2016-01-18 19:21:40,1453141710,410
5698da492fb0de2600f229a6,96091,MRK3480 Forbrukeratferd,1453212680,2016-01-19 15:11:20,1453212722,42
5698da492fb0de2600f229a6,19434,MRK3480 Forbrukeratferd,1453370944,2016-01-21 11:09:04,1453371107,163
5698da492fb0de2600f229a6,33433,MRK3480 Forbrukeratferd,1453979104,2016-01-28 12:05:04,1453979181,77
5698da492fb0de2600f229a6,23999,MRK3480 Forbrukeratferd,1453993490,2016-01-28 16:04:50,1453994477,987
5698da492fb0de2600f229a6,7783,MRK3480 Forbrukeratferd,1453996733,2016-01-28 16:58:53,1453996737,4
5698da492fb0de2600f229a6,97800,MRK3480 Forbrukeratferd,1454012310,2016-01-28 21:18:30,1454012311,1
5698da492fb0de2600f229a7,22294,MRK3480 Forbrukeratferd,1453209043,2016-01-19 14:10:43,1453209161,118
5698da492fb0de2600f229a7,64408,MRK3480 Forbrukeratferd,1453372711,2016-01-21 11:38:31,1453372810,99
5698da492fb0de2600f229a7,29596,MRK3480 Forbrukeratferd,1453720238,2016-01-25 12:10:38,1453720273,35
5698da492fb0de2600f229a7,58345,MRK3480 Forbrukeratferd,1453725162,2016-01-25 13:32:42,1453725164,2
5698da492fb0de2600f229a7,78159,MRK3480 Forbrukeratferd,1453802285,2016-01-26 10:58:05,1453802285,0
5698da492fb0de2600f229a7,54338,MRK3480 Forbrukeratferd,1453999497,2016-01-28 17:44:57,1453999667,170
5698da492fb0de2600f229a8,85456,MRK3480 Forbrukeratferd,1453146873,2016-01-18 20:54:33,1453147387,514
5698da492fb0de2600f229a8,55543,MRK3480 Forbrukeratferd,1453306897,2016-01-20 17:21:37,1453306908,11
5698da492fb0de2600f229a9,83532,MRK3480 Forbrukeratferd,1452905131,2016-01-16 01:45:31,1452905323,192
5698da492fb0de2600f229a9,70370,MRK3480 Forbrukeratferd,1453123511,2016-01-18 14:25:11,1453124103,592
5698da492fb0de2600f229a9,75464,MRK3480 Forbrukeratferd,1453682053,2016-01-25 01:34:13,1453682261,208
5698da4941a9d721002406c1,90818,MRK3480 Forbrukeratferd,1453374012,2016-01-21 12:00:12,1453374144,132
5698da4941a9d721002406c1,51708,MRK3480 Forbrukeratferd,1453747062,2016-01-25 19:37:42,1453747073,11
5698da4941a9d721002406c1,68436,MRK3480 Forbrukeratferd,1453818227,2016-01-26 15:23:47,1453818374,147
5698da4941a9d721002406c1,5374,MRK3480 Forbrukeratferd,1453892776,2016-01-27 12:06:16,1453892824,48
5698da4941a9d721002406c1,76892,MRK3480 Forbrukeratferd,1453978512,2016-01-28 11:55:12,1453978632,120
5698da4941a9d721002406c2,74773,MRK3480 Forbrukeratferd,1452865107,2016-01-15 14:38:27,1452865141,34
5698da4941a9d721002406c2,84298,MRK3480 Forbrukeratferd,1452867367,2016-01-15 15:16:07,1452867570,203
5698da4941a9d721002406c2,19484,MRK3480 Forbrukeratferd,1452872644,2016-01-15 16:44:04,1452873553,909
5698da4941a9d721002406c2,3911,MRK3480 Forbrukeratferd,1453334412,2016-01-21 01:00:12,1453334548,136
5698da4941a9d721002406c2,2230,MRK3480 Forbrukeratferd,1453340352,2016-01-21 02:39:12,1453341038,686
5698da4941a9d721002406c2,48121,MRK3480 Forbrukeratferd,1453675570,2016-01-24 23:46:10,1453675575,5
5698da4941a9d721002406c2,71652,MRK3480 Forbrukeratferd,1453948497,2016-01-28 03:34:57,1453948923,426
5698da4941a9d721002406c3,54036,MRK3480 Forbrukeratferd,1452861687,2016-01-15 13:41:27,1452861989,302
5698da4941a9d721002406c3,91425,MRK3480 Forbrukeratferd,1452872721,2016-01-15 16:45:21,1452872754,33
5698da4941a9d721002406c3,33661,MRK3480 Forbrukeratferd,1452882839,2016-01-15 19:33:59,1452884995,2156
5698da4941a9d721002406c3,30279,MRK3480 Forbrukeratferd,1452983025,2016-01-16 23:23:45,1452983027,2
5698da4941a9d721002406c3,96867,MRK3480 Forbrukeratferd,1453054317,2016-01-17 19:11:57,1453054317,0
5698da4941a9d721002406c3,21413,MRK3480 Forbrukeratferd,1453061153,2016-01-17 21:05:53,1453061178,25
5698da4941a9d721002406c3,32537,MRK3480 Forbrukeratferd,1453119015,2016-01-18 13:10:15,1453119015,0
5698da4941a9d721002406c3,21504,MRK3480 Forbrukeratferd,1453374333,2016-01-21 12:05:33,1453374506,173
5698da4941a9d721002406c3,35491,MRK3480 Forbrukeratferd,1453377695,2016-01-21 13:01:35,1453378434,739
5698da4941a9d721002406c3,11921,MRK3480 Forbrukeratferd,1453730663,2016-01-25 15:04:23,1453730669,6
5698da4941a9d721002406c3,35122,MRK3480 Forbrukeratferd,1453979139,2016-01-28 12:05:39,1453979208,69
5698da4941a9d721002406c3,41765,MRK3480 Forbrukeratferd,1453997797,2016-01-28 17:16:37,1454000870,3073
5698da4941a9d721002406c4,94873,MRK3480 Forbrukeratferd,1453980100,2016-01-28 12:21:40,1453980438,338
5698da4941a9d721002406c4,13577,MRK3480 Forbrukeratferd,1453985999,2016-01-28 13:59:59,1453986079,80
5698da4941a9d721002406c4,85549,MRK3480 Forbrukeratferd,1454011334,2016-01-28 21:02:14,1454011353,19
5698da4a2fb0de2600f229c2,89181,MRK3480 Forbrukeratferd,1453160891,2016-01-19 00:48:11,1453160960,69
5698da4a2fb0de2600f229c2,95609,MRK3480 Forbrukeratferd,1453645262,2016-01-24 15:21:02,1453645268,6
5698da4a41a9d721002406de,51093,MRK3480 Forbrukeratferd,1453761183,2016-01-25 23:33:03,1453761219,36
5698da4a41a9d721002406de,79,MRK3480 Forbrukeratferd,1453763239,2016-01-26 00:07:19,1453764396,1157
5698da4a41a9d721002406de,16597,MRK3480 Forbrukeratferd,1453816292,2016-01-26 14:51:32,1453816610,318
5698da4a41a9d721002406de,37157,MRK3480 Forbrukeratferd,1453818577,2016-01-26 15:29:37,1453818577,0
5698da4b2fb0de2600f229c4,7955,MRK3480 Forbrukeratferd,1452867018,2016-01-15 15:10:18,1452867026,8
5698da4b2fb0de2600f229c4,98580,MRK3480 Forbrukeratferd,1452872269,2016-01-15 16:37:49,1452872269,0
5698da4b2fb0de2600f229c4,18543,MRK3480 Forbrukeratferd,1453809701,2016-01-26 13:01:41,1453809702,1
5698da4b2fb0de2600f229c4,92847,MRK3480 Forbrukeratferd,1453912184,2016-01-27 17:29:44,1453912185,1
5698da4b2fb0de2600f229c5,93095,MRK3480 Forbrukeratferd,1453376866,2016-01-21 12:47:46,1453377803,937
5698da4b2fb0de2600f229c5,69148,MRK3480 Forbrukeratferd,1453604587,2016-01-24 04:03:07,1453604588,1
5698da4b2fb0de2600f229c6,49856,MRK3480 Forbrukeratferd,1453375613,2016-01-21 12:26:53,1453375710,97
5698da4b2fb0de2600f229c6,70433,MRK3480 Forbrukeratferd,1453378143,2016-01-21 13:09:03,1453378769,626
5698da4b2fb0de2600f229c6,53268,MRK3480 Forbrukeratferd,1453979892,2016-01-28 12:18:12,1453979925,33
5698da4b2fb0de2600f229c8,39202,MRK3480 Forbrukeratferd,1453135500,2016-01-18 17:45:00,1453136044,544
5698da4b2fb0de2600f229c8,36541,MRK3480 Forbrukeratferd,1453292756,2016-01-20 13:25:56,1453295004,2248
5698da4b2fb0de2600f229c8,16930,MRK3480 Forbrukeratferd,1453296647,2016-01-20 14:30:47,1453296666,19
5698da4b2fb0de2600f229c8,7223,MRK3480 Forbrukeratferd,1453297889,2016-01-20 14:51:29,1453297895,6
5698da4b2fb0de2600f229c8,79681,MRK3480 Forbrukeratferd,1453300790,2016-01-20 15:39:50,1453300833,43
5698da4b2fb0de2600f229c8,66699,MRK3480 Forbrukeratferd,1453304109,2016-01-20 16:35:09,1453304130,21
5698da4b2fb0de2600f229c8,81823,MRK3480 Forbrukeratferd,1453308083,2016-01-20 17:41:23,1453308099,16
5698da4b2fb0de2600f229c9,76754,MRK3480 Forbrukeratferd,1453377075,2016-01-21 12:51:15,1453378004,929
5698da4b41a9d721002406e0,11361,MRK3480 Forbrukeratferd,1453072736,2016-01-18 00:18:56,1453073200,464
5698da4b41a9d721002406e0,49677,MRK3480 Forbrukeratferd,1453843166,2016-01-26 22:19:26,1453844448,1282
5698da4b41a9d721002406e2,38309,MRK3480 Forbrukeratferd,1453376891,2016-01-21 12:48:11,1453376965,74
5698da4b41a9d721002406e2,93416,MRK3480 Forbrukeratferd,1453387214,2016-01-21 15:40:14,1453388165,951
5698da4b41a9d721002406e2,92911,MRK3480 Forbrukeratferd,1453804993,2016-01-26 11:43:13,1453805118,125
5698da4b41a9d721002406e2,61064,MRK3480 Forbrukeratferd,1453968712,2016-01-28 09:11:52,1453968713,1
5698da4b41a9d721002406e2,1092,MRK3480 Forbrukeratferd,1453988926,2016-01-28 14:48:46,1453989340,414
5698da4c2fb0de2600f229cb,41520,MRK3480 Forbrukeratferd,1453119408,2016-01-18 13:16:48,1453119525,117
5698da4c2fb0de2600f229cb,96453,MRK3480 Forbrukeratferd,1453125546,2016-01-18 14:59:06,1453125604,58
5698da4c2fb0de2600f229cb,35084,MRK3480 Forbrukeratferd,1453151736,2016-01-18 22:15:36,1453152294,558
5698da4c2fb0de2600f229cb,21336,MRK3480 Forbrukeratferd,1453201650,2016-01-19 12:07:30,1453201650,0
5698da4c2fb0de2600f229cb,49607,MRK3480 Forbrukeratferd,1453203004,2016-01-19 12:30:04,1453203157,153
5698da4c2fb0de2600f229cb,63144,MRK3480 Forbrukeratferd,1453224613,2016-01-19 18:30:13,1453224614,1
5698da4c2fb0de2600f229cb,53697,MRK3480 Forbrukeratferd,1453297832,2016-01-20 14:50:32,1453297832,0
5698da4c2fb0de2600f229cb,16101,MRK3480 Forbrukeratferd,1453674591,2016-01-24 23:29:51,1453674678,87
5698da4c2fb0de2600f229cb,16875,MRK3480 Forbrukeratferd,1453728323,2016-01-25 14:25:23,1453728343,20
5698da4c2fb0de2600f229cb,70486,MRK3480 Forbrukeratferd,1453805763,2016-01-26 11:56:03,1453810513,4750
5698da4c2fb0de2600f229cb,33134,MRK3480 Forbrukeratferd,1453812638,2016-01-26 13:50:38,1453812638,0
5698da4c2fb0de2600f229cb,49805,MRK3480 Forbrukeratferd,1453977260,2016-01-28 11:34:20,1453977415,155
5698da4c2fb0de2600f229cc,98529,MRK3480 Forbrukeratferd,1453927148,2016-01-27 21:39:08,1453927316,168
5698da4c2fb0de2600f229cc,21730,MRK3480 Forbrukeratferd,1453990385,2016-01-28 15:13:05,1453990410,25
5698da4c2fb0de2600f229cc,85601,MRK3480 Forbrukeratferd,1453993401,2016-01-28 16:03:21,1453993495,94
5698da4c2fb0de2600f229ce,25302,MRK3480 Forbrukeratferd,1453071400,2016-01-17 23:56:40,1453071465,65
5698da4c2fb0de2600f229ce,3178,MRK3480 Forbrukeratferd,1453289862,2016-01-20 12:37:42,1453290242,380
5698da4c2fb0de2600f229ce,61141,MRK3480 Forbrukeratferd,1453719088,2016-01-25 11:51:28,1453719101,13
5698da4c2fb0de2600f229ce,33262,MRK3480 Forbrukeratferd,1453916234,2016-01-27 18:37:14,1453916250,16
5698da4c2fb0de2600f229ce,91205,MRK3480 Forbrukeratferd,1453938265,2016-01-28 00:44:25,1453938265,0
5698da4c2fb0de2600f229ce,13118,MRK3480 Forbrukeratferd,1453980355,2016-01-28 12:25:55,1453980542,187
5698da4c2fb0de2600f229d2,1438,MRK3480 Forbrukeratferd,1453224207,2016-01-19 18:23:27,1453224233,26
5698da4c2fb0de2600f229d2,58088,MRK3480 Forbrukeratferd,1453745117,2016-01-25 19:05:17,1453745594,477
5698da4c2fb0de2600f229d2,29019,MRK3480 Forbrukeratferd,1453937028,2016-01-28 00:23:48,1453937789,761
5698da4c2fb0de2600f229d2,12854,MRK3480 Forbrukeratferd,1453973273,2016-01-28 10:27:53,1453973384,111
5698da4c2fb0de2600f229d2,90218,MRK3480 Forbrukeratferd,1453995732,2016-01-28 16:42:12,1453995744,12
5698da4c41a9d721002406e4,82872,MRK3480 Forbrukeratferd,1453147574,2016-01-18 21:06:14,1453147637,63
5698da4c41a9d721002406e4,59564,MRK3480 Forbrukeratferd,1453148872,2016-01-18 21:27:52,1453148872,0
5698da4c41a9d721002406e4,42366,MRK3480 Forbrukeratferd,1453151512,2016-01-18 22:11:52,1453151515,3
5698da4c41a9d721002406e4,30267,MRK3480 Forbrukeratferd,1453159442,2016-01-19 00:24:02,1453159507,65
5698da4c41a9d721002406e4,63965,MRK3480 Forbrukeratferd,1453231257,2016-01-19 20:20:57,1453231279,22
5698da4c41a9d721002406e4,98065,MRK3480 Forbrukeratferd,1453239192,2016-01-19 22:33:12,1453239204,12
5698da4c41a9d721002406e4,82344,MRK3480 Forbrukeratferd,1453244201,2016-01-19 23:56:41,1453244202,1
5698da4c41a9d721002406e4,45570,MRK3480 Forbrukeratferd,1453720663,2016-01-25 12:17:43,1453720708,45
5698da4c41a9d721002406e6,15540,MRK3480 Forbrukeratferd,1453155651,2016-01-18 23:20:51,1453155752,101
5698da4c41a9d721002406e6,48255,MRK3480 Forbrukeratferd,1453223583,2016-01-19 18:13:03,1453223685,102
5698da4c41a9d721002406e6,47877,MRK3480 Forbrukeratferd,1453309977,2016-01-20 18:12:57,1453309990,13
5698da4c41a9d721002406e6,30990,MRK3480 Forbrukeratferd,1453325203,2016-01-20 22:26:43,1453325208,5
5698da4c41a9d721002406e6,67160,MRK3480 Forbrukeratferd,1453374760,2016-01-21 12:12:40,1453374761,1
5698da4c41a9d721002406e6,71857,MRK3480 Forbrukeratferd,1453382085,2016-01-21 14:14:45,1453382085,0
5698da4c41a9d721002406e6,73371,MRK3480 Forbrukeratferd,1453395523,2016-01-21 17:58:43,1453395605,82
5698da4c41a9d721002406e7,97663,MRK3480 Forbrukeratferd,1453378186,2016-01-21 13:09:46,1453378436,250
5698da4c41a9d721002406ea,24217,MRK3480 Forbrukeratferd,1453389293,2016-01-21 16:14:53,1453389779,486
5698da4c41a9d721002406ec,781,MRK3480 Forbrukeratferd,1452868943,2016-01-15 15:42:23,1452869071,128
5698da4c41a9d721002406ec,18712,MRK3480 Forbrukeratferd,1452874431,2016-01-15 17:13:51,1452874460,29
5698da4c41a9d721002406ec,76972,MRK3480 Forbrukeratferd,1452880275,2016-01-15 18:51:15,1452880743,468
5698da4c41a9d721002406ec,79908,MRK3480 Forbrukeratferd,1453118981,2016-01-18 13:09:41,1453118987,6
5698da4c41a9d721002406ec,76965,MRK3480 Forbrukeratferd,1453195058,2016-01-19 10:17:38,1453195965,907
5698da4c41a9d721002406ec,45925,MRK3480 Forbrukeratferd,1453378588,2016-01-21 13:16:28,1453378607,19
5698da4c41a9d721002406ec,57956,MRK3480 Forbrukeratferd,1453386080,2016-01-21 15:21:20,1453386118,38
5698da4c41a9d721002406ec,67307,nan,1453639193,2016-01-24 13:39:53,1453639194,1
5698da4c41a9d721002406ec,76192,MRK3480 Forbrukeratferd,1453678715,2016-01-25 00:38:35,1453678737,22
5698da4c41a9d721002406ec,44579,MRK3480 Forbrukeratferd,1453716460,2016-01-25 11:07:40,1453716522,62
5698da4c41a9d721002406ec,1745,MRK3480 Forbrukeratferd,1453978873,2016-01-28 12:01:13,1453979791,918
5698da4c41a9d721002406ec,52142,MRK3480 Forbrukeratferd,1454255766,2016-01-31 16:56:06,1454255970,204
5698da4c41a9d721002406ec,39733,MRK3480 Forbrukeratferd,1454272486,2016-01-31 21:34:46,1454272501,15
5698da4d41a9d72100240706,5263,MRK3480 Forbrukeratferd,1453378375,2016-01-21 13:12:55,1453378393,18
5698da4d41a9d72100240706,39217,MRK3480 Forbrukeratferd,1453384820,2016-01-21 15:00:20,1453384825,5
5698da4d41a9d72100240706,21087,MRK3480 Forbrukeratferd,1453389005,2016-01-21 16:10:05,1453389120,115
5698da4e2fb0de2600f229ea,10909,MRK3480 Forbrukeratferd,1453213584,2016-01-19 15:26:24,1453213948,364
5698da4e2fb0de2600f229ea,34234,MRK3480 Forbrukeratferd,1453914279,2016-01-27 18:04:39,1453914482,203
5698da4e2fb0de2600f229ea,81018,MRK3480 Forbrukeratferd,1453917711,2016-01-27 19:01:51,1453917711,0
5698da4e2fb0de2600f229ea,82861,MRK3480 Forbrukeratferd,1453979357,2016-01-28 12:09:17,1453979375,18
5698da4e2fb0de2600f229ea,28540,MRK3480 Forbrukeratferd,1453980617,2016-01-28 12:30:17,1453980689,72
5698da4e2fb0de2600f229eb,44390,MRK3480 Forbrukeratferd,1453304393,2016-01-20 16:39:53,1453304642,249
5698da4e2fb0de2600f229eb,90104,MRK3480 Forbrukeratferd,1453311972,2016-01-20 18:46:12,1453311982,10
5698da4e2fb0de2600f229eb,32827,MRK3480 Forbrukeratferd,1453321983,2016-01-20 21:33:03,1453321985,2
5698da4e2fb0de2600f229eb,79741,MRK3480 Forbrukeratferd,1453838292,2016-01-26 20:58:12,1453838508,216
5698da4e2fb0de2600f229eb,44289,MRK3480 Forbrukeratferd,1454072301,2016-01-29 13:58:21,1454072324,23
5698da4e2fb0de2600f229eb,58412,MRK3480 Forbrukeratferd,1454075813,2016-01-29 14:56:53,1454076755,942
5698da4e2fb0de2600f229ec,268,MRK3480 Forbrukeratferd,1453219473,2016-01-19 17:04:33,1453219503,30
5698da4e2fb0de2600f229ec,42913,MRK3480 Forbrukeratferd,1453980115,2016-01-28 12:21:55,1453980295,180
5698da4e41a9d72100240707,91466,MRK3480 Forbrukeratferd,1452913830,2016-01-16 04:10:30,1452913837,7
5698da4e41a9d72100240707,47345,MRK3480 Forbrukeratferd,1453151829,2016-01-18 22:17:09,1453151915,86
5698da4e41a9d72100240707,29622,MRK3480 Forbrukeratferd,1453259992,2016-01-20 04:19:52,1453260232,240
5698da4e41a9d72100240707,67748,MRK3480 Forbrukeratferd,1453333505,2016-01-21 00:45:05,1453333870,365
5698da4e41a9d72100240707,53100,MRK3480 Forbrukeratferd,1453680606,2016-01-25 01:10:06,1453680608,2
5698da4e41a9d72100240707,15374,MRK3480 Forbrukeratferd,1453765261,2016-01-26 00:41:01,1453765263,2
5698da4e41a9d72100240707,53652,MRK3480 Forbrukeratferd,1453810378,2016-01-26 13:12:58,1453810378,0
5698da4e41a9d72100240707,3161,MRK3480 Forbrukeratferd,1453911397,2016-01-27 17:16:37,1453911398,1
5698da4e41a9d72100240707,82109,MRK3480 Forbrukeratferd,1453941116,2016-01-28 01:31:56,1453941161,45
5698da4e41a9d72100240707,86338,MRK3480 Forbrukeratferd,1453953017,2016-01-28 04:50:17,1453954252,1235
5698da4e41a9d72100240708,62085,MRK3480 Forbrukeratferd,1452862649,2016-01-15 13:57:29,1452862714,65
5698da4e41a9d72100240708,3272,MRK3480 Forbrukeratferd,1453132827,2016-01-18 17:00:27,1453132869,42
5698da4e41a9d72100240708,71404,MRK3480 Forbrukeratferd,1453228156,2016-01-19 19:29:16,1453228230,74
5698da4e41a9d72100240708,7226,MRK3480 Forbrukeratferd,1453322840,2016-01-20 21:47:20,1453323293,453
5698da4e41a9d72100240708,69484,MRK3480 Forbrukeratferd,1453331065,2016-01-21 00:04:25,1453331305,240
5698da4e41a9d72100240708,50252,MRK3480 Forbrukeratferd,1453370355,2016-01-21 10:59:15,1453370564,209
5698da4e41a9d72100240708,56224,MRK3480 Forbrukeratferd,1453374331,2016-01-21 12:05:31,1453374331,0
5698da4e41a9d72100240708,36930,MRK3480 Forbrukeratferd,1453375820,2016-01-21 12:30:20,1453376029,209
5698da4e41a9d72100240708,29326,MRK3480 Forbrukeratferd,1453381300,2016-01-21 14:01:40,1453381301,1
5698da4e41a9d72100240708,3134,MRK3480 Forbrukeratferd,1453397651,2016-01-21 18:34:11,1453397663,12
5698da4e41a9d72100240708,63442,MRK3480 Forbrukeratferd,1453575138,2016-01-23 19:52:18,1453575179,41
5698da4e41a9d72100240708,79991,MRK3480 Forbrukeratferd,1453577751,2016-01-23 20:35:51,1453577752,1
5698da4e41a9d72100240708,35533,MRK3480 Forbrukeratferd,1453637581,2016-01-24 13:13:01,1453637599,18
5698da4e41a9d72100240708,85599,MRK3480 Forbrukeratferd,1453675578,2016-01-24 23:46:18,1453676577,999
5698da4e41a9d72100240708,77074,MRK3480 Forbrukeratferd,1453725019,2016-01-25 13:30:19,1453725025,6
5698da4e41a9d72100240708,57734,MRK3480 Forbrukeratferd,1453754946,2016-01-25 21:49:06,1453754947,1
5698da4e41a9d72100240708,30837,MRK3480 Forbrukeratferd,1453914098,2016-01-27 18:01:38,1453914137,39
5698da4e41a9d72100240708,32859,MRK3480 Forbrukeratferd,1453978679,2016-01-28 11:57:59,1453978765,86
5698da4e41a9d72100240708,94373,MRK3480 Forbrukeratferd,1453980645,2016-01-28 12:30:45,1453981475,830
5698da4e41a9d72100240708,25599,MRK3480 Forbrukeratferd,1453987635,2016-01-28 14:27:15,1453987647,12
5698da4e41a9d72100240709,21655,MRK3480 Forbrukeratferd,1452864483,2016-01-15 14:28:03,1452864483,0
5698da4e41a9d72100240709,27236,MRK3480 Forbrukeratferd,1453288096,2016-01-20 12:08:16,1453288117,21
5698da4e41a9d72100240709,98024,MRK3480 Forbrukeratferd,1453724644,2016-01-25 13:24:04,1453724651,7
5698da4e41a9d72100240709,15150,MRK3480 Forbrukeratferd,1453726300,2016-01-25 13:51:40,1453726332,32
5698da4e41a9d72100240709,30790,MRK3480 Forbrukeratferd,1453895315,2016-01-27 12:48:35,1453895489,174
5698da4e41a9d72100240709,9862,MRK3480 Forbrukeratferd,1453982984,2016-01-28 13:09:44,1453983035,51
5698da4f2fb0de2600f229f7,90692,MRK3480 Forbrukeratferd,1453139351,2016-01-18 18:49:11,1453139502,151
5698da4f2fb0de2600f229f7,64252,MRK3480 Forbrukeratferd,1453213645,2016-01-19 15:27:25,1453213885,240
5698da4f2fb0de2600f229f7,85337,MRK3480 Forbrukeratferd,1453386180,2016-01-21 15:23:00,1453387009,829
5698da4f2fb0de2600f229f7,94148,MRK3480 Forbrukeratferd,1453388830,2016-01-21 16:07:10,1453389420,590
5698da4f2fb0de2600f229f7,21622,MRK3480 Forbrukeratferd,1453391761,2016-01-21 16:56:01,1453392366,605
5698da4f2fb0de2600f229f7,48261,MRK3480 Forbrukeratferd,1453942499,2016-01-28 01:54:59,1453942692,193
5698da4f2fb0de2600f229f7,47287,MRK3480 Forbrukeratferd,1454008073,2016-01-28 20:07:53,1454008998,925
5698da4f2fb0de2600f229f7,58391,MRK3480 Forbrukeratferd,1454010927,2016-01-28 20:55:27,1454010928,1
5698da4f2fb0de2600f229f8,76890,MRK3480 Forbrukeratferd,1453215890,2016-01-19 16:04:50,1453216084,194
5698da4f2fb0de2600f229f9,93178,MRK3480 Forbrukeratferd,1453379131,2016-01-21 13:25:31,1453379353,222
5698da4f2fb0de2600f229f9,10467,MRK3480 Forbrukeratferd,1453918665,2016-01-27 19:17:45,1453918874,209
5698da4f2fb0de2600f229fa,21191,MRK3480 Forbrukeratferd,1452877338,2016-01-15 18:02:18,1452877553,215
5698da4f2fb0de2600f229fa,96445,MRK3480 Forbrukeratferd,1452887956,2016-01-15 20:59:16,1452888828,872
5698da4f2fb0de2600f229fa,5873,MRK3480 Forbrukeratferd,1452957417,2016-01-16 16:16:57,1452958604,1187
5698da4f2fb0de2600f229fa,30010,MRK3480 Forbrukeratferd,1453151616,2016-01-18 22:13:36,1453151869,253
5698da4f2fb0de2600f229fa,29795,MRK3480 Forbrukeratferd,1453327938,2016-01-20 23:12:18,1453328064,126
5698da4f2fb0de2600f229fa,5136,MRK3480 Forbrukeratferd,1453375934,2016-01-21 12:32:14,1453376075,141
5698da4f2fb0de2600f229fa,48506,MRK3480 Forbrukeratferd,1453405362,2016-01-21 20:42:42,1453405368,6
5698da4f2fb0de2600f229fa,42951,MRK3480 Forbrukeratferd,1453676980,2016-01-25 00:09:40,1453677398,418
5698da4f2fb0de2600f229fa,95237,MRK3480 Forbrukeratferd,1453728078,2016-01-25 14:21:18,1453728085,7
5698da4f2fb0de2600f229fa,93478,MRK3480 Forbrukeratferd,1454020986,2016-01-28 23:43:06,1454021034,48
5698da4f2fb0de2600f229fa,66160,MRK3480 Forbrukeratferd,1454025188,2016-01-29 00:53:08,1454025189,1
5698da4f2fb0de2600f229fb,44663,MRK3480 Forbrukeratferd,1453978185,2016-01-28 11:49:45,1453979251,1066
5698da4f2fb0de2600f229fb,34850,MRK3480 Forbrukeratferd,1453981033,2016-01-28 12:37:13,1453982325,1292
5698da4f2fb0de2600f229fb,34616,MRK3480 Forbrukeratferd,1453988423,2016-01-28 14:40:23,1453988441,18
5698da4f41a9d7210024070f,62704,MRK3480 Forbrukeratferd,1453374544,2016-01-21 12:09:04,1453374545,1
5698da4f41a9d7210024070f,24772,MRK3480 Forbrukeratferd,1453376831,2016-01-21 12:47:11,1453378576,1745
5698da4f41a9d7210024070f,1917,MRK3480 Forbrukeratferd,1453983184,2016-01-28 13:13:04,1453983274,90
5698da4f41a9d7210024070f,55685,MRK3480 Forbrukeratferd,1454015082,2016-01-28 22:04:42,1454015236,154
5698da4f41a9d7210024070f,85114,MRK3480 Forbrukeratferd,1454176287,2016-01-30 18:51:27,1454176377,90
5698da4f41a9d72100240710,87268,MRK3480 Forbrukeratferd,1453061975,2016-01-17 21:19:35,1453062166,191
5698da4f41a9d72100240710,53984,MRK3480 Forbrukeratferd,1453165141,2016-01-19 01:59:01,1453165238,97
5698da4f41a9d72100240710,84735,MRK3480 Forbrukeratferd,1453911902,2016-01-27 17:25:02,1453911935,33
5698da4f41a9d72100240710,88259,MRK3480 Forbrukeratferd,1453983203,2016-01-28 13:13:23,1453983234,31
5698da5041a9d72100240714,20082,MRK3480 Forbrukeratferd,1453893648,2016-01-27 12:20:48,1453893785,137
5698da5041a9d72100240714,75548,MRK3480 Forbrukeratferd,1453897738,2016-01-27 13:28:58,1453898813,1075
5698da5041a9d72100240714,88951,MRK3480 Forbrukeratferd,1453903525,2016-01-27 15:05:25,1453903527,2
5698da5041a9d72100240714,93248,MRK3480 Forbrukeratferd,1453979112,2016-01-28 12:05:12,1453979251,139
5698da5041a9d72100240717,4964,MRK3480 Forbrukeratferd,1453378194,2016-01-21 13:09:54,1453378713,519
5698da5041a9d72100240717,75753,MRK3480 Forbrukeratferd,1453473311,2016-01-22 15:35:11,1453473664,353
5698da5041a9d72100240717,87624,MRK3480 Forbrukeratferd,1453565727,2016-01-23 17:15:27,1453565728,1
5698da5041a9d72100240717,12185,MRK3480 Forbrukeratferd,1453986988,2016-01-28 14:16:28,1453987001,13
5698da5041a9d72100240717,76580,MRK3480 Forbrukeratferd,1454205325,2016-01-31 02:55:25,1454205540,215
5698da512fb0de2600f22a12,87778,MRK3480 Forbrukeratferd,1454066250,2016-01-29 12:17:30,1454067490,1240
5698da512fb0de2600f22a13,8070,MRK3480 Forbrukeratferd,1452862742,2016-01-15 13:59:02,1452863139,397
5698da512fb0de2600f22a13,79401,MRK3480 Forbrukeratferd,1452905296,2016-01-16 01:48:16,1452905327,31
5698da512fb0de2600f22a13,83998,MRK3480 Forbrukeratferd,1452963998,2016-01-16 18:06:38,1452964223,225
5698da512fb0de2600f22a13,54161,MRK3480 Forbrukeratferd,1452987807,2016-01-17 00:43:27,1452987932,125
5698da512fb0de2600f22a13,93449,MRK3480 Forbrukeratferd,1453032890,2016-01-17 13:14:50,1453032913,23
5698da512fb0de2600f22a13,60149,MRK3480 Forbrukeratferd,1453125633,2016-01-18 15:00:33,1453125662,29
5698da512fb0de2600f22a13,7019,MRK3480 Forbrukeratferd,1453675916,2016-01-24 23:51:56,1453676253,337
5698da512fb0de2600f22a13,56769,MRK3480 Forbrukeratferd,1453736318,2016-01-25 16:38:38,1453736319,1
5698da512fb0de2600f22a13,22224,MRK3480 Forbrukeratferd,1453807072,2016-01-26 12:17:52,1453807075,3
5698da512fb0de2600f22a13,72256,MRK3480 Forbrukeratferd,1453977806,2016-01-28 11:43:26,1453977866,60
5698da5141a9d7210024072e,44003,MRK3480 Forbrukeratferd,1453757102,2016-01-25 22:25:02,1453757161,59
5698da5141a9d7210024072e,77396,MRK3480 Forbrukeratferd,1454099150,2016-01-29 21:25:50,1454100066,916
5698da522fb0de2600f22a17,80400,MRK3480 Forbrukeratferd,1453379997,2016-01-21 13:39:57,1453379997,0
5698da522fb0de2600f22a17,26644,MRK3480 Forbrukeratferd,1453713970,2016-01-25 10:26:10,1453714016,46
5698da522fb0de2600f22a19,36014,MRK3480 Forbrukeratferd,1453120575,2016-01-18 13:36:15,1453120808,233
5698da522fb0de2600f22a19,35153,MRK3480 Forbrukeratferd,1453131636,2016-01-18 16:40:36,1453131779,143
5698da522fb0de2600f22a19,70297,MRK3480 Forbrukeratferd,1453145279,2016-01-18 20:27:59,1453145297,18
5698da522fb0de2600f22a19,45284,MRK3480 Forbrukeratferd,1453220224,2016-01-19 17:17:04,1453220225,1
5698da522fb0de2600f22a19,37691,MRK3480 Forbrukeratferd,1453374483,2016-01-21 12:08:03,1453375804,1321
5698da522fb0de2600f22a19,44296,MRK3480 Forbrukeratferd,1453384963,2016-01-21 15:02:43,1453385187,224
5698da522fb0de2600f22a19,43694,MRK3480 Forbrukeratferd,1453986696,2016-01-28 14:11:36,1453986812,116
5698da522fb0de2600f22a1a,21745,MRK3480 Forbrukeratferd,1453208652,2016-01-19 14:04:12,1453209227,575
5698da522fb0de2600f22a1c,84807,MRK3480 Forbrukeratferd,1453242935,2016-01-19 23:35:35,1453243564,629
5698da522fb0de2600f22a1c,9593,MRK3480 Forbrukeratferd,1453852488,2016-01-27 00:54:48,1453853020,532
5698da522fb0de2600f22a1d,78760,MRK3480 Forbrukeratferd,1452881882,2016-01-15 19:18:02,1452882351,469
5698da522fb0de2600f22a1d,31098,MRK3480 Forbrukeratferd,1453125028,2016-01-18 14:50:28,1453125030,2
5698da522fb0de2600f22a1d,92878,MRK3480 Forbrukeratferd,1453194288,2016-01-19 10:04:48,1453194300,12
5698da522fb0de2600f22a1d,73880,MRK3480 Forbrukeratferd,1453199029,2016-01-19 11:23:49,1453199038,9
5698da522fb0de2600f22a1d,63020,MRK3480 Forbrukeratferd,1453201781,2016-01-19 12:09:41,1453201786,5
5698da522fb0de2600f22a1d,75825,MRK3480 Forbrukeratferd,1453210715,2016-01-19 14:38:35,1453210726,11
5698da522fb0de2600f22a1d,20953,MRK3480 Forbrukeratferd,1453228188,2016-01-19 19:29:48,1453228188,0
5698da522fb0de2600f22a1d,36341,MRK3480 Forbrukeratferd,1453363809,2016-01-21 09:10:09,1453364145,336
5698da522fb0de2600f22a1d,9023,MRK3480 Forbrukeratferd,1453387841,2016-01-21 15:50:41,1453387857,16
5698da522fb0de2600f22a1d,54446,MRK3480 Forbrukeratferd,1453556453,2016-01-23 14:40:53,1453556461,8
5698da522fb0de2600f22a1d,32511,MRK3480 Forbrukeratferd,1453713299,2016-01-25 10:14:59,1453713299,0
5698da522fb0de2600f22a1d,14530,MRK3480 Forbrukeratferd,1453719407,2016-01-25 11:56:47,1453719420,13
5698da522fb0de2600f22a1d,81621,MRK3480 Forbrukeratferd,1453897904,2016-01-27 13:31:44,1453897915,11
5698da522fb0de2600f22a1d,87701,MRK3480 Forbrukeratferd,1454233444,2016-01-31 10:44:04,1454233525,81
5698da5241a9d72100240733,50402,MRK3480 Forbrukeratferd,1453225039,2016-01-19 18:37:19,1453225361,322
5698da5241a9d72100240733,39048,MRK3480 Forbrukeratferd,1453227550,2016-01-19 19:19:10,1453228699,1149
5698da5241a9d72100240733,36410,MRK3480 Forbrukeratferd,1453316482,2016-01-20 20:01:22,1453317195,713
5698da5241a9d72100240733,55092,MRK3480 Forbrukeratferd,1453324276,2016-01-20 22:11:16,1453324740,464
5698da5241a9d72100240733,15377,MRK3480 Forbrukeratferd,1453326119,2016-01-20 22:41:59,1453326119,0
5698da5241a9d72100240733,77299,MRK3480 Forbrukeratferd,1453377804,2016-01-21 13:03:24,1453378010,206
5698da5241a9d72100240733,64474,MRK3480 Forbrukeratferd,1453381666,2016-01-21 14:07:46,1453381667,1
5698da5241a9d72100240733,66219,MRK3480 Forbrukeratferd,1453908991,2016-01-27 16:36:31,1453909207,216
5698da5241a9d72100240733,59121,MRK3480 Forbrukeratferd,1453920078,2016-01-27 19:41:18,1453920079,1
5698da5241a9d72100240733,36923,MRK3480 Forbrukeratferd,1453930701,2016-01-27 22:38:21,1453930703,2
5698da5241a9d72100240733,42256,MRK3480 Forbrukeratferd,1453979818,2016-01-28 12:16:58,1453979915,97
5698da5241a9d72100240733,26807,MRK3480 Forbrukeratferd,1453981515,2016-01-28 12:45:15,1453981599,84
5698da5241a9d72100240735,75810,MRK3480 Forbrukeratferd,1453133512,2016-01-18 17:11:52,1453133512,0
5698da5241a9d72100240735,74003,MRK3480 Forbrukeratferd,1453860714,2016-01-27 03:11:54,1453860768,54
5698da5241a9d72100240735,55987,MRK3480 Forbrukeratferd,1453895172,2016-01-27 12:46:12,1453895172,0
5698da5241a9d72100240735,32453,MRK3480 Forbrukeratferd,1453913392,2016-01-27 17:49:52,1453913439,47
5698da5241a9d72100240735,13498,MRK3480 Forbrukeratferd,1453918461,2016-01-27 19:14:21,1453918462,1
5698da5241a9d72100240736,97361,MRK3480 Forbrukeratferd,1453979937,2016-01-28 12:18:57,1453980192,255
5698da5241a9d72100240736,41017,MRK3480 Forbrukeratferd,1453991354,2016-01-28 15:29:14,1453992472,1118
5698da532fb0de2600f22a1e,55850,MRK3480 Forbrukeratferd,1452890987,2016-01-15 21:49:47,1452891129,142
5698da532fb0de2600f22a1e,83897,MRK3480 Forbrukeratferd,1453050381,2016-01-17 18:06:21,1453051592,1211
5698da532fb0de2600f22a1e,30541,MRK3480 Forbrukeratferd,1453678533,2016-01-25 00:35:33,1453678534,1
5698da532fb0de2600f22a1e,5761,MRK3480 Forbrukeratferd,1453806731,2016-01-26 12:12:11,1453806796,65
5698da532fb0de2600f22a1e,91955,MRK3480 Forbrukeratferd,1453815335,2016-01-26 14:35:35,1453815336,1
5698da532fb0de2600f22a1e,70877,MRK3480 Forbrukeratferd,1453820465,2016-01-26 16:01:05,1453820466,1
5698da532fb0de2600f22a1e,24395,MRK3480 Forbrukeratferd,1453919317,2016-01-27 19:28:37,1453919480,163
5698da532fb0de2600f22a1f,58670,MRK3480 Forbrukeratferd,1453378725,2016-01-21 13:18:45,1453378870,145
5698da532fb0de2600f22a1f,49904,MRK3480 Forbrukeratferd,1453724118,2016-01-25 13:15:18,1453724148,30
5698da532fb0de2600f22a1f,58760,MRK3480 Forbrukeratferd,1453985051,2016-01-28 13:44:11,1453987601,2550
5698da5341a9d72100240738,10867,MRK3480 Forbrukeratferd,1453205659,2016-01-19 13:14:19,1453205817,158
5698da5341a9d7210024073a,60174,MRK3480 Forbrukeratferd,1453678235,2016-01-25 00:30:35,1453678304,69
5698da5341a9d7210024073b,71493,MRK3480 Forbrukeratferd,1452890698,2016-01-15 21:44:58,1452891754,1056
5698da5341a9d7210024073b,48433,MRK3480 Forbrukeratferd,1452898442,2016-01-15 23:54:02,1452899752,1310
5698da5341a9d7210024073b,7900,MRK3480 Forbrukeratferd,1453475437,2016-01-22 16:10:37,1453475476,39
5698da5341a9d7210024073b,46607,MRK3480 Forbrukeratferd,1453565382,2016-01-23 17:09:42,1453566167,785
5698da5341a9d7210024073b,47753,MRK3480 Forbrukeratferd,1453721093,2016-01-25 12:24:53,1453721098,5
5698da5341a9d7210024073b,19961,MRK3480 Forbrukeratferd,1453723782,2016-01-25 13:09:42,1453723784,2
5698da5341a9d7210024073b,16623,MRK3480 Forbrukeratferd,1453726690,2016-01-25 13:58:10,1453727195,505
5698da5341a9d7210024073b,76122,MRK3480 Forbrukeratferd,1453916788,2016-01-27 18:46:28,1453916816,28
5698da542fb0de2600f22a3a,40065,MRK3480 Forbrukeratferd,1453122362,2016-01-18 14:06:02,1453122858,496
5698da542fb0de2600f22a3a,64098,MRK3480 Forbrukeratferd,1453125426,2016-01-18 14:57:06,1453125575,149
5698da542fb0de2600f22a3a,77904,MRK3480 Forbrukeratferd,1453127664,2016-01-18 15:34:24,1453127666,2
5698da542fb0de2600f22a3a,39603,MRK3480 Forbrukeratferd,1453290695,2016-01-20 12:51:35,1453291282,587
5698da542fb0de2600f22a3a,80830,MRK3480 Forbrukeratferd,1453378203,2016-01-21 13:10:03,1453378587,384
5698da542fb0de2600f22a3b,87266,MRK3480 Forbrukeratferd,1453301629,2016-01-20 15:53:49,1453301647,18
5698da542fb0de2600f22a3b,25397,MRK3480 Forbrukeratferd,1453374324,2016-01-21 12:05:24,1453375575,1251
5698da542fb0de2600f22a3b,86925,MRK3480 Forbrukeratferd,1453377719,2016-01-21 13:01:59,1453378407,688
5698da542fb0de2600f22a3b,63394,MRK3480 Forbrukeratferd,1453381567,2016-01-21 14:06:07,1453382340,773
5698da542fb0de2600f22a3b,94084,MRK3480 Forbrukeratferd,1453950869,2016-01-28 04:14:29,1453950988,119
5698da542fb0de2600f22a3c,39659,MRK3480 Forbrukeratferd,1452870658,2016-01-15 16:10:58,1452871607,949
5698da542fb0de2600f22a3c,65006,MRK3480 Forbrukeratferd,1453064158,2016-01-17 21:55:58,1453064191,33
5698da542fb0de2600f22a3c,94194,MRK3480 Forbrukeratferd,1453122019,2016-01-18 14:00:19,1453122115,96
5698da542fb0de2600f22a3c,72155,MRK3480 Forbrukeratferd,1453149451,2016-01-18 21:37:31,1453149495,44
5698da542fb0de2600f22a3c,99232,MRK3480 Forbrukeratferd,1453316460,2016-01-20 20:01:00,1453317183,723
5698da542fb0de2600f22a3c,8142,MRK3480 Forbrukeratferd,1453644463,2016-01-24 15:07:43,1453644463,0
5698da542fb0de2600f22a3c,7669,MRK3480 Forbrukeratferd,1453912818,2016-01-27 17:40:18,1453914439,1621
5698da542fb0de2600f22a3c,4004,MRK3480 Forbrukeratferd,1454003251,2016-01-28 18:47:31,1454003283,32
5698da542fb0de2600f22a3d,63115,MRK3480 Forbrukeratferd,1452872851,2016-01-15 16:47:31,1452872933,82
5698da542fb0de2600f22a3d,77522,MRK3480 Forbrukeratferd,1452874316,2016-01-15 17:11:56,1452874569,253
5698da542fb0de2600f22a3d,32614,MRK3480 Forbrukeratferd,1453145795,2016-01-18 20:36:35,1453145935,140
5698da542fb0de2600f22a3d,59666,MRK3480 Forbrukeratferd,1453363852,2016-01-21 09:10:52,1453363887,35
5698da542fb0de2600f22a3d,48666,MRK3480 Forbrukeratferd,1453391316,2016-01-21 16:48:36,1453391969,653
5698da542fb0de2600f22a3d,29274,MRK3480 Forbrukeratferd,1453832271,2016-01-26 19:17:51,1453832343,72
5698da542fb0de2600f22a3d,39907,MRK3480 Forbrukeratferd,1453930565,2016-01-27 22:36:05,1453930659,94
5698da542fb0de2600f22a3d,62165,MRK3480 Forbrukeratferd,1453976164,2016-01-28 11:16:04,1453976540,376
5698da542fb0de2600f22a3e,74241,MRK3480 Forbrukeratferd,1453393784,2016-01-21 17:29:44,1453394173,389
5698da5441a9d72100240756,26916,MRK3480 Forbrukeratferd,1453204200,2016-01-19 12:50:00,1453204284,84
5698da5441a9d72100240756,37490,MRK3480 Forbrukeratferd,1453370245,2016-01-21 10:57:25,1453370345,100
5698da5441a9d72100240756,46989,MRK3480 Forbrukeratferd,1453908040,2016-01-27 16:20:40,1453908141,101
5698da5441a9d72100240756,98361,MRK3480 Forbrukeratferd,1453979742,2016-01-28 12:15:42,1453980084,342
5698da5441a9d72100240756,8184,MRK3480 Forbrukeratferd,1453983102,2016-01-28 13:11:42,1453983105,3
5698da552fb0de2600f22a3f,84869,MRK3480 Forbrukeratferd,1453894887,2016-01-27 12:41:27,1453894887,0
5698da5541a9d72100240758,77556,MRK3480 Forbrukeratferd,1453133533,2016-01-18 17:12:13,1453133542,9
5698da5541a9d72100240758,11515,MRK3480 Forbrukeratferd,1453138894,2016-01-18 18:41:34,1453138895,1
5698da5541a9d72100240758,63433,MRK3480 Forbrukeratferd,1453361901,2016-01-21 08:38:21,1453361989,88
5698da5541a9d72100240758,54718,MRK3480 Forbrukeratferd,1453366005,2016-01-21 09:46:45,1453366018,13
5698da5541a9d72100240759,38423,MRK3480 Forbrukeratferd,1453377845,2016-01-21 13:04:05,1453378141,296
5698da5541a9d72100240759,61401,MRK3480 Forbrukeratferd,1453381489,2016-01-21 14:04:49,1453381880,391
5698da5541a9d72100240759,46930,MRK3480 Forbrukeratferd,1453933295,2016-01-27 23:21:35,1453933317,22
5698da5541a9d72100240759,87686,MRK3480 Forbrukeratferd,1453979062,2016-01-28 12:04:22,1453979883,821
5698da5541a9d72100240759,87463,MRK3480 Forbrukeratferd,1453986361,2016-01-28 14:06:01,1453986410,49
5698da5541a9d72100240759,67192,MRK3480 Forbrukeratferd,1453988468,2016-01-28 14:41:08,1453988468,0
5698da5541a9d7210024075a,95663,MRK3480 Forbrukeratferd,1453270235,2016-01-20 07:10:35,1453270335,100
5698da5541a9d7210024075a,51369,MRK3480 Forbrukeratferd,1453292184,2016-01-20 13:16:24,1453292513,329
5698da5541a9d7210024075a,86968,MRK3480 Forbrukeratferd,1453296600,2016-01-20 14:30:00,1453296601,1
5698da5541a9d7210024075a,11804,MRK3480 Forbrukeratferd,1453309330,2016-01-20 18:02:10,1453309330,0
5698da5541a9d7210024075a,76999,MRK3480 Forbrukeratferd,1453315989,2016-01-20 19:53:09,1453315989,0
5698da5541a9d7210024075a,45619,MRK3480 Forbrukeratferd,1453327574,2016-01-20 23:06:14,1453329629,2055
5698da5541a9d7210024075a,24480,MRK3480 Forbrukeratferd,1453375510,2016-01-21 12:25:10,1453377698,2188
5698da5541a9d7210024075a,16720,MRK3480 Forbrukeratferd,1453397005,2016-01-21 18:23:25,1453397005,0
5698da5541a9d7210024075a,78659,MRK3480 Forbrukeratferd,1453422721,2016-01-22 01:32:01,1453422721,0
5698da5541a9d7210024075a,5549,MRK3480 Forbrukeratferd,1453495030,2016-01-22 21:37:10,1453495030,0
5698da5541a9d7210024075a,49245,MRK3480 Forbrukeratferd,1453589042,2016-01-23 23:44:02,1453589048,6
5698da5541a9d7210024075a,64300,MRK3480 Forbrukeratferd,1453917886,2016-01-27 19:04:46,1453918517,631
5698da5541a9d7210024075a,57115,MRK3480 Forbrukeratferd,1453979197,2016-01-28 12:06:37,1453980036,839
5698da5541a9d7210024075a,23163,MRK3480 Forbrukeratferd,1454256509,2016-01-31 17:08:29,1454256509,0
5698da5541a9d7210024075d,58140,MRK3480 Forbrukeratferd,1453375007,2016-01-21 12:16:47,1453375039,32
5698da5541a9d7210024075d,59244,MRK3480 Forbrukeratferd,1453376858,2016-01-21 12:47:38,1453377686,828
5698da562fb0de2600f22a4a,24021,MRK3480 Forbrukeratferd,1453120677,2016-01-18 13:37:57,1453120770,93
5698da562fb0de2600f22a4a,80189,MRK3480 Forbrukeratferd,1453123414,2016-01-18 14:23:34,1453123797,383
5698da562fb0de2600f22a4a,48933,MRK3480 Forbrukeratferd,1453288239,2016-01-20 12:10:39,1453288502,263
5698da562fb0de2600f22a4a,82790,MRK3480 Forbrukeratferd,1453301679,2016-01-20 15:54:39,1453301760,81
5698da562fb0de2600f22a4a,47040,MRK3480 Forbrukeratferd,1453321102,2016-01-20 21:18:22,1453322336,1234
5698da562fb0de2600f22a4a,42148,MRK3480 Forbrukeratferd,1453373668,2016-01-21 11:54:28,1453373668,0
5698da562fb0de2600f22a4a,67802,MRK3480 Forbrukeratferd,1453474997,2016-01-22 16:03:17,1453474998,1
5698da562fb0de2600f22a4a,55557,MRK3480 Forbrukeratferd,1453808165,2016-01-26 12:36:05,1453808438,273
5698da562fb0de2600f22a4a,35115,MRK3480 Forbrukeratferd,1453809732,2016-01-26 13:02:12,1453810900,1168
5698da562fb0de2600f22a4a,16849,MRK3480 Forbrukeratferd,1453813897,2016-01-26 14:11:37,1453813927,30
5698da562fb0de2600f22a4a,25879,MRK3480 Forbrukeratferd,1453877619,2016-01-27 07:53:39,1453877630,11
5698da562fb0de2600f22a4a,24950,MRK3480 Forbrukeratferd,1453892111,2016-01-27 11:55:11,1453892112,1
5698da562fb0de2600f22a4a,27118,MRK3480 Forbrukeratferd,1453977325,2016-01-28 11:35:25,1453977396,71
5698da562fb0de2600f22a4a,25049,MRK3480 Forbrukeratferd,1453979055,2016-01-28 12:04:15,1453979073,18
5698da562fb0de2600f22a4a,93349,MRK3480 Forbrukeratferd,1454059191,2016-01-29 10:19:51,1454059191,0
5698da562fb0de2600f22a4a,94926,MRK3480 Forbrukeratferd,1454270512,2016-01-31 21:01:52,1454270514,2
5698da562fb0de2600f22a4b,33042,MRK3480 Forbrukeratferd,1453236350,2016-01-19 21:45:50,1453236436,86
5698da562fb0de2600f22a4b,94630,MRK3480 Forbrukeratferd,1453674012,2016-01-24 23:20:12,1453674765,753
5698da562fb0de2600f22a50,41227,MRK3480 Forbrukeratferd,1453058757,2016-01-17 20:25:57,1453058854,97
5698da562fb0de2600f22a50,63263,nan,1453116799,2016-01-18 12:33:19,1453117608,809
5698da562fb0de2600f22a50,81232,MRK3480 Forbrukeratferd,1453147142,2016-01-18 20:59:02,1453147290,148
5698da562fb0de2600f22a50,24138,MRK3480 Forbrukeratferd,1453374325,2016-01-21 12:05:25,1453374367,42
5698da562fb0de2600f22a50,65206,MRK3480 Forbrukeratferd,1453377674,2016-01-21 13:01:14,1453378572,898
5698da562fb0de2600f22a50,6023,MRK3480 Forbrukeratferd,1453719930,2016-01-25 12:05:30,1453719939,9
5698da562fb0de2600f22a50,92858,MRK3480 Forbrukeratferd,1453751759,2016-01-25 20:55:59,1453751760,1
5698da562fb0de2600f22a50,48615,MRK3480 Forbrukeratferd,1453978884,2016-01-28 12:01:24,1453980170,1286
5698da562fb0de2600f22a50,62650,MRK3480 Forbrukeratferd,1453983951,2016-01-28 13:25:51,1453983951,0
5698da562fb0de2600f22a50,65852,MRK3480 Forbrukeratferd,1454000743,2016-01-28 18:05:43,1454000743,0
5698da5641a9d7210024076b,74520,MRK3480 Forbrukeratferd,1453219451,2016-01-19 17:04:11,1453219533,82
5698da5641a9d7210024076b,92781,MRK3480 Forbrukeratferd,1453220994,2016-01-19 17:29:54,1453221908,914
5698da5641a9d7210024076b,29857,MRK3480 Forbrukeratferd,1453307220,2016-01-20 17:27:00,1453307271,51
5698da5641a9d7210024076b,41639,MRK3480 Forbrukeratferd,1453391592,2016-01-21 16:53:12,1453391685,93
5698da5641a9d7210024076b,15193,MRK3480 Forbrukeratferd,1453933263,2016-01-27 23:21:03,1453933342,79
5698da572fb0de2600f22a52,78791,MRK3480 Forbrukeratferd,1453066980,2016-01-17 22:43:00,1453066983,3
5698da572fb0de2600f22a52,15385,MRK3480 Forbrukeratferd,1453371596,2016-01-21 11:19:56,1453371713,117
5698da572fb0de2600f22a52,76209,MRK3480 Forbrukeratferd,1453808173,2016-01-26 12:36:13,1453808223,50
5698da572fb0de2600f22a52,49854,MRK3480 Forbrukeratferd,1453972541,2016-01-28 10:15:41,1453977349,4808
5698da572fb0de2600f22a52,96735,MRK3480 Forbrukeratferd,1454317892,2016-02-01 10:11:32,1454317892,0
5698da582fb0de2600f22a6b,56561,MRK3480 Forbrukeratferd,1452864666,2016-01-15 14:31:06,1452864751,85
5698da582fb0de2600f22a6b,52062,MRK3480 Forbrukeratferd,1453121476,2016-01-18 13:51:16,1453121476,0
5698da5841a9d72100240776,15168,MRK3480 Forbrukeratferd,1453365943,2016-01-21 09:45:43,1453366169,226
5698da5841a9d72100240776,97521,MRK3480 Forbrukeratferd,1453389607,2016-01-21 16:20:07,1453389694,87
5698da5841a9d72100240776,84060,MRK3480 Forbrukeratferd,1453820553,2016-01-26 16:02:33,1453820583,30
5698da5841a9d72100240776,87750,MRK3480 Forbrukeratferd,1453821815,2016-01-26 16:23:35,1453821832,17
5698da5841a9d72100240776,69699,MRK3480 Forbrukeratferd,1453922072,2016-01-27 20:14:32,1453922262,190
5698da5841a9d72100240776,49011,MRK3480 Forbrukeratferd,1454160496,2016-01-30 14:28:16,1454160508,12
5698da5841a9d72100240777,13818,MRK3480 Forbrukeratferd,1452863834,2016-01-15 14:17:14,1452863866,32
5698da5841a9d72100240777,51941,MRK3480 Forbrukeratferd,1453242921,2016-01-19 23:35:21,1453243060,139
5698da5841a9d72100240778,15726,MRK3480 Forbrukeratferd,1452884855,2016-01-15 20:07:35,1452885348,493
5698da5841a9d72100240778,73305,MRK3480 Forbrukeratferd,1453320040,2016-01-20 21:00:40,1453320044,4
5698da5841a9d72100240778,70141,MRK3480 Forbrukeratferd,1453822819,2016-01-26 16:40:19,1453822819,0
5698da5841a9d72100240778,52627,MRK3480 Forbrukeratferd,1453832713,2016-01-26 19:25:13,1453832713,0
5698da5841a9d72100240778,86619,MRK3480 Forbrukeratferd,1453984491,2016-01-28 13:34:51,1453984559,68
5698da5841a9d72100240779,11716,MRK3480 Forbrukeratferd,1453306724,2016-01-20 17:18:44,1453307423,699
5698da5841a9d72100240779,73197,MRK3480 Forbrukeratferd,1453312426,2016-01-20 18:53:46,1453312433,7
5698da5841a9d72100240779,4905,MRK3480 Forbrukeratferd,1453376092,2016-01-21 12:34:52,1453376102,10
5698da5841a9d72100240779,10335,MRK3480 Forbrukeratferd,1453418222,2016-01-22 00:17:02,1453418816,594
5698da5841a9d72100240779,25852,MRK3480 Forbrukeratferd,1453420945,2016-01-22 01:02:25,1453420945,0
5698da5841a9d72100240779,49987,MRK3480 Forbrukeratferd,1453758741,2016-01-25 22:52:21,1453758785,44
5698da5841a9d72100240779,70126,MRK3480 Forbrukeratferd,1453982414,2016-01-28 13:00:14,1453982448,34
5698da5841a9d72100240779,19793,MRK3480 Forbrukeratferd,1453991268,2016-01-28 15:27:48,1453992781,1513
5698da5841a9d72100240779,99165,MRK3480 Forbrukeratferd,1454264117,2016-01-31 19:15:17,1454264307,190
5698da592fb0de2600f22a6d,77429,MRK3480 Forbrukeratferd,1453298306,2016-01-20 14:58:26,1453299905,1599
5698da592fb0de2600f22a6d,16642,MRK3480 Forbrukeratferd,1453374222,2016-01-21 12:03:42,1453374223,1
5698da592fb0de2600f22a6d,49361,MRK3480 Forbrukeratferd,1453747124,2016-01-25 19:38:44,1453747124,0
5698da592fb0de2600f22a6d,20829,MRK3480 Forbrukeratferd,1453857366,2016-01-27 02:16:06,1453857367,1
5698da592fb0de2600f22a6d,57590,MRK3480 Forbrukeratferd,1453888326,2016-01-27 10:52:06,1453888326,0
5698da592fb0de2600f22a6d,51281,MRK3480 Forbrukeratferd,1453924164,2016-01-27 20:49:24,1453924193,29
5698da592fb0de2600f22a6d,71023,MRK3480 Forbrukeratferd,1453975664,2016-01-28 11:07:44,1453975664,0
5698da592fb0de2600f22a6d,69448,MRK3480 Forbrukeratferd,1453997866,2016-01-28 17:17:46,1453997936,70
5698da592fb0de2600f22a6d,61381,MRK3480 Forbrukeratferd,1454008110,2016-01-28 20:08:30,1454008111,1
5698da592fb0de2600f22a6d,59332,MRK3480 Forbrukeratferd,1454118339,2016-01-30 02:45:39,1454118340,1
5698da592fb0de2600f22a70,23322,MRK3480 Forbrukeratferd,1452876045,2016-01-15 17:40:45,1452876045,0
5698da592fb0de2600f22a70,14750,MRK3480 Forbrukeratferd,1453290374,2016-01-20 12:46:14,1453290486,112
5698da592fb0de2600f22a70,80863,MRK3480 Forbrukeratferd,1453499218,2016-01-22 22:46:58,1453499218,0
5698da5941a9d7210024077b,57092,MRK3480 Forbrukeratferd,1452861613,2016-01-15 13:40:13,1452861614,1
5698da5941a9d7210024077b,47368,MRK3480 Forbrukeratferd,1453913286,2016-01-27 17:48:06,1453913290,4
5698da5941a9d7210024077b,93036,MRK3480 Forbrukeratferd,1453917195,2016-01-27 18:53:15,1453917197,2
5698da5941a9d7210024077c,21073,MRK3480 Forbrukeratferd,1453374333,2016-01-21 12:05:33,1453374430,97
5698da5941a9d7210024077c,65731,MRK3480 Forbrukeratferd,1453377978,2016-01-21 13:06:18,1453379325,1347
5698da5941a9d7210024078d,22051,MRK3480 Forbrukeratferd,1453122627,2016-01-18 14:10:27,1453122842,215
5698da5941a9d7210024078d,699,MRK3480 Forbrukeratferd,1453343324,2016-01-21 03:28:44,1453343414,90
5698da5941a9d7210024078d,59060,MRK3480 Forbrukeratferd,1453819479,2016-01-26 15:44:39,1453819510,31
5698da5941a9d7210024078d,74698,MRK3480 Forbrukeratferd,1454269534,2016-01-31 20:45:34,1454270238,704
5698da5a2fb0de2600f22a71,1404,MRK3480 Forbrukeratferd,1453117850,2016-01-18 12:50:50,1453118509,659
5698da5a2fb0de2600f22a72,75442,MRK3480 Forbrukeratferd,1453193298,2016-01-19 09:48:18,1453193299,1
5698da5a2fb0de2600f22a72,55289,MRK3480 Forbrukeratferd,1453375590,2016-01-21 12:26:30,1453375610,20
5698da5a2fb0de2600f22a72,69661,MRK3480 Forbrukeratferd,1453377577,2016-01-21 12:59:37,1453377578,1
5698da5a2fb0de2600f22a72,18584,MRK3480 Forbrukeratferd,1453851139,2016-01-27 00:32:19,1453851311,172
5698da5a2fb0de2600f22a72,54698,MRK3480 Forbrukeratferd,1453988240,2016-01-28 14:37:20,1453988286,46
5698da5a2fb0de2600f22a78,83827,MRK3480 Forbrukeratferd,1453287687,2016-01-20 12:01:27,1453287837,150
5698da5a2fb0de2600f22a78,36479,MRK3480 Forbrukeratferd,1453892458,2016-01-27 12:00:58,1453893033,575
5698da5a2fb0de2600f22a78,53008,MRK3480 Forbrukeratferd,1453900994,2016-01-27 14:23:14,1453900994,0
5698da5a2fb0de2600f22a78,37804,MRK3480 Forbrukeratferd,1453905766,2016-01-27 15:42:46,1453905766,0
5698da5a2fb0de2600f22a78,7295,MRK3480 Forbrukeratferd,1454243325,2016-01-31 13:28:45,1454243347,22
5698da5a2fb0de2600f22a7a,78089,ORG3402 Organisasjonsatferd og ledelse,1453110121,2016-01-18 10:42:01,1453110449,328
5698da5a2fb0de2600f22a7a,65794,MRK3480 Forbrukeratferd,1453141862,2016-01-18 19:31:02,1453142392,530
5698da5a2fb0de2600f22a7a,60829,MRK3480 Forbrukeratferd,1453321336,2016-01-20 21:22:16,1453321967,631
5698da5a2fb0de2600f22a7a,19220,ORG3402 Organisasjonsatferd og ledelse,1453643498,2016-01-24 14:51:38,1453643543,45
5698da5a2fb0de2600f22a7a,87174,MRK3480 Forbrukeratferd,1453801560,2016-01-26 10:46:00,1453803241,1681
5698da5b2fb0de2600f22a88,49489,MRK3480 Forbrukeratferd,1452861974,2016-01-15 13:46:14,1452862005,31
5698da5b2fb0de2600f22a88,81246,MRK3480 Forbrukeratferd,1452878469,2016-01-15 18:21:09,1452878503,34
5698da5b2fb0de2600f22a88,79455,MRK3480 Forbrukeratferd,1452987213,2016-01-17 00:33:33,1452987247,34
5698da5b2fb0de2600f22a88,99524,MRK3480 Forbrukeratferd,1453313754,2016-01-20 19:15:54,1453313845,91
5698da5b2fb0de2600f22a88,95037,MRK3480 Forbrukeratferd,1453319073,2016-01-20 20:44:33,1453319107,34
5698da5b2fb0de2600f22a88,79129,MRK3480 Forbrukeratferd,1453843128,2016-01-26 22:18:48,1453843140,12
5698da5b2fb0de2600f22a88,46138,MRK3480 Forbrukeratferd,1453902218,2016-01-27 14:43:38,1453902267,49
5698da5b2fb0de2600f22a88,11531,MRK3480 Forbrukeratferd,1453991279,2016-01-28 15:27:59,1453993297,2018
5698da5b41a9d7210024079f,65400,MRK3480 Forbrukeratferd,1453822807,2016-01-26 16:40:07,1453823600,793
5698da5b41a9d7210024079f,74815,MRK3480 Forbrukeratferd,1453995001,2016-01-28 16:30:01,1453995080,79
5698da5b41a9d721002407a0,88905,MRK3480 Forbrukeratferd,1453058643,2016-01-17 20:24:03,1453059743,1100
5698da5b41a9d721002407a0,91724,MRK3480 Forbrukeratferd,1453307902,2016-01-20 17:38:22,1453309889,1987
5698da5b41a9d721002407a0,79113,MRK3480 Forbrukeratferd,1453907655,2016-01-27 16:14:15,1453907718,63
5698da5b41a9d721002407a1,6116,MRK3480 Forbrukeratferd,1453811950,2016-01-26 13:39:10,1453812791,841
5698da5c2fb0de2600f22a97,52741,MRK3480 Forbrukeratferd,1453724214,2016-01-25 13:16:54,1453724237,23
5698da5c2fb0de2600f22a97,64387,MRK3480 Forbrukeratferd,1453918623,2016-01-27 19:17:03,1453918624,1
5698da5c41a9d721002407a3,29683,MRK3480 Forbrukeratferd,1453122682,2016-01-18 14:11:22,1453122960,278
5698da5c41a9d721002407a3,6124,MRK3480 Forbrukeratferd,1453682118,2016-01-25 01:35:18,1453682190,72
5698da5c41a9d721002407a6,14070,MRK3480 Forbrukeratferd,1453221388,2016-01-19 17:36:28,1453221560,172
5698da5c41a9d721002407a7,20718,MRK3480 Forbrukeratferd,1453136809,2016-01-18 18:06:49,1453136883,74
5698da5c41a9d721002407a7,39766,MRK3480 Forbrukeratferd,1453145273,2016-01-18 20:27:53,1453145290,17
5698da5c41a9d721002407a7,380,MRK3480 Forbrukeratferd,1453147078,2016-01-18 20:57:58,1453147360,282
5698da5c41a9d721002407a7,58191,MRK3480 Forbrukeratferd,1453155836,2016-01-18 23:23:56,1453155836,0
5698da5c41a9d721002407a7,11668,MRK3480 Forbrukeratferd,1453211447,2016-01-19 14:50:47,1453211465,18
5698da5c41a9d721002407a7,81848,MRK3480 Forbrukeratferd,1453811147,2016-01-26 13:25:47,1453811179,32
5698da5c41a9d721002407a7,55007,MRK3480 Forbrukeratferd,1453814254,2016-01-26 14:17:34,1453814390,136
5698da5c41a9d721002407a7,95965,MRK3480 Forbrukeratferd,1453983133,2016-01-28 13:12:13,1453983153,20
5698da5c41a9d721002407a7,49038,MRK3480 Forbrukeratferd,1454062583,2016-01-29 11:16:23,1454062648,65
5698da5c41a9d721002407a7,14558,MRK3480 Forbrukeratferd,1454063978,2016-01-29 11:39:38,1454063981,3
5698da5d2fb0de2600f22a9c,87556,MRK3480 Forbrukeratferd,1453301309,2016-01-20 15:48:29,1453303058,1749
5698da5d2fb0de2600f22a9c,23202,MRK3480 Forbrukeratferd,1453847934,2016-01-26 23:38:54,1453848020,86
5698da5d2fb0de2600f22a9c,37904,MRK3480 Forbrukeratferd,1453849259,2016-01-27 00:00:59,1453849303,44
5698da5d2fb0de2600f22a9c,96612,MRK3480 Forbrukeratferd,1453850718,2016-01-27 00:25:18,1453850719,1
5698da5d2fb0de2600f22a9c,35937,MRK3480 Forbrukeratferd,1453905920,2016-01-27 15:45:20,1453905937,17
5698da5d2fb0de2600f22a9c,50712,MRK3480 Forbrukeratferd,1454247253,2016-01-31 14:34:13,1454247365,112
5698da5d2fb0de2600f22a9e,45113,MRK3480 Forbrukeratferd,1452861764,2016-01-15 13:42:44,1452861884,120
5698da5d2fb0de2600f22a9e,65523,MRK3480 Forbrukeratferd,1452878386,2016-01-15 18:19:46,1452878444,58
5698da5d2fb0de2600f22a9e,63028,MRK3480 Forbrukeratferd,1452902006,2016-01-16 00:53:26,1452902059,53
5698da5d2fb0de2600f22a9e,68046,MRK3480 Forbrukeratferd,1453037893,2016-01-17 14:38:13,1453037897,4
5698da5d2fb0de2600f22a9e,16513,MRK3480 Forbrukeratferd,1453040923,2016-01-17 15:28:43,1453041514,591
5698da5d2fb0de2600f22a9e,93020,MRK3480 Forbrukeratferd,1453125621,2016-01-18 15:00:21,1453125650,29
5698da5d2fb0de2600f22a9e,36842,MRK3480 Forbrukeratferd,1453132809,2016-01-18 17:00:09,1453132810,1
5698da5d2fb0de2600f22a9e,24781,MRK3480 Forbrukeratferd,1453161445,2016-01-19 00:57:25,1453161540,95
5698da5d2fb0de2600f22a9e,14696,MRK3480 Forbrukeratferd,1453251460,2016-01-20 01:57:40,1453251546,86
5698da5d2fb0de2600f22a9e,61155,MRK3480 Forbrukeratferd,1453292826,2016-01-20 13:27:06,1453292826,0
5698da5d2fb0de2600f22a9e,70049,MRK3480 Forbrukeratferd,1453324911,2016-01-20 22:21:51,1453324949,38
5698da5d2fb0de2600f22a9e,20161,MRK3480 Forbrukeratferd,1453371512,2016-01-21 11:18:32,1453371529,17
5698da5d2fb0de2600f22a9e,79756,MRK3480 Forbrukeratferd,1453373735,2016-01-21 11:55:35,1453373735,0
5698da5d2fb0de2600f22a9e,72522,MRK3480 Forbrukeratferd,1453722456,2016-01-25 12:47:36,1453722507,51
5698da5d2fb0de2600f22a9e,73211,MRK3480 Forbrukeratferd,1453724809,2016-01-25 13:26:49,1453724811,2
5698da5d2fb0de2600f22a9e,36488,MRK3480 Forbrukeratferd,1453813912,2016-01-26 14:11:52,1453813913,1
5698da5d2fb0de2600f22a9e,38231,MRK3480 Forbrukeratferd,1453819337,2016-01-26 15:42:17,1453819338,1
5698da5d2fb0de2600f22a9e,50964,MRK3480 Forbrukeratferd,1453845238,2016-01-26 22:53:58,1453845256,18
5698da5d2fb0de2600f22a9e,29887,MRK3480 Forbrukeratferd,1453891597,2016-01-27 11:46:37,1453891597,0
5698da5d2fb0de2600f22a9e,13927,MRK3480 Forbrukeratferd,1453913158,2016-01-27 17:45:58,1453913159,1
5698da5d2fb0de2600f22a9e,27968,MRK3480 Forbrukeratferd,1454024298,2016-01-29 00:38:18,1454024661,363
5698da5d41a9d721002407b8,26378,MRK3480 Forbrukeratferd,1453732003,2016-01-25 15:26:43,1453732083,80
5698da5d41a9d721002407b8,77072,MRK3480 Forbrukeratferd,1453814734,2016-01-26 14:25:34,1453816020,1286
5698da5d41a9d721002407b8,10612,MRK3480 Forbrukeratferd,1453817454,2016-01-26 15:10:54,1453817804,350
5698da5e2fb0de2600f22aa2,56730,MRK3480 Forbrukeratferd,1453197480,2016-01-19 10:58:00,1453197861,381
5698da5e2fb0de2600f22aa2,4052,MRK3480 Forbrukeratferd,1453364601,2016-01-21 09:23:21,1453365114,513
5698da5e2fb0de2600f22aa2,64317,MRK3480 Forbrukeratferd,1453374134,2016-01-21 12:02:14,1453374405,271
5698da5e2fb0de2600f22aa2,51298,MRK3480 Forbrukeratferd,1453378039,2016-01-21 13:07:19,1453379014,975
5698da5e2fb0de2600f22aa2,57934,MRK3480 Forbrukeratferd,1453382379,2016-01-21 14:19:39,1453382381,2
5698da5e2fb0de2600f22aa2,11793,MRK3480 Forbrukeratferd,1453560851,2016-01-23 15:54:11,1453560851,0
5698da5e2fb0de2600f22aa3,95429,MRK3480 Forbrukeratferd,1453045902,2016-01-17 16:51:42,1453046158,256
5698da5e2fb0de2600f22aa3,68879,MRK3480 Forbrukeratferd,1453308858,2016-01-20 17:54:18,1453309215,357
5698da5e2fb0de2600f22aa3,79383,MRK3480 Forbrukeratferd,1453377490,2016-01-21 12:58:10,1453378013,523
5698da5e2fb0de2600f22aa3,86723,MRK3480 Forbrukeratferd,1453382548,2016-01-21 14:22:28,1453382559,11
5698da5e2fb0de2600f22aa3,34776,MRK3480 Forbrukeratferd,1453385159,2016-01-21 15:05:59,1453385176,17
5698da5e2fb0de2600f22aa3,74513,MRK3480 Forbrukeratferd,1453388212,2016-01-21 15:56:52,1453389446,1234
5698da5e2fb0de2600f22aa3,88068,MRK3480 Forbrukeratferd,1453391803,2016-01-21 16:56:43,1453391817,14
5698da5e2fb0de2600f22aa3,35396,MRK3480 Forbrukeratferd,1453721527,2016-01-25 12:32:07,1453721568,41
5698da5e2fb0de2600f22aa3,5710,MRK3480 Forbrukeratferd,1453724220,2016-01-25 13:17:00,1453724231,11
5698da5e2fb0de2600f22aa3,12858,MRK3480 Forbrukeratferd,1453816256,2016-01-26 14:50:56,1453816331,75
5698da5e2fb0de2600f22aa3,70479,MRK3480 Forbrukeratferd,1453892678,2016-01-27 12:04:38,1453892687,9
5698da5e2fb0de2600f22aa3,28513,MRK3480 Forbrukeratferd,1453919339,2016-01-27 19:28:59,1453919340,1
5698da5e2fb0de2600f22aa3,62550,MRK3480 Forbrukeratferd,1453983547,2016-01-28 13:19:07,1453983554,7
5698da5e2fb0de2600f22aa3,89632,MRK3480 Forbrukeratferd,1453987354,2016-01-28 14:22:34,1453987358,4
5698da5e2fb0de2600f22ab6,38968,MRK3480 Forbrukeratferd,1453213828,2016-01-19 15:30:28,1453213840,12
5698da5e2fb0de2600f22ab6,89664,MRK3480 Forbrukeratferd,1453675606,2016-01-24 23:46:46,1453675627,21
5698da5e2fb0de2600f22ab6,39669,MRK3480 Forbrukeratferd,1453713373,2016-01-25 10:16:13,1453713435,62
5698da5e2fb0de2600f22ab6,11468,MRK3480 Forbrukeratferd,1453805515,2016-01-26 11:51:55,1453805536,21
5698da5e2fb0de2600f22ab6,23082,MRK3480 Forbrukeratferd,1453813190,2016-01-26 13:59:50,1453813191,1
5698da5e2fb0de2600f22ab6,20187,MRK3480 Forbrukeratferd,1453911036,2016-01-27 17:10:36,1453911060,24
5698da5e41a9d721002407cb,40445,MRK3480 Forbrukeratferd,1452925700,2016-01-16 07:28:20,1452925777,77
5698da5e41a9d721002407cb,80092,MRK3480 Forbrukeratferd,1453066237,2016-01-17 22:30:37,1453066238,1
5698da5e41a9d721002407cb,44264,MRK3480 Forbrukeratferd,1453376924,2016-01-21 12:48:44,1453377130,206
5698da5e41a9d721002407cb,50018,MRK3480 Forbrukeratferd,1453405214,2016-01-21 20:40:14,1453405262,48
5698da5e41a9d721002407cb,64123,MRK3480 Forbrukeratferd,1453820239,2016-01-26 15:57:19,1453820259,20
5698da5e41a9d721002407cb,95292,MRK3480 Forbrukeratferd,1453826382,2016-01-26 17:39:42,1453826813,431
5698da5e41a9d721002407cb,50041,MRK3480 Forbrukeratferd,1453836115,2016-01-26 20:21:55,1453836126,11
5698da5e41a9d721002407cb,14473,MRK3480 Forbrukeratferd,1453902654,2016-01-27 14:50:54,1453902663,9
5698da5e41a9d721002407cb,9400,MRK3480 Forbrukeratferd,1453919237,2016-01-27 19:27:17,1453919242,5
5698da5e41a9d721002407cb,61409,MRK3480 Forbrukeratferd,1453979021,2016-01-28 12:03:41,1453979541,520
5698da5e41a9d721002407cb,30369,MRK3480 Forbrukeratferd,1453981489,2016-01-28 12:44:49,1453981493,4
5698da5f2fb0de2600f22ac2,20058,MRK3480 Forbrukeratferd,1453289057,2016-01-20 12:24:17,1453289143,86
5698da5f2fb0de2600f22ac2,73721,MRK3480 Forbrukeratferd,1453309823,2016-01-20 18:10:23,1453310296,473
5698da5f2fb0de2600f22ac2,36979,MRK3480 Forbrukeratferd,1453323119,2016-01-20 21:51:59,1453323120,1
5698da5f2fb0de2600f22ac2,20200,MRK3480 Forbrukeratferd,1453329060,2016-01-20 23:31:00,1453329128,68
5698da5f2fb0de2600f22ac2,36386,MRK3480 Forbrukeratferd,1453373686,2016-01-21 11:54:46,1453373945,259
5698da5f2fb0de2600f22ac2,30482,MRK3480 Forbrukeratferd,1453377464,2016-01-21 12:57:44,1453377594,130
5698da5f2fb0de2600f22ac2,42863,MRK3480 Forbrukeratferd,1453731995,2016-01-25 15:26:35,1453732032,37
5698da5f2fb0de2600f22ac2,31291,MRK3480 Forbrukeratferd,1453822360,2016-01-26 16:32:40,1453822365,5
5698da5f2fb0de2600f22ac2,28371,MRK3480 Forbrukeratferd,1453978985,2016-01-28 12:03:05,1453979027,42
5698da5f2fb0de2600f22ac2,23335,MRK3480 Forbrukeratferd,1453982402,2016-01-28 13:00:02,1453982404,2
5698da5f41a9d721002407cd,6594,MRK3480 Forbrukeratferd,1453138676,2016-01-18 18:37:56,1453138780,104
5698da5f41a9d721002407cd,12671,MRK3480 Forbrukeratferd,1453816288,2016-01-26 14:51:28,1453816929,641
5698da5f41a9d721002407cd,62296,MRK3480 Forbrukeratferd,1453820923,2016-01-26 16:08:43,1453820934,11
5698da5f41a9d721002407cd,16554,MRK3480 Forbrukeratferd,1453906262,2016-01-27 15:51:02,1453906403,141
5698da5f41a9d721002407cd,90700,MRK3480 Forbrukeratferd,1453914800,2016-01-27 18:13:20,1453914818,18
5698da5f41a9d721002407ce,37445,MRK3480 Forbrukeratferd,1453743788,2016-01-25 18:43:08,1453743813,25
5698da5f41a9d721002407d0,5253,MRK3480 Forbrukeratferd,1453753257,2016-01-25 21:20:57,1453753783,526
5698da5f41a9d721002407d0,29525,MRK3480 Forbrukeratferd,1453758148,2016-01-25 22:42:28,1453758158,10
5698da5f41a9d721002407d0,21633,MRK3480 Forbrukeratferd,1453936840,2016-01-28 00:20:40,1453936887,47
5698da5f41a9d721002407d1,62412,MRK3480 Forbrukeratferd,1453904900,2016-01-27 15:28:20,1453905050,150
5698da602fb0de2600f22ac4,92413,MRK3480 Forbrukeratferd,1452865525,2016-01-15 14:45:25,1452865699,174
5698da602fb0de2600f22ac4,29432,MRK3480 Forbrukeratferd,1452872767,2016-01-15 16:46:07,1452872767,0
5698da602fb0de2600f22ac4,70540,MRK3480 Forbrukeratferd,1452906219,2016-01-16 02:03:39,1452906261,42
5698da602fb0de2600f22ac4,63094,MRK3480 Forbrukeratferd,1453121090,2016-01-18 13:44:50,1453121214,124
5698da602fb0de2600f22ac4,40788,MRK3480 Forbrukeratferd,1453321709,2016-01-20 21:28:29,1453322341,632
5698da602fb0de2600f22ac4,29423,MRK3480 Forbrukeratferd,1453377740,2016-01-21 13:02:20,1453378531,791
5698da602fb0de2600f22ac4,10219,MRK3480 Forbrukeratferd,1453388187,2016-01-21 15:56:27,1453388188,1
5698da602fb0de2600f22ac4,5431,MRK3480 Forbrukeratferd,1453457731,2016-01-22 11:15:31,1453457735,4
5698da602fb0de2600f22ac4,53983,MRK3480 Forbrukeratferd,1453675574,2016-01-24 23:46:14,1453675575,1
5698da602fb0de2600f22ac4,99664,MRK3480 Forbrukeratferd,1453681289,2016-01-25 01:21:29,1453681291,2
5698da602fb0de2600f22ac4,11118,MRK3480 Forbrukeratferd,1453717549,2016-01-25 11:25:49,1453717620,71
5698da602fb0de2600f22ac4,1010,MRK3480 Forbrukeratferd,1453726620,2016-01-25 13:57:00,1453726655,35
5698da602fb0de2600f22ac4,33947,MRK3480 Forbrukeratferd,1453804998,2016-01-26 11:43:18,1453805011,13
5698da602fb0de2600f22ac4,15679,MRK3480 Forbrukeratferd,1453913078,2016-01-27 17:44:38,1453913198,120
5698da602fb0de2600f22ac4,64702,MRK3480 Forbrukeratferd,1454001128,2016-01-28 18:12:08,1454001128,0
5698da602fb0de2600f22ac4,65052,MRK3480 Forbrukeratferd,1454164517,2016-01-30 15:35:17,1454164518,1
5698da602fb0de2600f22ac5,28826,MRK3480 Forbrukeratferd,1452867113,2016-01-15 15:11:53,1452867149,36
5698da602fb0de2600f22ac5,4204,MRK3480 Forbrukeratferd,1452873090,2016-01-15 16:51:30,1452873123,33
5698da602fb0de2600f22ac5,98720,MRK3480 Forbrukeratferd,1453723799,2016-01-25 13:09:59,1453723801,2
5698da602fb0de2600f22ac5,93651,MRK3480 Forbrukeratferd,1453733772,2016-01-25 15:56:12,1453733828,56
5698da602fb0de2600f22ac5,87046,MRK3480 Forbrukeratferd,1453805063,2016-01-26 11:44:23,1453805064,1
5698da602fb0de2600f22ac5,41329,MRK3480 Forbrukeratferd,1453920361,2016-01-27 19:46:01,1453920363,2
5698da602fb0de2600f22ac5,48588,MRK3480 Forbrukeratferd,1453927352,2016-01-27 21:42:32,1453927420,68
5698da602fb0de2600f22ac7,59557,MRK3480 Forbrukeratferd,1452869340,2016-01-15 15:49:00,1452869497,157
5698da602fb0de2600f22ac7,43626,MRK3480 Forbrukeratferd,1452871552,2016-01-15 16:25:52,1452871554,2
5698da602fb0de2600f22ac9,36122,MRK3480 Forbrukeratferd,1453128397,2016-01-18 15:46:37,1453128693,296
5698da602fb0de2600f22ac9,45156,MRK3480 Forbrukeratferd,1453201406,2016-01-19 12:03:26,1453201462,56
5698da602fb0de2600f22ac9,89017,MRK3480 Forbrukeratferd,1453892414,2016-01-27 12:00:14,1453892542,128
5698da602fb0de2600f22ac9,94831,MRK3480 Forbrukeratferd,1453994690,2016-01-28 16:24:50,1453995203,513
5698da6041a9d721002407d3,97103,MRK3480 Forbrukeratferd,1453216843,2016-01-19 16:20:43,1453216966,123
5698da6041a9d721002407d3,56466,MRK3480 Forbrukeratferd,1453979339,2016-01-28 12:08:59,1453979390,51
5698da6041a9d721002407e4,12996,MRK3480 Forbrukeratferd,1453378141,2016-01-21 13:09:01,1453379266,1125
5698da6041a9d721002407e4,68272,MRK3480 Forbrukeratferd,1453383112,2016-01-21 14:31:52,1453383116,4
5698da6041a9d721002407e5,45276,MRK3480 Forbrukeratferd,1453416823,2016-01-21 23:53:43,1453416870,47
5698da6041a9d721002407e5,19108,MRK3480 Forbrukeratferd,1453942673,2016-01-28 01:57:53,1453942737,64
5698da6041a9d721002407e5,45319,MRK3480 Forbrukeratferd,1453945819,2016-01-28 02:50:19,1453945873,54
5698da6041a9d721002407e5,66469,MRK3480 Forbrukeratferd,1453996908,2016-01-28 17:01:48,1453996909,1
5698da612fb0de2600f22acb,21183,MRK3480 Forbrukeratferd,1452863142,2016-01-15 14:05:42,1452863142,0
5698da612fb0de2600f22acb,36920,MRK3480 Forbrukeratferd,1452864651,2016-01-15 14:30:51,1452864996,345
5698da612fb0de2600f22acb,38406,MRK3480 Forbrukeratferd,1453191968,2016-01-19 09:26:08,1453192756,788
5698da612fb0de2600f22acb,24592,MRK3480 Forbrukeratferd,1453283073,2016-01-20 10:44:33,1453284166,1093
5698da612fb0de2600f22acb,18068,MRK3480 Forbrukeratferd,1453285537,2016-01-20 11:25:37,1453285941,404
5698da612fb0de2600f22acb,46147,MRK3480 Forbrukeratferd,1453292941,2016-01-20 13:29:01,1453292945,4
5698da612fb0de2600f22acb,29412,MRK3480 Forbrukeratferd,1453374321,2016-01-21 12:05:21,1453374321,0
5698da612fb0de2600f22acb,37796,MRK3480 Forbrukeratferd,1453375778,2016-01-21 12:29:38,1453375783,5
5698da612fb0de2600f22acb,78577,MRK3480 Forbrukeratferd,1453378181,2016-01-21 13:09:41,1453378486,305
5698da612fb0de2600f22acb,71542,MRK3480 Forbrukeratferd,1453815842,2016-01-26 14:44:02,1453815943,101
5698da612fb0de2600f22acb,89801,MRK3480 Forbrukeratferd,1453825397,2016-01-26 17:23:17,1453825417,20
5698da612fb0de2600f22acb,37678,MRK3480 Forbrukeratferd,1453908515,2016-01-27 16:28:35,1453908552,37
5698da612fb0de2600f22acb,72453,MRK3480 Forbrukeratferd,1453913578,2016-01-27 17:52:58,1453913610,32
5698da612fb0de2600f22acb,50515,MRK3480 Forbrukeratferd,1453979014,2016-01-28 12:03:34,1453979953,939
5698da612fb0de2600f22acb,73709,MRK3480 Forbrukeratferd,1453986534,2016-01-28 14:08:54,1453986539,5
5698da612fb0de2600f22acb,12665,MRK3480 Forbrukeratferd,1453988531,2016-01-28 14:42:11,1453988531,0
5698da612fb0de2600f22acd,21857,MRK3480 Forbrukeratferd,1452954974,2016-01-16 15:36:14,1452955524,550
5698da612fb0de2600f22acd,11944,MRK3480 Forbrukeratferd,1452958360,2016-01-16 16:32:40,1452958866,506
5698da612fb0de2600f22acd,77799,MRK3480 Forbrukeratferd,1453119051,2016-01-18 13:10:51,1453119052,1
5698da612fb0de2600f22acd,24455,MRK3480 Forbrukeratferd,1453125477,2016-01-18 14:57:57,1453125506,29
5698da612fb0de2600f22acd,10298,MRK3480 Forbrukeratferd,1453293900,2016-01-20 13:45:00,1453294115,215
5698da612fb0de2600f22acd,14397,MRK3480 Forbrukeratferd,1453326876,2016-01-20 22:54:36,1453326973,97
5698da612fb0de2600f22acd,76259,MRK3480 Forbrukeratferd,1453637220,2016-01-24 13:07:00,1453637221,1
5698da612fb0de2600f22acd,30308,MRK3480 Forbrukeratferd,1453717515,2016-01-25 11:25:15,1453717530,15
5698da612fb0de2600f22acd,59995,MRK3480 Forbrukeratferd,1453978299,2016-01-28 11:51:39,1453978353,54
5698da612fb0de2600f22acd,57600,MRK3480 Forbrukeratferd,1454245950,2016-01-31 14:12:30,1454245950,0
5698da612fb0de2600f22ace,78008,MRK3480 Forbrukeratferd,1453240866,2016-01-19 23:01:06,1453242083,1217
5698da612fb0de2600f22ace,60928,MRK3480 Forbrukeratferd,1453290747,2016-01-20 12:52:27,1453292056,1309
5698da612fb0de2600f22ace,38541,MRK3480 Forbrukeratferd,1453299714,2016-01-20 15:21:54,1453299753,39
5698da612fb0de2600f22ace,51234,MRK3480 Forbrukeratferd,1453405775,2016-01-21 20:49:35,1453405783,8
5698da612fb0de2600f22ace,67027,MRK3480 Forbrukeratferd,1453848862,2016-01-26 23:54:22,1453849071,209
5698da622fb0de2600f22ae6,7135,MRK3480 Forbrukeratferd,1453139334,2016-01-18 18:48:54,1453143784,4450
5698da622fb0de2600f22ae6,82766,MRK3480 Forbrukeratferd,1453146154,2016-01-18 20:42:34,1453146154,0
5698da622fb0de2600f22ae6,67113,MRK3480 Forbrukeratferd,1453801135,2016-01-26 10:38:55,1453801147,12
5698da622fb0de2600f22ae6,31764,MRK3480 Forbrukeratferd,1453920609,2016-01-27 19:50:09,1453920768,159
5698da622fb0de2600f22ae9,51614,MRK3480 Forbrukeratferd,1453843583,2016-01-26 22:26:23,1453843652,69
5698da6241a9d721002408cb,63929,MRK3480 Forbrukeratferd,1453292787,2016-01-20 13:26:27,1453293028,241
5698da6241a9d721002408cb,417,MRK3480 Forbrukeratferd,1453808477,2016-01-26 12:41:17,1453809518,1041
5698da6241a9d721002408cc,54455,MRK3480 Forbrukeratferd,1453377075,2016-01-21 12:51:15,1453378361,1286
5698da6241a9d721002408cc,78754,MRK3480 Forbrukeratferd,1453416645,2016-01-21 23:50:45,1453418105,1460
5698da6241a9d721002408cc,41969,MRK3480 Forbrukeratferd,1453861441,2016-01-27 03:24:01,1453862338,897
5698da632fb0de2600f22aee,76869,MRK3480 Forbrukeratferd,1453374573,2016-01-21 12:09:33,1453374605,32
5698da632fb0de2600f22aee,84754,MRK3480 Forbrukeratferd,1453377483,2016-01-21 12:58:03,1453378382,899
5698da632fb0de2600f22af0,14730,MRK3480 Forbrukeratferd,1453237784,2016-01-19 22:09:44,1453237822,38
5698da6341a9d721002408cd,56859,MRK3480 Forbrukeratferd,1453668409,2016-01-24 21:46:49,1453668551,142
5698da6341a9d721002408cd,70971,MRK3480 Forbrukeratferd,1453670233,2016-01-24 22:17:13,1453671697,1464
5698da6341a9d721002408cd,7504,MRK3480 Forbrukeratferd,1453724723,2016-01-25 13:25:23,1453724779,56
5698da6341a9d721002408cd,63156,MRK3480 Forbrukeratferd,1453805332,2016-01-26 11:48:52,1453805359,27
5698da6341a9d721002408cd,82244,MRK3480 Forbrukeratferd,1453826889,2016-01-26 17:48:09,1453826889,0
5698da6341a9d721002408cd,11416,MRK3480 Forbrukeratferd,1453829622,2016-01-26 18:33:42,1453829622,0
5698da6341a9d721002408cd,39825,MRK3480 Forbrukeratferd,1453916567,2016-01-27 18:42:47,1453916567,0
5698da6341a9d721002408ce,57474,MRK3480 Forbrukeratferd,1453118244,2016-01-18 12:57:24,1453118523,279
5698da6341a9d721002408ce,85749,MRK3480 Forbrukeratferd,1453721626,2016-01-25 12:33:46,1453722050,424
5698da6341a9d721002408ce,49649,MRK3480 Forbrukeratferd,1453937159,2016-01-28 00:25:59,1453937963,804
5698da6341a9d721002408ce,78822,MRK3480 Forbrukeratferd,1454014864,2016-01-28 22:01:04,1454014867,3
5698da6341a9d721002408cf,66582,MRK3480 Forbrukeratferd,1453376158,2016-01-21 12:35:58,1453376174,16
5698da6341a9d721002408cf,17449,MRK3480 Forbrukeratferd,1453377995,2016-01-21 13:06:35,1453378036,41
5698da6341a9d721002408cf,19726,MRK3480 Forbrukeratferd,1453978814,2016-01-28 12:00:14,1453979188,374
5698da6341a9d721002408d0,99094,MRK3480 Forbrukeratferd,1452866742,2016-01-15 15:05:42,1452867133,391
5698da6341a9d721002408d0,22656,MRK3480 Forbrukeratferd,1453374513,2016-01-21 12:08:33,1453374651,138
5698da6341a9d721002408d0,23128,MRK3480 Forbrukeratferd,1453376254,2016-01-21 12:37:34,1453376296,42
5698da6341a9d721002408d0,71540,MRK3480 Forbrukeratferd,1453741474,2016-01-25 18:04:34,1453741874,400
5698da6341a9d721002408d0,87179,MRK3480 Forbrukeratferd,1453815998,2016-01-26 14:46:38,1453817095,1097
5698da6341a9d721002408db,69361,MRK3480 Forbrukeratferd,1452863942,2016-01-15 14:19:02,1452863942,0
5698da6341a9d721002408db,75945,MRK3480 Forbrukeratferd,1452881774,2016-01-15 19:16:14,1452882213,439
5698da6341a9d721002408db,53831,MRK3480 Forbrukeratferd,1453222748,2016-01-19 17:59:08,1453222825,77
5698da6341a9d721002408db,72910,MRK3480 Forbrukeratferd,1453374325,2016-01-21 12:05:25,1453374556,231
5698da6341a9d721002408db,9011,MRK3480 Forbrukeratferd,1453377803,2016-01-21 13:03:23,1453378035,232
5698da6341a9d721002408db,68321,MRK3480 Forbrukeratferd,1453483165,2016-01-22 18:19:25,1453483165,0
5698da6341a9d721002408db,20789,MRK3480 Forbrukeratferd,1453652014,2016-01-24 17:13:34,1453652063,49
5698da6341a9d721002408db,20411,MRK3480 Forbrukeratferd,1453677048,2016-01-25 00:10:48,1453677049,1
5698da6341a9d721002408db,74836,MRK3480 Forbrukeratferd,1453752078,2016-01-25 21:01:18,1453752078,0
5698da6341a9d721002408db,53384,MRK3480 Forbrukeratferd,1453753633,2016-01-25 21:27:13,1453754019,386
5698da6341a9d721002408db,17238,MRK3480 Forbrukeratferd,1453757022,2016-01-25 22:23:42,1453757098,76
5698da6341a9d721002408db,24611,MRK3480 Forbrukeratferd,1453892000,2016-01-27 11:53:20,1453892020,20
5698da6341a9d721002408db,34131,MRK3480 Forbrukeratferd,1453978594,2016-01-28 11:56:34,1453978692,98
5698da642fb0de2600f22af5,26653,MRK3480 Forbrukeratferd,1453128896,2016-01-18 15:54:56,1453129069,173
5698da642fb0de2600f22af5,74676,MRK3480 Forbrukeratferd,1453211855,2016-01-19 14:57:35,1453211895,40
5698da642fb0de2600f22af5,51907,MRK3480 Forbrukeratferd,1453218965,2016-01-19 16:56:05,1453218966,1
5698da642fb0de2600f22af5,34127,MRK3480 Forbrukeratferd,1453376167,2016-01-21 12:36:07,1453376181,14
5698da642fb0de2600f22af5,20360,MRK3480 Forbrukeratferd,1453378524,2016-01-21 13:15:24,1453378566,42
5698da642fb0de2600f22af5,3155,MRK3480 Forbrukeratferd,1453675598,2016-01-24 23:46:38,1453675599,1
5698da642fb0de2600f22af5,52107,MRK3480 Forbrukeratferd,1453733905,2016-01-25 15:58:25,1453733979,74
5698da642fb0de2600f22af5,196,MRK3480 Forbrukeratferd,1453915167,2016-01-27 18:19:27,1453915222,55
5698da642fb0de2600f22af5,20394,MRK3480 Forbrukeratferd,1453934572,2016-01-27 23:42:52,1453934573,1
5698da642fb0de2600f22af5,47665,MRK3480 Forbrukeratferd,1453978978,2016-01-28 12:02:58,1453979918,940
5698da642fb0de2600f22af5,58094,MRK3480 Forbrukeratferd,1453981512,2016-01-28 12:45:12,1453981513,1
5698da642fb0de2600f22af5,75983,MRK3480 Forbrukeratferd,1453990817,2016-01-28 15:20:17,1453990818,1
5698da642fb0de2600f22af5,59562,MRK3480 Forbrukeratferd,1454014452,2016-01-28 21:54:12,1454014464,12
5698da642fb0de2600f22af5,36890,MRK3480 Forbrukeratferd,1454063222,2016-01-29 11:27:02,1454063238,16
5698da642fb0de2600f22afa,43133,MRK3480 Forbrukeratferd,1453316664,2016-01-20 20:04:24,1453316805,141
5698da642fb0de2600f22afa,16830,MRK3480 Forbrukeratferd,1453724520,2016-01-25 13:22:00,1453724525,5
5698da642fb0de2600f22afa,40870,MRK3480 Forbrukeratferd,1453726773,2016-01-25 13:59:33,1453726805,32
5698da642fb0de2600f22afa,16371,MRK3480 Forbrukeratferd,1453815744,2016-01-26 14:42:24,1453815759,15
5698da642fb0de2600f22afa,34121,MRK3480 Forbrukeratferd,1453981134,2016-01-28 12:38:54,1453981185,51
5698da642fb0de2600f22afa,48171,MRK3480 Forbrukeratferd,1453999718,2016-01-28 17:48:38,1453999718,0
5698da642fb0de2600f22afa,76990,MRK3480 Forbrukeratferd,1454108418,2016-01-30 00:00:18,1454108418,0
5698da6441a9d721002408e0,69189,MRK3480 Forbrukeratferd,1453210382,2016-01-19 14:33:02,1453210410,28
5698da6441a9d721002408e0,12582,MRK3480 Forbrukeratferd,1453211997,2016-01-19 14:59:57,1453212363,366
5698da6441a9d721002408e0,88733,MRK3480 Forbrukeratferd,1453461823,2016-01-22 12:23:43,1453461996,173
5698da6441a9d721002408e3,85684,MRK3480 Forbrukeratferd,1454009249,2016-01-28 20:27:29,1454009344,95
5698da6441a9d721002408e4,75045,MRK3480 Forbrukeratferd,1453138116,2016-01-18 18:28:36,1453138523,407
5698da6441a9d721002408e4,62160,MRK3480 Forbrukeratferd,1453139856,2016-01-18 18:57:36,1453139883,27
5698da6441a9d721002408e4,25726,MRK3480 Forbrukeratferd,1453208818,2016-01-19 14:06:58,1453208848,30
5698da6441a9d721002408e4,17376,MRK3480 Forbrukeratferd,1453212493,2016-01-19 15:08:13,1453212989,496
5698da6441a9d721002408e4,92199,MRK3480 Forbrukeratferd,1453680126,2016-01-25 01:02:06,1453680701,575
5698da6441a9d721002408e4,99546,MRK3480 Forbrukeratferd,1453720460,2016-01-25 12:14:20,1453720486,26
5698da6441a9d721002408e4,30512,MRK3480 Forbrukeratferd,1453721690,2016-01-25 12:34:50,1453721694,4
5698da6441a9d721002408e4,38457,MRK3480 Forbrukeratferd,1453724471,2016-01-25 13:21:11,1453724522,51
5698da6441a9d721002408e4,52762,MRK3480 Forbrukeratferd,1453936322,2016-01-28 00:12:02,1453936451,129
5698da6441a9d721002408e4,36755,MRK3480 Forbrukeratferd,1453992903,2016-01-28 15:55:03,1453992926,23
5698da652fb0de2600f22b12,82499,MRK3480 Forbrukeratferd,1453374874,2016-01-21 12:14:34,1453374915,41
5698da652fb0de2600f22b12,86867,MRK3480 Forbrukeratferd,1453923425,2016-01-27 20:37:05,1453923470,45
5698da652fb0de2600f22b12,56463,MRK3480 Forbrukeratferd,1453924697,2016-01-27 20:58:17,1453925269,572
5698da6541a9d721002408fa,89919,MRK3480 Forbrukeratferd,1452861968,2016-01-15 13:46:08,1452862102,134
5698da6541a9d721002408fa,83493,MRK3480 Forbrukeratferd,1452865564,2016-01-15 14:46:04,1452865565,1
5698da6541a9d721002408fa,22344,MRK3480 Forbrukeratferd,1453104322,2016-01-18 09:05:22,1453104338,16
5698da6541a9d721002408fa,70517,MRK3480 Forbrukeratferd,1453373774,2016-01-21 11:56:14,1453373796,22
5698da6541a9d721002408fa,80888,MRK3480 Forbrukeratferd,1453384427,2016-01-21 14:53:47,1453384866,439
5698da6541a9d721002408fa,53715,MRK3480 Forbrukeratferd,1453386940,2016-01-21 15:35:40,1453387012,72
5698da6541a9d721002408fa,28887,MRK3480 Forbrukeratferd,1453656692,2016-01-24 18:31:32,1453656748,56
5698da6541a9d721002408fa,94668,MRK3480 Forbrukeratferd,1453727161,2016-01-25 14:06:01,1453727175,14
5698da6541a9d721002408fa,32172,MRK3480 Forbrukeratferd,1453835655,2016-01-26 20:14:15,1453835656,1
5698da6541a9d721002408fa,91688,MRK3480 Forbrukeratferd,1453977009,2016-01-28 11:30:09,1453977285,276
5698da6541a9d721002408fa,51062,MRK3480 Forbrukeratferd,1453978888,2016-01-28 12:01:28,1453978990,102
5698da662fb0de2600f22b15,98363,MRK3480 Forbrukeratferd,1453038747,2016-01-17 14:52:27,1453039500,753
5698da662fb0de2600f22b15,92749,MRK3480 Forbrukeratferd,1453069890,2016-01-17 23:31:30,1453069899,9
5698da662fb0de2600f22b15,2890,MRK3480 Forbrukeratferd,1453147966,2016-01-18 21:12:46,1453147967,1
5698da662fb0de2600f22b15,57522,MRK3480 Forbrukeratferd,1453157728,2016-01-18 23:55:28,1453159156,1428
5698da662fb0de2600f22b15,23312,MRK3480 Forbrukeratferd,1453645523,2016-01-24 15:25:23,1453645524,1
5698da662fb0de2600f22b15,93696,MRK3480 Forbrukeratferd,1453719655,2016-01-25 12:00:55,1453720286,631
5698da662fb0de2600f22b15,34283,MRK3480 Forbrukeratferd,1453730189,2016-01-25 14:56:29,1453730189,0
5698da662fb0de2600f22b15,19070,MRK3480 Forbrukeratferd,1453752492,2016-01-25 21:08:12,1453752795,303
5698da662fb0de2600f22b15,95615,MRK3480 Forbrukeratferd,1453837249,2016-01-26 20:40:49,1453837310,61
5698da662fb0de2600f22b15,28957,MRK3480 Forbrukeratferd,1453893211,2016-01-27 12:13:31,1453893603,392
5698da662fb0de2600f22b15,9739,MRK3480 Forbrukeratferd,1453895383,2016-01-27 12:49:43,1453896135,752
5698da662fb0de2600f22b15,70769,MRK3480 Forbrukeratferd,1453900782,2016-01-27 14:19:42,1453900787,5
5698da662fb0de2600f22b15,27324,MRK3480 Forbrukeratferd,1453910778,2016-01-27 17:06:18,1453910779,1
5698da662fb0de2600f22b15,14168,MRK3480 Forbrukeratferd,1453934047,2016-01-27 23:34:07,1453934156,109
5698da662fb0de2600f22b15,39092,MRK3480 Forbrukeratferd,1454187441,2016-01-30 21:57:21,1454187557,116
5698da662fb0de2600f22b19,83963,MRK3480 Forbrukeratferd,1453374555,2016-01-21 12:09:15,1453374555,0
5698da662fb0de2600f22b19,9367,MRK3480 Forbrukeratferd,1453376875,2016-01-21 12:47:55,1453378016,1141
5698da662fb0de2600f22b19,1801,MRK3480 Forbrukeratferd,1453382343,2016-01-21 14:19:03,1453382385,42
5698da662fb0de2600f22b19,50926,MRK3480 Forbrukeratferd,1453729004,2016-01-25 14:36:44,1453729656,652
5698da662fb0de2600f22b19,50233,MRK3480 Forbrukeratferd,1453983616,2016-01-28 13:20:16,1453984319,703
5698da6641a9d721002408fb,21145,MRK3480 Forbrukeratferd,1453287003,2016-01-20 11:50:03,1453287004,1
5698da6641a9d721002408fb,62751,MRK3480 Forbrukeratferd,1453288291,2016-01-20 12:11:31,1453289105,814
5698da6641a9d721002408fb,90101,MRK3480 Forbrukeratferd,1453664712,2016-01-24 20:45:12,1453665334,622
5698da6641a9d721002408fb,55469,MRK3480 Forbrukeratferd,1453677928,2016-01-25 00:25:28,1453677967,39
5698da6641a9d721002408fb,67277,MRK3480 Forbrukeratferd,1453723826,2016-01-25 13:10:26,1453723827,1
5698da6641a9d721002408fb,54670,MRK3480 Forbrukeratferd,1453837754,2016-01-26 20:49:14,1453838080,326
5698da6641a9d721002408fb,92609,MRK3480 Forbrukeratferd,1454076336,2016-01-29 15:05:36,1454076358,22
5698da6641a9d721002408fc,81585,MRK3480 Forbrukeratferd,1452864384,2016-01-15 14:26:24,1452864415,31
5698da6641a9d721002408fc,46332,MRK3480 Forbrukeratferd,1453721737,2016-01-25 12:35:37,1453721820,83
5698da6641a9d721002408fc,35487,MRK3480 Forbrukeratferd,1453818766,2016-01-26 15:32:46,1453819938,1172
5698da6641a9d721002408fd,90988,MRK3480 Forbrukeratferd,1453375774,2016-01-21 12:29:34,1453375775,1
5698da6641a9d721002408fd,76759,MRK3480 Forbrukeratferd,1453378000,2016-01-21 13:06:40,1453378013,13
5698da6641a9d721002408fd,31177,MRK3480 Forbrukeratferd,1453730984,2016-01-25 15:09:44,1453730996,12
5698da6641a9d721002408fd,90099,MRK3480 Forbrukeratferd,1453892473,2016-01-27 12:01:13,1453892475,2
5698da6641a9d721002408fd,21814,MRK3480 Forbrukeratferd,1453982552,2016-01-28 13:02:32,1453983770,1218
5698da672fb0de2600f22b1d,56614,MRK3480 Forbrukeratferd,1452876705,2016-01-15 17:51:45,1452877395,690
5698da672fb0de2600f22b1d,63025,MRK3480 Forbrukeratferd,1453212121,2016-01-19 15:02:01,1453212609,488
5698da672fb0de2600f22b1d,12416,MRK3480 Forbrukeratferd,1453217035,2016-01-19 16:23:55,1453217035,0
5698da672fb0de2600f22b1d,13443,MRK3480 Forbrukeratferd,1453288075,2016-01-20 12:07:55,1453288075,0
5698da672fb0de2600f22b1d,67102,MRK3480 Forbrukeratferd,1453291705,2016-01-20 13:08:25,1453292027,322
5698da672fb0de2600f22b1f,63412,MRK3480 Forbrukeratferd,1452862730,2016-01-15 13:58:50,1452862981,251
5698da672fb0de2600f22b1f,5314,MRK3480 Forbrukeratferd,1452864303,2016-01-15 14:25:03,1452864347,44
5698da672fb0de2600f22b1f,26774,MRK3480 Forbrukeratferd,1453045375,2016-01-17 16:42:55,1453045634,259
5698da672fb0de2600f22b1f,87025,MRK3480 Forbrukeratferd,1453375409,2016-01-21 12:23:29,1453375744,335
5698da672fb0de2600f22b1f,63786,MRK3480 Forbrukeratferd,1453822836,2016-01-26 16:40:36,1453824579,1743
5698da6741a9d72100240900,84090,MRK3480 Forbrukeratferd,1453078445,2016-01-18 01:54:05,1453078696,251
5698da6741a9d72100240900,17391,MRK3480 Forbrukeratferd,1453374734,2016-01-21 12:12:14,1453374751,17
5698da6741a9d72100240900,15930,MRK3480 Forbrukeratferd,1453675885,2016-01-24 23:51:25,1453677776,1891
5698da6741a9d72100240900,47971,MRK3480 Forbrukeratferd,1453979401,2016-01-28 12:10:01,1453979984,583
5698da6741a9d72100240904,2040,MRK3480 Forbrukeratferd,1453039329,2016-01-17 15:02:09,1453039836,507
5698da6741a9d72100240904,68603,MRK3480 Forbrukeratferd,1453120346,2016-01-18 13:32:26,1453120431,85
5698da6741a9d72100240904,90913,MRK3480 Forbrukeratferd,1453208051,2016-01-19 13:54:11,1453208051,0
5698da6741a9d72100240904,65013,MRK3480 Forbrukeratferd,1453209539,2016-01-19 14:18:59,1453209724,185
5698da6741a9d72100240904,59354,MRK3480 Forbrukeratferd,1453388513,2016-01-21 16:01:53,1453389505,992
5698da6741a9d72100240904,20763,MRK3480 Forbrukeratferd,1453805190,2016-01-26 11:46:30,1453805216,26
5698da6741a9d72100240904,39780,MRK3480 Forbrukeratferd,1453810509,2016-01-26 13:15:09,1453810510,1
5698da6741a9d72100240904,85080,MRK3480 Forbrukeratferd,1453835017,2016-01-26 20:03:37,1453835079,62
5698da6741a9d72100240904,75819,MRK3480 Forbrukeratferd,1453904670,2016-01-27 15:24:30,1453904993,323
5698da6741a9d72100240904,99522,MRK3480 Forbrukeratferd,1453911661,2016-01-27 17:21:01,1453911701,40
5698da682fb0de2600f22b24,3655,MRK3480 Forbrukeratferd,1453133580,2016-01-18 17:13:00,1453133640,60
5698da682fb0de2600f22b24,82866,MRK3480 Forbrukeratferd,1453300681,2016-01-20 15:38:01,1453300739,58
5698da682fb0de2600f22b24,70086,MRK3480 Forbrukeratferd,1453375327,2016-01-21 12:22:07,1453375462,135
5698da682fb0de2600f22b24,46890,MRK3480 Forbrukeratferd,1453378035,2016-01-21 13:07:15,1453378236,201
5698da682fb0de2600f22b24,22704,MRK3480 Forbrukeratferd,1453748838,2016-01-25 20:07:18,1453748903,65
5698da682fb0de2600f22b24,52126,MRK3480 Forbrukeratferd,1453811168,2016-01-26 13:26:08,1453811173,5
5698da682fb0de2600f22b24,99464,MRK3480 Forbrukeratferd,1453844918,2016-01-26 22:48:38,1453844965,47
5698da682fb0de2600f22b24,4547,MRK3480 Forbrukeratferd,1453906732,2016-01-27 15:58:52,1453906772,40
5698da682fb0de2600f22b24,97294,MRK3480 Forbrukeratferd,1453930135,2016-01-27 22:28:55,1453930179,44
5698da682fb0de2600f22b24,11442,MRK3480 Forbrukeratferd,1453980959,2016-01-28 12:35:59,1453980979,20
5698da682fb0de2600f22b24,27991,MRK3480 Forbrukeratferd,1453986123,2016-01-28 14:02:03,1453986130,7
5698da682fb0de2600f22b25,92245,MRK3480 Forbrukeratferd,1453122848,2016-01-18 14:14:08,1453123388,540
5698da682fb0de2600f22b25,11754,MRK3480 Forbrukeratferd,1453370178,2016-01-21 10:56:18,1453370631,453
5698da682fb0de2600f22b25,11350,MRK3480 Forbrukeratferd,1453376584,2016-01-21 12:43:04,1453377742,1158
5698da682fb0de2600f22b25,34639,MRK3480 Forbrukeratferd,1453638525,2016-01-24 13:28:45,1453638543,18
5698da682fb0de2600f22b25,28706,MRK3480 Forbrukeratferd,1453709113,2016-01-25 09:05:13,1453709120,7
5698da682fb0de2600f22b25,92959,MRK3480 Forbrukeratferd,1453805289,2016-01-26 11:48:09,1453805330,41
5698da682fb0de2600f22b25,29835,MRK3480 Forbrukeratferd,1453993056,2016-01-28 15:57:36,1453993198,142
5698da682fb0de2600f22b25,42356,MRK3480 Forbrukeratferd,1454009904,2016-01-28 20:38:24,1454009904,0
5698da682fb0de2600f22b25,84061,MRK3480 Forbrukeratferd,1454014829,2016-01-28 22:00:29,1454014829,0
5698da682fb0de2600f22b25,2859,MRK3480 Forbrukeratferd,1454063105,2016-01-29 11:25:05,1454063117,12
5698da6841a9d7210024090a,21948,MRK3480 Forbrukeratferd,1453239183,2016-01-19 22:33:03,1453239223,40
5698da6841a9d7210024090a,51781,MRK3480 Forbrukeratferd,1453305448,2016-01-20 16:57:28,1453306097,649
5698da6841a9d7210024090a,31464,MRK3480 Forbrukeratferd,1453315934,2016-01-20 19:52:14,1453317849,1915
5698da6841a9d7210024090a,25411,MRK3480 Forbrukeratferd,1453320021,2016-01-20 21:00:21,1453320218,197
5698da6841a9d7210024090a,64939,MRK3480 Forbrukeratferd,1453366607,2016-01-21 09:56:47,1453366846,239
5698da6841a9d7210024090a,41513,MRK3480 Forbrukeratferd,1453456117,2016-01-22 10:48:37,1453456117,0
5698da6841a9d7210024090a,42885,MRK3480 Forbrukeratferd,1453471086,2016-01-22 14:58:06,1453471086,0
5698da6841a9d7210024090a,18905,MRK3480 Forbrukeratferd,1453676397,2016-01-24 23:59:57,1453676398,1
5698da6841a9d7210024090a,95944,MRK3480 Forbrukeratferd,1453725356,2016-01-25 13:35:56,1453725357,1
5698da6841a9d7210024090a,89447,MRK3480 Forbrukeratferd,1453810930,2016-01-26 13:22:10,1453810951,21
5698da6841a9d7210024090a,80289,MRK3480 Forbrukeratferd,1453912942,2016-01-27 17:42:22,1453912990,48
5698da6841a9d7210024090a,2608,MRK3480 Forbrukeratferd,1454002177,2016-01-28 18:29:37,1454002804,627
5698da6841a9d7210024090a,84720,MRK3480 Forbrukeratferd,1454018408,2016-01-28 23:00:08,1454018498,90
5698da6841a9d7210024090a,38257,MRK3480 Forbrukeratferd,1454068204,2016-01-29 12:50:04,1454068208,4
5698da6841a9d7210024090c,13638,MRK3480 Forbrukeratferd,1453049576,2016-01-17 17:52:56,1453049631,55
5698da6841a9d7210024090c,6737,MRK3480 Forbrukeratferd,1453986786,2016-01-28 14:13:06,1453986858,72
5698da6841a9d7210024091f,98307,MRK3480 Forbrukeratferd,1453143138,2016-01-18 19:52:18,1453143435,297
5698da6841a9d7210024091f,93310,MRK3480 Forbrukeratferd,1453145740,2016-01-18 20:35:40,1453146671,931
5698da6841a9d7210024091f,19875,MRK3480 Forbrukeratferd,1453492547,2016-01-22 20:55:47,1453492552,5
5698da6841a9d7210024091f,42281,MRK3480 Forbrukeratferd,1453729361,2016-01-25 14:42:41,1453729415,54
5698da6841a9d7210024091f,91276,MRK3480 Forbrukeratferd,1453940686,2016-01-28 01:24:46,1453940933,247
5698da6841a9d7210024091f,13179,MRK3480 Forbrukeratferd,1453994648,2016-01-28 16:24:08,1453994649,1
5698da6841a9d7210024091f,38604,MRK3480 Forbrukeratferd,1454081805,2016-01-29 16:36:45,1454081808,3
5698da692fb0de2600f22b3b,33912,MRK3480 Forbrukeratferd,1453819703,2016-01-26 15:48:23,1453819820,117
5698da692fb0de2600f22b3c,17422,MRK3480 Forbrukeratferd,1453570698,2016-01-23 18:38:18,1453570717,19
5698da692fb0de2600f22b3d,85989,MRK3480 Forbrukeratferd,1453032876,2016-01-17 13:14:36,1453033405,529
5698da692fb0de2600f22b3d,25693,MRK3480 Forbrukeratferd,1453244645,2016-01-20 00:04:05,1453244740,95
5698da692fb0de2600f22b3d,6480,MRK3480 Forbrukeratferd,1453906402,2016-01-27 15:53:22,1453906768,366
5698da692fb0de2600f22b3d,53912,MRK3480 Forbrukeratferd,1454067114,2016-01-29 12:31:54,1454067240,126
5698da692fb0de2600f22b3d,15231,MRK3480 Forbrukeratferd,1454069270,2016-01-29 13:07:50,1454069751,481
5698da692fb0de2600f22b3d,24565,MRK3480 Forbrukeratferd,1454071756,2016-01-29 13:49:16,1454071786,30
5698da692fb0de2600f22b3d,6176,MRK3480 Forbrukeratferd,1454077660,2016-01-29 15:27:40,1454077665,5
5698da692fb0de2600f22b3d,16672,MRK3480 Forbrukeratferd,1454270315,2016-01-31 20:58:35,1454270551,236
5698da692fb0de2600f22b3e,89593,MRK3480 Forbrukeratferd,1453111853,2016-01-18 11:10:53,1453112433,580
5698da692fb0de2600f22b3e,62356,MRK3480 Forbrukeratferd,1453318546,2016-01-20 20:35:46,1453319137,591
5698da692fb0de2600f22b3e,92638,MRK3480 Forbrukeratferd,1453660438,2016-01-24 19:33:58,1453660479,41
5698da692fb0de2600f22b3e,26315,MRK3480 Forbrukeratferd,1453675918,2016-01-24 23:51:58,1453675928,10
5698da692fb0de2600f22b3e,54416,MRK3480 Forbrukeratferd,1453807413,2016-01-26 12:23:33,1453807447,34
5698da692fb0de2600f22b3e,32955,MRK3480 Forbrukeratferd,1453911081,2016-01-27 17:11:21,1453911082,1
5698da6941a9d72100240922,81431,MRK3480 Forbrukeratferd,1453304165,2016-01-20 16:36:05,1453304509,344
5698da6941a9d72100240922,50201,MRK3480 Forbrukeratferd,1453376533,2016-01-21 12:42:13,1453376554,21
5698da6941a9d72100240922,211,MRK3480 Forbrukeratferd,1453978924,2016-01-28 12:02:04,1453979950,1026
5698da6941a9d72100240922,71397,MRK3480 Forbrukeratferd,1454030177,2016-01-29 02:16:17,1454030188,11
5698da6941a9d72100240923,17967,MRK3480 Forbrukeratferd,1453377283,2016-01-21 12:54:43,1453378168,885
5698da6941a9d72100240923,42668,MRK3480 Forbrukeratferd,1453899983,2016-01-27 14:06:23,1453901888,1905
5698da6941a9d72100240923,57823,MRK3480 Forbrukeratferd,1453904713,2016-01-27 15:25:13,1453904713,0
5698da6941a9d72100240923,81855,MRK3480 Forbrukeratferd,1453907007,2016-01-27 16:03:27,1453907430,423
5698da6941a9d72100240924,14966,MRK3480 Forbrukeratferd,1453903090,2016-01-27 14:58:10,1453904949,1859
5698da6941a9d72100240925,67419,MRK3480 Forbrukeratferd,1453741824,2016-01-25 18:10:24,1453741865,41
5698da6941a9d72100240925,78235,MRK3480 Forbrukeratferd,1453810377,2016-01-26 13:12:57,1453810385,8
5698da6a2fb0de2600f22b44,64402,MRK3480 Forbrukeratferd,1453818472,2016-01-26 15:27:52,1453818672,200
5698da6a2fb0de2600f22b44,74613,MRK3480 Forbrukeratferd,1453913377,2016-01-27 17:49:37,1453914077,700
5698da6a2fb0de2600f22b44,88812,MRK3480 Forbrukeratferd,1453915616,2016-01-27 18:26:56,1453915716,100
5698da6a2fb0de2600f22b44,29127,MRK3480 Forbrukeratferd,1453937017,2016-01-28 00:23:37,1453937201,184
5698da6a2fb0de2600f22b45,13368,MRK3480 Forbrukeratferd,1452888239,2016-01-15 21:03:59,1452888306,67
5698da6a2fb0de2600f22b45,24158,MRK3480 Forbrukeratferd,1453131341,2016-01-18 16:35:41,1453131921,580
5698da6a2fb0de2600f22b45,38005,MRK3480 Forbrukeratferd,1453291837,2016-01-20 13:10:37,1453291885,48
5698da6a2fb0de2600f22b45,42245,MRK3480 Forbrukeratferd,1453729800,2016-01-25 14:50:00,1453729858,58
5698da6a2fb0de2600f22b45,92060,MRK3480 Forbrukeratferd,1453886312,2016-01-27 10:18:32,1453886356,44
5698da6a2fb0de2600f22b45,17537,MRK3480 Forbrukeratferd,1453979835,2016-01-28 12:17:15,1453979851,16
5698da6a2fb0de2600f22b45,93302,MRK3480 Forbrukeratferd,1453981065,2016-01-28 12:37:45,1453981068,3
5698da6a41a9d72100240928,7742,MRK3480 Forbrukeratferd,1453111266,2016-01-18 11:01:06,1453111423,157
5698da6a41a9d72100240928,49913,MRK3480 Forbrukeratferd,1453288666,2016-01-20 12:17:46,1453289033,367
5698da6a41a9d72100240928,97887,MRK3480 Forbrukeratferd,1453716513,2016-01-25 11:08:33,1453716526,13
5698da6a41a9d72100240928,23159,MRK3480 Forbrukeratferd,1453808644,2016-01-26 12:44:04,1453808713,69
5698da6a41a9d72100240928,82968,MRK3480 Forbrukeratferd,1453928263,2016-01-27 21:57:43,1453928352,89
5698da6a41a9d72100240934,31827,MRK3480 Forbrukeratferd,1453758556,2016-01-25 22:49:16,1453758640,84
5698da6a41a9d72100240934,8321,MRK3480 Forbrukeratferd,1453985813,2016-01-28 13:56:53,1453985879,66
5698da6a41a9d72100240934,77353,MRK3480 Forbrukeratferd,1453987478,2016-01-28 14:24:38,1453987484,6
5698da6b2fb0de2600f22b4b,62757,MRK3480 Forbrukeratferd,1453127198,2016-01-18 15:26:38,1453127523,325
5698da6b2fb0de2600f22b4b,15729,MRK3480 Forbrukeratferd,1453722567,2016-01-25 12:49:27,1453722603,36
5698da6b2fb0de2600f22b4b,35561,MRK3480 Forbrukeratferd,1453856077,2016-01-27 01:54:37,1453856077,0
5698da6b2fb0de2600f22b4b,55391,MRK3480 Forbrukeratferd,1453950619,2016-01-28 04:10:19,1453950659,40
5698da6b2fb0de2600f22b4c,9975,MRK3480 Forbrukeratferd,1453252765,2016-01-20 02:19:25,1453253569,804
5698da6b2fb0de2600f22b4c,54526,MRK3480 Forbrukeratferd,1453336155,2016-01-21 01:29:15,1453336871,716
5698da6b2fb0de2600f22b4c,69772,MRK3480 Forbrukeratferd,1453660843,2016-01-24 19:40:43,1453660872,29
5698da6b2fb0de2600f22b4c,22490,MRK3480 Forbrukeratferd,1453677170,2016-01-25 00:12:50,1453677244,74
5698da6b2fb0de2600f22b4c,93008,MRK3480 Forbrukeratferd,1453919272,2016-01-27 19:27:52,1453919585,313
5698da6b2fb0de2600f22b4c,45676,MRK3480 Forbrukeratferd,1453939280,2016-01-28 01:01:20,1453940964,1684
5698da6b2fb0de2600f22b4c,75812,MRK3480 Forbrukeratferd,1453984526,2016-01-28 13:35:26,1453984787,261
5698da6b2fb0de2600f22b4c,14151,MRK3480 Forbrukeratferd,1453994711,2016-01-28 16:25:11,1453995796,1085
5698da6b2fb0de2600f22b4c,50752,MRK3480 Forbrukeratferd,1454016659,2016-01-28 22:30:59,1454016813,154
5698da6b2fb0de2600f22b4c,24308,MRK3480 Forbrukeratferd,1454019336,2016-01-28 23:15:36,1454019336,0
5698da6b2fb0de2600f22b4c,9066,MRK3480 Forbrukeratferd,1454273483,2016-01-31 21:51:23,1454273483,0
5698da6b2fb0de2600f22b4c,23454,MRK3480 Forbrukeratferd,1454278505,2016-01-31 23:15:05,1454278514,9
5698da6b2fb0de2600f22b4d,39215,MRK3480 Forbrukeratferd,1452894448,2016-01-15 22:47:28,1452894609,161
5698da6b2fb0de2600f22b4d,46005,MRK3480 Forbrukeratferd,1453145341,2016-01-18 20:29:01,1453145436,95
5698da6b2fb0de2600f22b4d,57706,MRK3480 Forbrukeratferd,1453150757,2016-01-18 21:59:17,1453150847,90
5698da6b2fb0de2600f22b4d,46808,MRK3480 Forbrukeratferd,1453153808,2016-01-18 22:50:08,1453155387,1579
5698da6b2fb0de2600f22b4d,22299,MRK3480 Forbrukeratferd,1453375310,2016-01-21 12:21:50,1453375510,200
5698da6b2fb0de2600f22b4d,79300,MRK3480 Forbrukeratferd,1453377053,2016-01-21 12:50:53,1453377264,211
5698da6b2fb0de2600f22b4d,83520,MRK3480 Forbrukeratferd,1453381704,2016-01-21 14:08:24,1453381704,0
5698da6b2fb0de2600f22b4d,87991,MRK3480 Forbrukeratferd,1453408920,2016-01-21 21:42:00,1453408922,2
5698da6b2fb0de2600f22b4d,59587,MRK3480 Forbrukeratferd,1453675850,2016-01-24 23:50:50,1453675850,0
5698da6b2fb0de2600f22b4d,12543,MRK3480 Forbrukeratferd,1453806028,2016-01-26 12:00:28,1453806029,1
5698da6b2fb0de2600f22b4d,15541,MRK3480 Forbrukeratferd,1453915716,2016-01-27 18:28:36,1453915807,91
5698da6b2fb0de2600f22b4d,99324,MRK3480 Forbrukeratferd,1453983096,2016-01-28 13:11:36,1453983129,33
5698da6c2fb0de2600f22b62,59033,MRK3480 Forbrukeratferd,1453297823,2016-01-20 14:50:23,1453298306,483
5698da6c2fb0de2600f22b62,50839,MRK3480 Forbrukeratferd,1453301604,2016-01-20 15:53:24,1453301605,1
5698da6c2fb0de2600f22b62,5467,MRK3480 Forbrukeratferd,1453723816,2016-01-25 13:10:16,1453723824,8
5698da6c2fb0de2600f22b62,54056,MRK3480 Forbrukeratferd,1453729270,2016-01-25 14:41:10,1453729620,350
5698da6c2fb0de2600f22b62,71699,MRK3480 Forbrukeratferd,1453732755,2016-01-25 15:39:15,1453732756,1
5698da6c2fb0de2600f22b62,32,MRK3480 Forbrukeratferd,1453807287,2016-01-26 12:21:27,1453807311,24
5698da6c2fb0de2600f22b62,7200,MRK3480 Forbrukeratferd,1453812839,2016-01-26 13:53:59,1453813538,699
5698da6c2fb0de2600f22b64,42557,MRK3480 Forbrukeratferd,1452959892,2016-01-16 16:58:12,1452959937,45
5698da6c2fb0de2600f22b64,23250,MRK3480 Forbrukeratferd,1452971106,2016-01-16 20:05:06,1452971221,115
5698da6c2fb0de2600f22b64,65968,MRK3480 Forbrukeratferd,1452972431,2016-01-16 20:27:11,1452972518,87
5698da6c2fb0de2600f22b64,41053,MRK3480 Forbrukeratferd,1453067772,2016-01-17 22:56:12,1453067858,86
5698da6c2fb0de2600f22b64,91774,MRK3480 Forbrukeratferd,1453125627,2016-01-18 15:00:27,1453125688,61
5698da6c2fb0de2600f22b64,54223,MRK3480 Forbrukeratferd,1453211066,2016-01-19 14:44:26,1453211067,1
5698da6c2fb0de2600f22b64,32153,MRK3480 Forbrukeratferd,1453243090,2016-01-19 23:38:10,1453243106,16
5698da6c2fb0de2600f22b64,17669,MRK3480 Forbrukeratferd,1453314043,2016-01-20 19:20:43,1453314265,222
5698da6c2fb0de2600f22b64,51487,MRK3480 Forbrukeratferd,1453316047,2016-01-20 19:54:07,1453317205,1158
5698da6c2fb0de2600f22b64,53107,MRK3480 Forbrukeratferd,1453323216,2016-01-20 21:53:36,1453323357,141
5698da6c2fb0de2600f22b64,1595,MRK3480 Forbrukeratferd,1453380992,2016-01-21 13:56:32,1453381076,84
5698da6c2fb0de2600f22b64,70868,MRK3480 Forbrukeratferd,1453770633,2016-01-26 02:10:33,1453770669,36
5698da6c2fb0de2600f22b64,73311,MRK3480 Forbrukeratferd,1453978943,2016-01-28 12:02:23,1453978991,48
5698da6c2fb0de2600f22b64,4368,MRK3480 Forbrukeratferd,1454030660,2016-01-29 02:24:20,1454030660,0
5698da6c2fb0de2600f22b64,84377,MRK3480 Forbrukeratferd,1454273771,2016-01-31 21:56:11,1454273771,0
5698da6c2fb0de2600f22b64,95334,MRK3480 Forbrukeratferd,1454315818,2016-02-01 09:36:58,1454315818,0
5698da6c2fb0de2600f22b66,1358,MRK3480 Forbrukeratferd,1453153461,2016-01-18 22:44:21,1453153757,296
5698da6c2fb0de2600f22b66,21345,MRK3480 Forbrukeratferd,1453883874,2016-01-27 09:37:54,1453884246,372
5698da6c41a9d72100240947,90768,MRK3480 Forbrukeratferd,1453105182,2016-01-18 09:19:42,1453105259,77
5698da6c41a9d72100240947,68569,MRK3480 Forbrukeratferd,1453719877,2016-01-25 12:04:37,1453719986,109
5698da6c41a9d72100240947,67529,MRK3480 Forbrukeratferd,1453733499,2016-01-25 15:51:39,1453733558,59
5698da6c41a9d72100240948,61462,MRK3480 Forbrukeratferd,1452868981,2016-01-15 15:43:01,1452869004,23
5698da6c41a9d72100240948,1632,MRK3480 Forbrukeratferd,1453724167,2016-01-25 13:16:07,1453724192,25
5698da6c41a9d72100240948,46044,MRK3480 Forbrukeratferd,1453979852,2016-01-28 12:17:32,1453979880,28
5698da6d41a9d72100240952,24378,MRK3480 Forbrukeratferd,1453119740,2016-01-18 13:22:20,1453120228,488
5698da6d41a9d72100240952,66199,MRK3480 Forbrukeratferd,1453676859,2016-01-25 00:07:39,1453676975,116
5698da6d41a9d72100240952,80819,MRK3480 Forbrukeratferd,1453724863,2016-01-25 13:27:43,1453724868,5
5698da6d41a9d72100240952,47296,MRK3480 Forbrukeratferd,1453805679,2016-01-26 11:54:39,1453805680,1
5698da6d41a9d72100240952,54214,MRK3480 Forbrukeratferd,1453922094,2016-01-27 20:14:54,1453922135,41
5698da6d41a9d72100240952,76491,MRK3480 Forbrukeratferd,1453925686,2016-01-27 21:14:46,1453925688,2
5698da6e2fb0de2600f22b71,92927,MRK3480 Forbrukeratferd,1452862167,2016-01-15 13:49:27,1452862216,49
5698da6e2fb0de2600f22b71,66942,MRK3480 Forbrukeratferd,1452863454,2016-01-15 14:10:54,1452863504,50
5698da6e2fb0de2600f22b71,45763,MRK3480 Forbrukeratferd,1452875624,2016-01-15 17:33:44,1452875706,82
5698da6e2fb0de2600f22b71,5849,MRK3480 Forbrukeratferd,1452894281,2016-01-15 22:44:41,1452894301,20
5698da6e2fb0de2600f22b71,89564,MRK3480 Forbrukeratferd,1452900019,2016-01-16 00:20:19,1452900021,2
5698da6e2fb0de2600f22b71,23777,MRK3480 Forbrukeratferd,1452986648,2016-01-17 00:24:08,1452986658,10
5698da6e2fb0de2600f22b71,59058,MRK3480 Forbrukeratferd,1453030116,2016-01-17 12:28:36,1453030161,45
5698da6e2fb0de2600f22b71,26320,MRK3480 Forbrukeratferd,1453374336,2016-01-21 12:05:36,1453374758,422
5698da6e2fb0de2600f22b71,17995,MRK3480 Forbrukeratferd,1453376532,2016-01-21 12:42:12,1453376548,16
5698da6e2fb0de2600f22b71,45734,MRK3480 Forbrukeratferd,1453718191,2016-01-25 11:36:31,1453718204,13
5698da6e2fb0de2600f22b71,17497,MRK3480 Forbrukeratferd,1453805430,2016-01-26 11:50:30,1453805431,1
5698da6e2fb0de2600f22b71,5380,MRK3480 Forbrukeratferd,1453938152,2016-01-28 00:42:32,1453938184,32
5698da6e2fb0de2600f22b74,75654,MRK3480 Forbrukeratferd,1452896533,2016-01-15 23:22:13,1452896718,185
5698da6e2fb0de2600f22b74,68361,MRK3480 Forbrukeratferd,1452967043,2016-01-16 18:57:23,1452967043,0
5698da6e2fb0de2600f22b74,34486,MRK3480 Forbrukeratferd,1453112582,2016-01-18 11:23:02,1453112582,0
5698da6e2fb0de2600f22b74,13356,MRK3480 Forbrukeratferd,1453119838,2016-01-18 13:23:58,1453120385,547
5698da6e2fb0de2600f22b74,93692,MRK3480 Forbrukeratferd,1453151349,2016-01-18 22:09:09,1453151358,9
5698da6e2fb0de2600f22b74,65187,MRK3480 Forbrukeratferd,1453376225,2016-01-21 12:37:05,1453376292,67
5698da6e2fb0de2600f22b74,49557,MRK3480 Forbrukeratferd,1453723166,2016-01-25 12:59:26,1453723179,13
5698da6e2fb0de2600f22b74,32728,MRK3480 Forbrukeratferd,1453726667,2016-01-25 13:57:47,1453726675,8
5698da6e2fb0de2600f22b74,5635,MRK3480 Forbrukeratferd,1453815260,2016-01-26 14:34:20,1453815261,1
5698da6e2fb0de2600f22b74,28769,MRK3480 Forbrukeratferd,1453913045,2016-01-27 17:44:05,1453913103,58
5698da6e41a9d72100240954,50061,MRK3480 Forbrukeratferd,1453289253,2016-01-20 12:27:33,1453290000,747
5698da6e41a9d72100240954,90406,MRK3480 Forbrukeratferd,1453892570,2016-01-27 12:02:50,1453893582,1012
5698da6e41a9d72100240955,15748,MRK3480 Forbrukeratferd,1453709884,2016-01-25 09:18:04,1453709926,42
5698da6e41a9d72100240955,23024,MRK3480 Forbrukeratferd,1453979449,2016-01-28 12:10:49,1453979936,487
5698da6e41a9d72100240955,2433,MRK3480 Forbrukeratferd,1453982038,2016-01-28 12:53:58,1453982465,427
5698da6e41a9d72100240955,20909,MRK3480 Forbrukeratferd,1454015675,2016-01-28 22:14:35,1454016304,629
5698da6e41a9d72100240955,75335,MRK3480 Forbrukeratferd,1454018979,2016-01-28 23:09:39,1454018983,4
5698da6e41a9d72100240956,94950,MRK3480 Forbrukeratferd,1453998032,2016-01-28 17:20:32,1453998230,198
5698da6e41a9d72100240957,81361,MRK3480 Forbrukeratferd,1453377691,2016-01-21 13:01:31,1453378453,762
5698da6e41a9d72100240957,43698,MRK3480 Forbrukeratferd,1453821148,2016-01-26 16:12:28,1453821781,633
5698da6e41a9d72100240957,48124,MRK3480 Forbrukeratferd,1453982480,2016-01-28 13:01:20,1453982496,16
5698da6e41a9d72100240958,56960,MRK3480 Forbrukeratferd,1453246160,2016-01-20 00:29:20,1453246279,119
5698da6e41a9d72100240958,96318,MRK3480 Forbrukeratferd,1453408400,2016-01-21 21:33:20,1453408406,6
5698da6e41a9d72100240958,85665,MRK3480 Forbrukeratferd,1453639665,2016-01-24 13:47:45,1453639697,32
5698da6f2fb0de2600f22b8a,18528,MRK3480 Forbrukeratferd,1452902225,2016-01-16 00:57:05,1452902384,159
5698da6f2fb0de2600f22b8a,11077,MRK3480 Forbrukeratferd,1453679818,2016-01-25 00:56:58,1453679819,1
5698da6f41a9d7210024096f,20308,MRK3480 Forbrukeratferd,1452872681,2016-01-15 16:44:41,1452872719,38
5698da6f41a9d7210024096f,54524,MRK3480 Forbrukeratferd,1452888701,2016-01-15 21:11:41,1452888701,0
5698da6f41a9d7210024096f,24570,MRK3480 Forbrukeratferd,1453471328,2016-01-22 15:02:08,1453471431,103
5698da6f41a9d7210024096f,72659,MRK3480 Forbrukeratferd,1453480242,2016-01-22 17:30:42,1453480245,3
5698da6f41a9d7210024096f,75984,MRK3480 Forbrukeratferd,1453493480,2016-01-22 21:11:20,1453493965,485
5698da6f41a9d7210024096f,37587,MRK3480 Forbrukeratferd,1453546247,2016-01-23 11:50:47,1453546247,0
5698da6f41a9d7210024096f,41529,MRK3480 Forbrukeratferd,1453560971,2016-01-23 15:56:11,1453560977,6
5698da6f41a9d7210024096f,5429,MRK3480 Forbrukeratferd,1453633538,2016-01-24 12:05:38,1453635381,1843
5698da6f41a9d7210024096f,41042,MRK3480 Forbrukeratferd,1453918451,2016-01-27 19:14:11,1453918480,29
5698da7041a9d72100240970,59943,MRK3480 Forbrukeratferd,1452879106,2016-01-15 18:31:46,1452879869,763
5698da7041a9d72100240971,14693,MRK3480 Forbrukeratferd,1453813465,2016-01-26 14:04:25,1453813465,0
5698da7041a9d72100240971,85450,MRK3480 Forbrukeratferd,1453816313,2016-01-26 14:51:53,1453816329,16
5698da7041a9d72100240971,82946,MRK3480 Forbrukeratferd,1453905157,2016-01-27 15:32:37,1453905192,35
5698da7041a9d72100240971,67407,MRK3480 Forbrukeratferd,1453979114,2016-01-28 12:05:14,1453979956,842
5698da7041a9d72100240971,28526,MRK3480 Forbrukeratferd,1453981777,2016-01-28 12:49:37,1453981786,9
5698da7041a9d72100240972,36740,MRK3480 Forbrukeratferd,1452863107,2016-01-15 14:05:07,1452863159,52
5698da7041a9d72100240972,68955,MRK3480 Forbrukeratferd,1453154687,2016-01-18 23:04:47,1453154935,248
5698da7041a9d72100240972,75858,MRK3480 Forbrukeratferd,1453320795,2016-01-20 21:13:15,1453320958,163
5698da7041a9d72100240972,46199,MRK3480 Forbrukeratferd,1453326754,2016-01-20 22:52:34,1453326759,5
5698da7041a9d72100240972,90080,MRK3480 Forbrukeratferd,1453719697,2016-01-25 12:01:37,1453719713,16
5698da7041a9d72100240972,49627,MRK3480 Forbrukeratferd,1453725617,2016-01-25 13:40:17,1453725618,1
5698da7041a9d72100240972,29495,MRK3480 Forbrukeratferd,1453729484,2016-01-25 14:44:44,1453729485,1
5698da7041a9d72100240972,24257,MRK3480 Forbrukeratferd,1453742230,2016-01-25 18:17:10,1453742230,0
5698da7041a9d72100240972,15719,MRK3480 Forbrukeratferd,1453978358,2016-01-28 11:52:38,1453978502,144
5698da7041a9d72100240972,46597,MRK3480 Forbrukeratferd,1453992266,2016-01-28 15:44:26,1453992306,40
5698da7041a9d72100240972,99388,MRK3480 Forbrukeratferd,1454075921,2016-01-29 14:58:41,1454076033,112
5698da712fb0de2600f22b8d,38244,MRK3480 Forbrukeratferd,1453058043,2016-01-17 20:14:03,1453059343,1300
5698da712fb0de2600f22b8d,95875,MRK3480 Forbrukeratferd,1453374335,2016-01-21 12:05:35,1453374477,142
5698da712fb0de2600f22b8d,28569,MRK3480 Forbrukeratferd,1453376180,2016-01-21 12:36:20,1453376185,5
5698da712fb0de2600f22b8d,58225,MRK3480 Forbrukeratferd,1453750859,2016-01-25 20:40:59,1453751989,1130
5698da712fb0de2600f22b8e,67260,MRK3480 Forbrukeratferd,1453135357,2016-01-18 17:42:37,1453135389,32
5698da712fb0de2600f22b8e,5731,MRK3480 Forbrukeratferd,1453373941,2016-01-21 11:59:01,1453374137,196
5698da712fb0de2600f22b8e,13470,MRK3480 Forbrukeratferd,1453378031,2016-01-21 13:07:11,1453378405,374
5698da712fb0de2600f22b8e,41259,MRK3480 Forbrukeratferd,1453400949,2016-01-21 19:29:09,1453400950,1
5698da712fb0de2600f22b8e,48096,MRK3480 Forbrukeratferd,1453822301,2016-01-26 16:31:41,1453822335,34
5698da712fb0de2600f22b8f,50275,MRK3480 Forbrukeratferd,1453396044,2016-01-21 18:07:24,1453396205,161
5698da712fb0de2600f22b90,30133,MRK3480 Forbrukeratferd,1453326593,2016-01-20 22:49:53,1453328211,1618
5698da712fb0de2600f22b90,33395,MRK3480 Forbrukeratferd,1453373838,2016-01-21 11:57:18,1453374455,617
5698da712fb0de2600f22b90,34112,MRK3480 Forbrukeratferd,1453378413,2016-01-21 13:13:33,1453378469,56
5698da712fb0de2600f22b90,4299,MRK3480 Forbrukeratferd,1453400722,2016-01-21 19:25:22,1453400808,86
5698da712fb0de2600f22b90,51634,MRK3480 Forbrukeratferd,1453454697,2016-01-22 10:24:57,1453455142,445
5698da712fb0de2600f22b90,51196,MRK3480 Forbrukeratferd,1453459853,2016-01-22 11:50:53,1453460020,167
5698da712fb0de2600f22b90,30048,MRK3480 Forbrukeratferd,1453472675,2016-01-22 15:24:35,1453474115,1440
5698da712fb0de2600f22b90,73254,MRK3480 Forbrukeratferd,1453803374,2016-01-26 11:16:14,1453803532,158
5698da712fb0de2600f22b90,62172,MRK3480 Forbrukeratferd,1453805783,2016-01-26 11:56:23,1453805784,1
5698da712fb0de2600f22b90,54542,MRK3480 Forbrukeratferd,1453823630,2016-01-26 16:53:50,1453824279,649
5698da712fb0de2600f22b90,15760,MRK3480 Forbrukeratferd,1453842714,2016-01-26 22:11:54,1453842715,1
5698da712fb0de2600f22b90,61335,MRK3480 Forbrukeratferd,1453911268,2016-01-27 17:14:28,1453912000,732
5698da712fb0de2600f22b90,32969,MRK3480 Forbrukeratferd,1453913290,2016-01-27 17:48:10,1453913349,59
5698da712fb0de2600f22b90,46683,MRK3480 Forbrukeratferd,1454156870,2016-01-30 13:27:50,1454156929,59
5698da712fb0de2600f22b91,12280,MRK3480 Forbrukeratferd,1453162225,2016-01-19 01:10:25,1453162651,426
5698da712fb0de2600f22b91,59414,MRK3480 Forbrukeratferd,1453287415,2016-01-20 11:56:55,1453287470,55
5698da712fb0de2600f22b91,52050,MRK3480 Forbrukeratferd,1453312374,2016-01-20 18:52:54,1453313595,1221
5698da712fb0de2600f22b91,81312,MRK3480 Forbrukeratferd,1453727023,2016-01-25 14:03:43,1453727094,71
5698da712fb0de2600f22b91,64954,MRK3480 Forbrukeratferd,1453734672,2016-01-25 16:11:12,1453734686,14
5698da712fb0de2600f22b91,31030,MRK3480 Forbrukeratferd,1453805006,2016-01-26 11:43:26,1453805053,47
5698da712fb0de2600f22b91,79635,MRK3480 Forbrukeratferd,1453912317,2016-01-27 17:31:57,1453912319,2
5698da712fb0de2600f22b92,36449,MRK3480 Forbrukeratferd,1453050138,2016-01-17 18:02:18,1453050350,212
5698da712fb0de2600f22b92,83249,MRK3480 Forbrukeratferd,1453138606,2016-01-18 18:36:46,1453138620,14
5698da712fb0de2600f22b92,7053,MRK3480 Forbrukeratferd,1453388322,2016-01-21 15:58:42,1453388623,301
5698da712fb0de2600f22b92,72594,MRK3480 Forbrukeratferd,1453398745,2016-01-21 18:52:25,1453398803,58
5698da712fb0de2600f22b92,8267,MRK3480 Forbrukeratferd,1453733913,2016-01-25 15:58:33,1453733944,31
5698da712fb0de2600f22b92,57662,MRK3480 Forbrukeratferd,1453913283,2016-01-27 17:48:03,1453913330,47
5698da712fb0de2600f22b92,85724,MRK3480 Forbrukeratferd,1453993515,2016-01-28 16:05:15,1453994663,1148
5698da712fb0de2600f22b93,43957,MRK3480 Forbrukeratferd,1453925174,2016-01-27 21:06:14,1453925758,584
5698da712fb0de2600f22b93,29054,MRK3480 Forbrukeratferd,1453979839,2016-01-28 12:17:19,1453979883,44
5698da712fb0de2600f22b93,60867,MRK3480 Forbrukeratferd,1454163484,2016-01-30 15:18:04,1454163485,1
5698da7141a9d7210024097a,54766,MRK3480 Forbrukeratferd,1453048279,2016-01-17 17:31:19,1453048345,66
5698da7141a9d7210024097a,28454,MRK3480 Forbrukeratferd,1453152019,2016-01-18 22:20:19,1453152041,22
5698da7141a9d7210024097a,731,MRK3480 Forbrukeratferd,1453885102,2016-01-27 09:58:22,1453885216,114
5698da7141a9d7210024097c,21455,MRK3480 Forbrukeratferd,1453119724,2016-01-18 13:22:04,1453119838,114
5698da7141a9d7210024097c,67117,MRK3480 Forbrukeratferd,1453375660,2016-01-21 12:27:40,1453375803,143
5698da7141a9d7210024097c,89292,MRK3480 Forbrukeratferd,1453979116,2016-01-28 12:05:16,1453979173,57
5698da7141a9d7210024097f,70253,MRK3480 Forbrukeratferd,1453457609,2016-01-22 11:13:29,1453458281,672
5698da7141a9d7210024097f,3936,MRK3480 Forbrukeratferd,1453890847,2016-01-27 11:34:07,1453891220,373
5698da7141a9d7210024097f,79912,MRK3480 Forbrukeratferd,1453895962,2016-01-27 12:59:22,1453895978,16
5698da7141a9d7210024097f,10736,MRK3480 Forbrukeratferd,1453911015,2016-01-27 17:10:15,1453911060,45
5698da7141a9d7210024097f,94610,MRK3480 Forbrukeratferd,1453912613,2016-01-27 17:36:53,1453912621,8
5698da7141a9d72100240980,4642,MRK3480 Forbrukeratferd,1453374205,2016-01-21 12:03:25,1453374220,15
5698da7141a9d72100240980,37092,MRK3480 Forbrukeratferd,1453378585,2016-01-21 13:16:25,1453378586,1
5698da7141a9d72100240980,68325,MRK3480 Forbrukeratferd,1453980471,2016-01-28 12:27:51,1453980568,97
5698da7141a9d72100240980,24539,MRK3480 Forbrukeratferd,1453999154,2016-01-28 17:39:14,1453999263,109
5698da7241a9d72100240997,91423,MRK3480 Forbrukeratferd,1453040363,2016-01-17 15:19:23,1453040509,146
5698da7241a9d72100240997,98742,MRK3480 Forbrukeratferd,1453280401,2016-01-20 10:00:01,1453280434,33
5698da7241a9d72100240997,92044,MRK3480 Forbrukeratferd,1453284780,2016-01-20 11:13:00,1453284866,86
5698da7241a9d72100240997,28120,MRK3480 Forbrukeratferd,1453374399,2016-01-21 12:06:39,1453374504,105
5698da7241a9d72100240997,86672,MRK3480 Forbrukeratferd,1453471437,2016-01-22 15:03:57,1453471465,28
5698da7241a9d72100240997,79653,MRK3480 Forbrukeratferd,1453721602,2016-01-25 12:33:22,1453721683,81
5698da7241a9d72100240997,41938,MRK3480 Forbrukeratferd,1453741191,2016-01-25 17:59:51,1453741194,3
5698da732fb0de2600f22bb2,49295,MRK3480 Forbrukeratferd,1453045303,2016-01-17 16:41:43,1453045357,54
5698da732fb0de2600f22bb2,35222,MRK3480 Forbrukeratferd,1453218535,2016-01-19 16:48:55,1453218560,25
5698da732fb0de2600f22bb2,48902,MRK3480 Forbrukeratferd,1453978703,2016-01-28 11:58:23,1453979522,819
5698da732fb0de2600f22bb2,67769,MRK3480 Forbrukeratferd,1454069739,2016-01-29 13:15:39,1454069773,34
5698da732fb0de2600f22bb3,94274,MRK3480 Forbrukeratferd,1453748046,2016-01-25 19:54:06,1453748153,107
5698da732fb0de2600f22bb3,57904,MRK3480 Forbrukeratferd,1453996751,2016-01-28 16:59:11,1453997592,841
5698da732fb0de2600f22bb3,52839,MRK3480 Forbrukeratferd,1454000321,2016-01-28 17:58:41,1454000323,2
5698da732fb0de2600f22bb4,36414,MRK3480 Forbrukeratferd,1452881848,2016-01-15 19:17:28,1452881950,102
5698da732fb0de2600f22bb4,30183,MRK3480 Forbrukeratferd,1453737685,2016-01-25 17:01:25,1453737687,2
5698da732fb0de2600f22bb4,84537,MRK3480 Forbrukeratferd,1454086203,2016-01-29 17:50:03,1454086267,64
5698da732fb0de2600f22bb4,55788,MRK3480 Forbrukeratferd,1454249266,2016-01-31 15:07:46,1454251308,2042
5698da732fb0de2600f22bb5,61646,MRK3480 Forbrukeratferd,1453377786,2016-01-21 13:03:06,1453378291,505
5698da732fb0de2600f22bb5,12355,MRK3480 Forbrukeratferd,1453757052,2016-01-25 22:24:12,1453757084,32
5698da732fb0de2600f22bba,78053,MRK3480 Forbrukeratferd,1453335823,2016-01-21 01:23:43,1453335894,71
5698da732fb0de2600f22bba,99820,MRK3480 Forbrukeratferd,1453375605,2016-01-21 12:26:45,1453375635,30
5698da732fb0de2600f22bba,75944,MRK3480 Forbrukeratferd,1453377861,2016-01-21 13:04:21,1453378420,559
5698da732fb0de2600f22bba,68553,MRK3480 Forbrukeratferd,1453991148,2016-01-28 15:25:48,1453991153,5
5698da7341a9d72100240999,89745,MRK3480 Forbrukeratferd,1453032836,2016-01-17 13:13:56,1453032836,0
5698da7341a9d72100240999,58656,MRK3480 Forbrukeratferd,1453079839,2016-01-18 02:17:19,1453079897,58
5698da7341a9d72100240999,27099,MRK3480 Forbrukeratferd,1453128474,2016-01-18 15:47:54,1453128475,1
5698da7341a9d72100240999,46806,MRK3480 Forbrukeratferd,1453374751,2016-01-21 12:12:31,1453374763,12
5698da7341a9d72100240999,46012,MRK3480 Forbrukeratferd,1453377562,2016-01-21 12:59:22,1453377562,0
5698da7341a9d72100240999,82701,MRK3480 Forbrukeratferd,1453675767,2016-01-24 23:49:27,1453675785,18
5698da7341a9d72100240999,64980,MRK3480 Forbrukeratferd,1453722639,2016-01-25 12:50:39,1453723835,1196
5698da7341a9d72100240999,50943,MRK3480 Forbrukeratferd,1453809221,2016-01-26 12:53:41,1453809221,0
5698da7341a9d72100240999,13876,MRK3480 Forbrukeratferd,1453911074,2016-01-27 17:11:14,1453911075,1
5698da7341a9d72100240999,32184,MRK3480 Forbrukeratferd,1453923231,2016-01-27 20:33:51,1453923253,22
5698da7341a9d72100240999,54773,MRK3480 Forbrukeratferd,1454001666,2016-01-28 18:21:06,1454001667,1
5698da742fb0de2600f22bbc,66646,MRK3480 Forbrukeratferd,1453309064,2016-01-20 17:57:44,1453309170,106
5698da742fb0de2600f22bbe,71141,MRK3480 Forbrukeratferd,1452867468,2016-01-15 15:17:48,1452867505,37
5698da742fb0de2600f22bbe,63974,MRK3480 Forbrukeratferd,1452999346,2016-01-17 03:55:46,1452999346,0
5698da742fb0de2600f22bbe,27283,MRK3480 Forbrukeratferd,1453675930,2016-01-24 23:52:10,1453675997,67
5698da742fb0de2600f22bbe,31818,MRK3480 Forbrukeratferd,1453745296,2016-01-25 19:08:16,1453746444,1148
5698da742fb0de2600f22bbe,32555,MRK3480 Forbrukeratferd,1453850343,2016-01-27 00:19:03,1453850382,39
5698da742fb0de2600f22bbe,50174,MRK3480 Forbrukeratferd,1453979463,2016-01-28 12:11:03,1453979465,2
5698da742fb0de2600f22bc1,43408,MRK3480 Forbrukeratferd,1453127199,2016-01-18 15:26:39,1453127225,26
5698da742fb0de2600f22bc1,96090,MRK3480 Forbrukeratferd,1453306104,2016-01-20 17:08:24,1453306573,469
5698da742fb0de2600f22bc1,36856,MRK3480 Forbrukeratferd,1453309833,2016-01-20 18:10:33,1453309860,27
5698da742fb0de2600f22bc1,76895,MRK3480 Forbrukeratferd,1453459899,2016-01-22 11:51:39,1453459899,0
5698da742fb0de2600f22bc1,9289,MRK3480 Forbrukeratferd,1453723732,2016-01-25 13:08:52,1453723765,33
5698da742fb0de2600f22bc1,91100,MRK3480 Forbrukeratferd,1453762863,2016-01-26 00:01:03,1453762888,25
5698da742fb0de2600f22bc1,11474,MRK3480 Forbrukeratferd,1453937419,2016-01-28 00:30:19,1453937492,73
5698da742fb0de2600f22bc2,34250,MRK3480 Forbrukeratferd,1453308987,2016-01-20 17:56:27,1453309054,67
5698da742fb0de2600f22bc2,75414,MRK3480 Forbrukeratferd,1453916256,2016-01-27 18:37:36,1453916377,121
5698da742fb0de2600f22bc2,64188,MRK3480 Forbrukeratferd,1453953229,2016-01-28 04:53:49,1453953262,33
5698da7541a9d7210024099f,85165,MRK3480 Forbrukeratferd,1452861623,2016-01-15 13:40:23,1452861683,60
5698da7541a9d7210024099f,18258,MRK3480 Forbrukeratferd,1453204460,2016-01-19 12:54:20,1453204504,44
5698da7541a9d721002409a0,42870,MRK3480 Forbrukeratferd,1453385403,2016-01-21 15:10:03,1453385496,93
5698da7541a9d721002409a0,51266,MRK3480 Forbrukeratferd,1453905811,2016-01-27 15:43:31,1453906626,815
5698da7541a9d721002409a0,31042,MRK3480 Forbrukeratferd,1453911720,2016-01-27 17:22:00,1453911741,21
5698da7541a9d721002409a0,78915,MRK3480 Forbrukeratferd,1453979018,2016-01-28 12:03:38,1453980303,1285
5698da7541a9d721002409a0,62158,MRK3480 Forbrukeratferd,1453982653,2016-01-28 13:04:13,1453983788,1135
5698da7541a9d721002409a1,3158,MRK3480 Forbrukeratferd,1453377466,2016-01-21 12:57:46,1453379175,1709
5698da7541a9d721002409a1,1098,MRK3480 Forbrukeratferd,1453386373,2016-01-21 15:26:13,1453386459,86
5698da7541a9d721002409a1,74986,MRK3480 Forbrukeratferd,1453467223,2016-01-22 13:53:43,1453467223,0
5698da7541a9d721002409a1,51431,MRK3480 Forbrukeratferd,1453810905,2016-01-26 13:21:45,1453810955,50
5698da7541a9d721002409a2,55829,MRK3480 Forbrukeratferd,1453201814,2016-01-19 12:10:14,1453201814,0
5698da7541a9d721002409a2,45492,MRK3480 Forbrukeratferd,1453723815,2016-01-25 13:10:15,1453723845,30
5698da7541a9d721002409a2,70958,MRK3480 Forbrukeratferd,1453903722,2016-01-27 15:08:42,1453903766,44
5698da7541a9d721002409a2,95473,MRK3480 Forbrukeratferd,1453906105,2016-01-27 15:48:25,1453906115,10
5698da7541a9d721002409a2,44494,MRK3480 Forbrukeratferd,1453909065,2016-01-27 16:37:45,1453909107,42
5698da7541a9d721002409a2,73750,MRK3480 Forbrukeratferd,1453978927,2016-01-28 12:02:07,1453978927,0
5698da7541a9d721002409a3,29064,MRK3480 Forbrukeratferd,1452863570,2016-01-15 14:12:50,1452863665,95
5698da7541a9d721002409a3,59073,MRK3480 Forbrukeratferd,1452873501,2016-01-15 16:58:21,1452873501,0
5698da7541a9d721002409a3,88655,MRK3480 Forbrukeratferd,1453119927,2016-01-18 13:25:27,1453119927,0
5698da7541a9d721002409a3,8232,MRK3480 Forbrukeratferd,1453548475,2016-01-23 12:27:55,1453548536,61
5698da762fb0de2600f22bda,27652,MRK3480 Forbrukeratferd,1453368425,2016-01-21 10:27:05,1453368984,559
5698da762fb0de2600f22bda,98706,MRK3480 Forbrukeratferd,1453373997,2016-01-21 11:59:57,1453374053,56
5698da762fb0de2600f22bda,31591,MRK3480 Forbrukeratferd,1453978688,2016-01-28 11:58:08,1453978802,114
5698da762fb0de2600f22bda,6337,MRK3480 Forbrukeratferd,1453983951,2016-01-28 13:25:51,1453983951,0
5698da762fb0de2600f22bda,752,MRK3480 Forbrukeratferd,1453992644,2016-01-28 15:50:44,1453992907,263
5698da772fb0de2600f22bde,44781,MRK3480 Forbrukeratferd,1453197439,2016-01-19 10:57:19,1453197440,1
5698da772fb0de2600f22bde,22888,MRK3480 Forbrukeratferd,1453291030,2016-01-20 12:57:10,1453291107,77
5698da772fb0de2600f22bde,37502,MRK3480 Forbrukeratferd,1453292377,2016-01-20 13:19:37,1453292394,17
5698da772fb0de2600f22bde,15195,MRK3480 Forbrukeratferd,1453887060,2016-01-27 10:31:00,1453888312,1252
5698da772fb0de2600f22bdf,26628,MRK3480 Forbrukeratferd,1453306551,2016-01-20 17:15:51,1453306910,359
5698da772fb0de2600f22bdf,77249,MRK3480 Forbrukeratferd,1453986020,2016-01-28 14:00:20,1453986163,143
5698da772fb0de2600f22bdf,96403,MRK3480 Forbrukeratferd,1453988352,2016-01-28 14:39:12,1453990113,1761
5698da772fb0de2600f22bdf,18353,MRK3480 Forbrukeratferd,1453991477,2016-01-28 15:31:17,1453991482,5
5698da772fb0de2600f22bdf,35466,MRK3480 Forbrukeratferd,1453993017,2016-01-28 15:56:57,1453993578,561
5698da772fb0de2600f22be0,77957,MRK3480 Forbrukeratferd,1453147873,2016-01-18 21:11:13,1453147873,0
5698da772fb0de2600f22be0,36111,MRK3480 Forbrukeratferd,1453250385,2016-01-20 01:39:45,1453250385,0
5698da772fb0de2600f22be0,92148,MRK3480 Forbrukeratferd,1453667686,2016-01-24 21:34:46,1453672296,4610
5698da772fb0de2600f22be0,38152,MRK3480 Forbrukeratferd,1453908642,2016-01-27 16:30:42,1453908801,159
5698da772fb0de2600f22be4,66846,MRK3480 Forbrukeratferd,1452879339,2016-01-15 18:35:39,1452879443,104
5698da772fb0de2600f22be4,83053,MRK3480 Forbrukeratferd,1452953621,2016-01-16 15:13:41,1452953768,147
5698da772fb0de2600f22be4,35339,MRK3480 Forbrukeratferd,1453144475,2016-01-18 20:14:35,1453144547,72
5698da772fb0de2600f22be4,41061,MRK3480 Forbrukeratferd,1453287926,2016-01-20 12:05:26,1453288054,128
5698da772fb0de2600f22be4,16027,MRK3480 Forbrukeratferd,1453294986,2016-01-20 14:03:06,1453294992,6
5698da772fb0de2600f22be4,66413,MRK3480 Forbrukeratferd,1453306430,2016-01-20 17:13:50,1453306454,24
5698da772fb0de2600f22be4,41035,MRK3480 Forbrukeratferd,1453372581,2016-01-21 11:36:21,1453372892,311
5698da772fb0de2600f22be4,52380,MRK3480 Forbrukeratferd,1453390085,2016-01-21 16:28:05,1453390085,0
5698da772fb0de2600f22be4,51715,MRK3480 Forbrukeratferd,1453507151,2016-01-23 00:59:11,1453507182,31
5698da772fb0de2600f22be4,48040,MRK3480 Forbrukeratferd,1453665247,2016-01-24 20:54:07,1453665310,63
5698da772fb0de2600f22be4,52168,MRK3480 Forbrukeratferd,1453702025,2016-01-25 07:07:05,1453702048,23
5698da772fb0de2600f22be4,76268,MRK3480 Forbrukeratferd,1453727802,2016-01-25 14:16:42,1453727822,20
5698da772fb0de2600f22be4,29630,MRK3480 Forbrukeratferd,1453807073,2016-01-26 12:17:53,1453807076,3
5698da772fb0de2600f22be4,55773,MRK3480 Forbrukeratferd,1453836672,2016-01-26 20:31:12,1453836672,0
5698da772fb0de2600f22be4,7573,MRK3480 Forbrukeratferd,1453922679,2016-01-27 20:24:39,1453922680,1
5698da7741a9d721002409c2,29938,MRK3480 Forbrukeratferd,1453377008,2016-01-21 12:50:08,1453377008,0
5698da7741a9d721002409c2,42556,MRK3480 Forbrukeratferd,1453382868,2016-01-21 14:27:48,1453382872,4
5698da7741a9d721002409c2,91015,MRK3480 Forbrukeratferd,1453392604,2016-01-21 17:10:04,1453392663,59
5698da7741a9d721002409c2,36397,MRK3480 Forbrukeratferd,1453836104,2016-01-26 20:21:44,1453836142,38
5698da7741a9d721002409c2,39129,MRK3480 Forbrukeratferd,1453912003,2016-01-27 17:26:43,1453912074,71
5698da7741a9d721002409c3,3120,MRK3480 Forbrukeratferd,1453128304,2016-01-18 15:45:04,1453129292,988
5698da7741a9d721002409c3,91503,MRK3480 Forbrukeratferd,1453145815,2016-01-18 20:36:55,1453145815,0
5698da7741a9d721002409c3,51756,MRK3480 Forbrukeratferd,1453371453,2016-01-21 11:17:33,1453372871,1418
5698da7741a9d721002409c3,89615,MRK3480 Forbrukeratferd,1453375628,2016-01-21 12:27:08,1453375815,187
5698da7741a9d721002409c3,88706,MRK3480 Forbrukeratferd,1453377807,2016-01-21 13:03:27,1453378550,743
5698da7741a9d721002409c3,97761,MRK3480 Forbrukeratferd,1453403358,2016-01-21 20:09:18,1453403372,14
5698da7741a9d721002409c3,86876,MRK3480 Forbrukeratferd,1453723866,2016-01-25 13:11:06,1453723868,2
5698da7741a9d721002409c3,3449,MRK3480 Forbrukeratferd,1453813240,2016-01-26 14:00:40,1453813241,1
5698da7741a9d721002409c3,47350,MRK3480 Forbrukeratferd,1453890300,2016-01-27 11:25:00,1453890309,9
5698da7741a9d721002409c3,34708,MRK3480 Forbrukeratferd,1453893069,2016-01-27 12:11:09,1453893081,12
5698da7741a9d721002409c3,33412,MRK3480 Forbrukeratferd,1453896884,2016-01-27 13:14:44,1453896901,17
5698da7741a9d721002409c3,69504,MRK3480 Forbrukeratferd,1453899919,2016-01-27 14:05:19,1453899941,22
5698da7741a9d721002409c4,71532,MRK3480 Forbrukeratferd,1453046264,2016-01-17 16:57:44,1453046627,363
5698da7741a9d721002409c4,31613,MRK3480 Forbrukeratferd,1453049044,2016-01-17 17:44:04,1453049152,108
5698da7741a9d721002409c4,96487,MRK3480 Forbrukeratferd,1453053378,2016-01-17 18:56:18,1453053387,9
5698da7741a9d721002409c4,75924,MRK3480 Forbrukeratferd,1454067228,2016-01-29 12:33:48,1454067447,219
5698da7741a9d721002409c5,63233,MRK3480 Forbrukeratferd,1453903912,2016-01-27 15:11:52,1453903913,1
5698da7741a9d721002409c6,88422,MRK3480 Forbrukeratferd,1453370184,2016-01-21 10:56:24,1453370275,91
5698da7741a9d721002409c6,93315,MRK3480 Forbrukeratferd,1453386967,2016-01-21 15:36:07,1453387082,115
5698da782fb0de2600f22bef,88061,MRK3480 Forbrukeratferd,1453149318,2016-01-18 21:35:18,1453149325,7
5698da782fb0de2600f22bef,9482,MRK3480 Forbrukeratferd,1453502112,2016-01-22 23:35:12,1453502129,17
5698da782fb0de2600f22bef,53250,MRK3480 Forbrukeratferd,1453894869,2016-01-27 12:41:09,1453894965,96
5698da782fb0de2600f22bef,82456,MRK3480 Forbrukeratferd,1453920433,2016-01-27 19:47:13,1453920455,22
5698da782fb0de2600f22bef,70034,MRK3480 Forbrukeratferd,1454000658,2016-01-28 18:04:18,1454000682,24
5698da782fb0de2600f22bef,41600,MRK3480 Forbrukeratferd,1454268727,2016-01-31 20:32:07,1454268727,0
5698da782fb0de2600f22bf5,74215,MRK3480 Forbrukeratferd,1453378455,2016-01-21 13:14:15,1453380063,1608
5698da782fb0de2600f22bf5,40648,MRK3480 Forbrukeratferd,1453381498,2016-01-21 14:04:58,1453382297,799
5698da782fb0de2600f22bf5,1672,MRK3480 Forbrukeratferd,1453760976,2016-01-25 23:29:36,1453760976,0
5698da782fb0de2600f22bf5,94332,MRK3480 Forbrukeratferd,1453979185,2016-01-28 12:06:25,1453979364,179
5698da782fb0de2600f22bf5,90052,MRK3480 Forbrukeratferd,1453983129,2016-01-28 13:12:09,1453983132,3
5698da782fb0de2600f22bf5,56780,MRK3480 Forbrukeratferd,1453988288,2016-01-28 14:38:08,1453988292,4
5698da7841a9d721002409d0,23283,MRK3480 Forbrukeratferd,1453309600,2016-01-20 18:06:40,1453309715,115
5698da7841a9d721002409d0,89123,MRK3480 Forbrukeratferd,1454248961,2016-01-31 15:02:41,1454250177,1216
5698da7841a9d721002409d0,703,MRK3480 Forbrukeratferd,1454264921,2016-01-31 19:28:41,1454265377,456
5698da7841a9d721002409d2,71946,MRK3480 Forbrukeratferd,1453138841,2016-01-18 18:40:41,1453138930,89
5698da7841a9d721002409d2,6921,MRK3480 Forbrukeratferd,1453203880,2016-01-19 12:44:40,1453205868,1988
5698da7841a9d721002409d2,26905,MRK3480 Forbrukeratferd,1453805608,2016-01-26 11:53:28,1453805670,62
5698da7841a9d721002409d2,66197,MRK3480 Forbrukeratferd,1453906886,2016-01-27 16:01:26,1453907015,129
5698da7841a9d721002409d2,70134,MRK3480 Forbrukeratferd,1453908451,2016-01-27 16:27:31,1453908575,124
5698da7841a9d721002409d2,46168,MRK3480 Forbrukeratferd,1453911346,2016-01-27 17:15:46,1453911349,3
5698da7841a9d721002409d2,23819,MRK3480 Forbrukeratferd,1453912672,2016-01-27 17:37:52,1453912672,0
5698da792fb0de2600f22c02,22271,MRK3480 Forbrukeratferd,1453109718,2016-01-18 10:35:18,1453109718,0
5698da792fb0de2600f22c02,83741,MRK3480 Forbrukeratferd,1453316092,2016-01-20 19:54:52,1453316145,53
5698da792fb0de2600f22c02,78586,MRK3480 Forbrukeratferd,1453722515,2016-01-25 12:48:35,1453722649,134
5698da792fb0de2600f22c02,12960,MRK3480 Forbrukeratferd,1454000368,2016-01-28 17:59:28,1454000432,64
5698da792fb0de2600f22c02,94730,MRK3480 Forbrukeratferd,1454002888,2016-01-28 18:41:28,1454002891,3
5698da792fb0de2600f22c02,49356,MRK3480 Forbrukeratferd,1454004648,2016-01-28 19:10:48,1454004651,3
5698da7a2fb0de2600f22c06,70976,MRK3480 Forbrukeratferd,1453285921,2016-01-20 11:32:01,1453286037,116
5698da7a2fb0de2600f22c06,95786,MRK3480 Forbrukeratferd,1453376622,2016-01-21 12:43:42,1453376626,4
5698da7a2fb0de2600f22c06,77797,MRK3480 Forbrukeratferd,1453378115,2016-01-21 13:08:35,1453378504,389
5698da7a2fb0de2600f22c06,71185,MRK3480 Forbrukeratferd,1453980652,2016-01-28 12:30:52,1453980665,13
5698da7a2fb0de2600f22c06,52953,MRK3480 Forbrukeratferd,1453982936,2016-01-28 13:08:56,1453984649,1713
5698da7a2fb0de2600f22c06,50091,MRK3480 Forbrukeratferd,1454064028,2016-01-29 11:40:28,1454064159,131
5698da7a2fb0de2600f22c06,90381,MRK3480 Forbrukeratferd,1454065547,2016-01-29 12:05:47,1454066455,908
5698da7a2fb0de2600f22c07,80063,MRK3480 Forbrukeratferd,1453727130,2016-01-25 14:05:30,1453727153,23
5698da7a2fb0de2600f22c07,19459,MRK3480 Forbrukeratferd,1454317599,2016-02-01 10:06:39,1454317738,139
5698da7a2fb0de2600f22c08,7822,MRK3480 Forbrukeratferd,1453190390,2016-01-19 08:59:50,1453190427,37
5698da7a2fb0de2600f22c08,25958,MRK3480 Forbrukeratferd,1453301284,2016-01-20 15:48:04,1453303356,2072
5698da7a2fb0de2600f22c09,58833,MRK3480 Forbrukeratferd,1453228252,2016-01-19 19:30:52,1453228931,679
5698da7a2fb0de2600f22c09,47889,MRK3480 Forbrukeratferd,1453233185,2016-01-19 20:53:05,1453233263,78
5698da7a2fb0de2600f22c09,25642,MRK3480 Forbrukeratferd,1453473806,2016-01-22 15:43:26,1453474104,298
5698da7a2fb0de2600f22c09,55561,MRK3480 Forbrukeratferd,1453480446,2016-01-22 17:34:06,1453480447,1
5698da7a2fb0de2600f22c09,96585,MRK3480 Forbrukeratferd,1453818509,2016-01-26 15:28:29,1453818599,90
5698da7a2fb0de2600f22c09,2949,MRK3480 Forbrukeratferd,1454024468,2016-01-29 00:41:08,1454024499,31
5698da7a2fb0de2600f22c09,23486,MRK3480 Forbrukeratferd,1454027103,2016-01-29 01:25:03,1454027103,0
5698da7a2fb0de2600f22c0a,71071,MRK3480 Forbrukeratferd,1453896542,2016-01-27 13:09:02,1453896542,0
5698da7a2fb0de2600f22c0a,67910,MRK3480 Forbrukeratferd,1454251528,2016-01-31 15:45:28,1454251538,10
5698da7a41a9d721002409e7,91031,MRK3480 Forbrukeratferd,1453148490,2016-01-18 21:21:30,1453148545,55
5698da7a41a9d721002409e7,79986,MRK3480 Forbrukeratferd,1453379338,2016-01-21 13:28:58,1453379838,500
5698da7a41a9d721002409e7,41391,MRK3480 Forbrukeratferd,1453382527,2016-01-21 14:22:07,1453382535,8
5698da7a41a9d721002409e7,83640,MRK3480 Forbrukeratferd,1453389836,2016-01-21 16:23:56,1453389836,0
5698da7a41a9d721002409e7,93661,MRK3480 Forbrukeratferd,1453393500,2016-01-21 17:25:00,1453395381,1881
5698da7a41a9d721002409e7,20,MRK3480 Forbrukeratferd,1453396915,2016-01-21 18:21:55,1453398169,1254
5698da7a41a9d721002409e7,90252,MRK3480 Forbrukeratferd,1453399691,2016-01-21 19:08:11,1453399693,2
5698da7a41a9d721002409e7,40437,MRK3480 Forbrukeratferd,1453494949,2016-01-22 21:35:49,1453494953,4
5698da7a41a9d721002409e7,94522,MRK3480 Forbrukeratferd,1453979055,2016-01-28 12:04:15,1453979718,663
5698da7a41a9d721002409ea,71682,MRK3480 Forbrukeratferd,1453122556,2016-01-18 14:09:16,1453122590,34
5698da7a41a9d721002409ea,54640,MRK3480 Forbrukeratferd,1453554565,2016-01-23 14:09:25,1453554566,1
5698da7a41a9d721002409ea,57183,MRK3480 Forbrukeratferd,1453653411,2016-01-24 17:36:51,1453653412,1
5698da7a41a9d721002409ea,20438,MRK3480 Forbrukeratferd,1453887086,2016-01-27 10:31:26,1453887134,48
5698da7a41a9d721002409ea,58023,MRK3480 Forbrukeratferd,1453975086,2016-01-28 10:58:06,1453975189,103
5698da7a41a9d721002409ea,39714,MRK3480 Forbrukeratferd,1453979921,2016-01-28 12:18:41,1453979939,18
5698da7a41a9d721002409ea,96879,MRK3480 Forbrukeratferd,1453983991,2016-01-28 13:26:31,1453983993,2
5698da7a41a9d721002409ea,95646,MRK3480 Forbrukeratferd,1454022657,2016-01-29 00:10:57,1454022661,4
5698da7a41a9d721002409ea,26381,MRK3480 Forbrukeratferd,1454249715,2016-01-31 15:15:15,1454249767,52
5698da7a41a9d721002409ed,18328,MRK3480 Forbrukeratferd,1452863359,2016-01-15 14:09:19,1452863633,274
5698da7a41a9d721002409ed,88316,MRK3480 Forbrukeratferd,1452878427,2016-01-15 18:20:27,1452878850,423
5698da7a41a9d721002409ed,6913,MRK3480 Forbrukeratferd,1453125499,2016-01-18 14:58:19,1453125596,97
5698da7a41a9d721002409ed,55697,MRK3480 Forbrukeratferd,1453230002,2016-01-19 20:00:02,1453230243,241
5698da7a41a9d721002409ed,45847,MRK3480 Forbrukeratferd,1453282257,2016-01-20 10:30:57,1453282258,1
5698da7a41a9d721002409ed,23734,MRK3480 Forbrukeratferd,1453321040,2016-01-20 21:17:20,1453321935,895
5698da7a41a9d721002409ed,73640,MRK3480 Forbrukeratferd,1453325567,2016-01-20 22:32:47,1453325645,78
5698da7a41a9d721002409ed,16053,MRK3480 Forbrukeratferd,1453373784,2016-01-21 11:56:24,1453373785,1
5698da7a41a9d721002409ed,66853,MRK3480 Forbrukeratferd,1453376149,2016-01-21 12:35:49,1453377324,1175
5698da7a41a9d721002409ed,60414,MRK3480 Forbrukeratferd,1453413320,2016-01-21 22:55:20,1453413320,0
5698da7a41a9d721002409ed,67855,MRK3480 Forbrukeratferd,1453589238,2016-01-23 23:47:18,1453589377,139
5698da7a41a9d721002409ed,82984,MRK3480 Forbrukeratferd,1453730335,2016-01-25 14:58:55,1453730343,8
5698da7a41a9d721002409ed,66284,MRK3480 Forbrukeratferd,1453805842,2016-01-26 11:57:22,1453805883,41
5698da7a41a9d721002409ed,81053,MRK3480 Forbrukeratferd,1453941277,2016-01-28 01:34:37,1453941279,2
5698da7a41a9d721002409ed,17906,MRK3480 Forbrukeratferd,1453977876,2016-01-28 11:44:36,1453977998,122
5698da7a41a9d721002409ed,53677,MRK3480 Forbrukeratferd,1454278232,2016-01-31 23:10:32,1454278232,0
5698da7b2fb0de2600f22c15,1063,MRK3480 Forbrukeratferd,1453137667,2016-01-18 18:21:07,1453137683,16
5698da7b2fb0de2600f22c15,63029,MRK3480 Forbrukeratferd,1453980080,2016-01-28 12:21:20,1453980260,180
5698da7b2fb0de2600f22c15,88845,MRK3480 Forbrukeratferd,1453983311,2016-01-28 13:15:11,1453983331,20
5698da7b41a9d721002409f3,63960,MRK3480 Forbrukeratferd,1453386679,2016-01-21 15:31:19,1453387000,321
5698da7b41a9d721002409f3,69784,MRK3480 Forbrukeratferd,1453905287,2016-01-27 15:34:47,1453905360,73
5698da7b41a9d721002409f6,50019,MRK3480 Forbrukeratferd,1452861789,2016-01-15 13:43:09,1452861819,30
5698da7b41a9d721002409f6,70041,MRK3480 Forbrukeratferd,1453293597,2016-01-20 13:39:57,1453295904,2307
5698da7b41a9d721002409f6,89625,MRK3480 Forbrukeratferd,1453299263,2016-01-20 15:14:23,1453299265,2
5698da7b41a9d721002409f6,60373,MRK3480 Forbrukeratferd,1453303102,2016-01-20 16:18:22,1453303108,6
5698da7b41a9d721002409f6,82385,MRK3480 Forbrukeratferd,1453323554,2016-01-20 21:59:14,1453323555,1
5698da7b41a9d721002409f6,90351,MRK3480 Forbrukeratferd,1453374552,2016-01-21 12:09:12,1453375886,1334
5698da7b41a9d721002409f6,64924,MRK3480 Forbrukeratferd,1453380217,2016-01-21 13:43:37,1453380240,23
5698da7b41a9d721002409f6,96357,MRK3480 Forbrukeratferd,1453392322,2016-01-21 17:05:22,1453392322,0
5698da7b41a9d721002409f6,74695,MRK3480 Forbrukeratferd,1453463701,2016-01-22 12:55:01,1453463704,3
5698da7b41a9d721002409f6,30785,MRK3480 Forbrukeratferd,1453573164,2016-01-23 19:19:24,1453573165,1
5698da7b41a9d721002409f6,6607,MRK3480 Forbrukeratferd,1453713522,2016-01-25 10:18:42,1453713563,41
5698da7b41a9d721002409f6,55081,MRK3480 Forbrukeratferd,1453728697,2016-01-25 14:31:37,1453728730,33
5698da7b41a9d721002409f6,46939,MRK3480 Forbrukeratferd,1453912726,2016-01-27 17:38:46,1453912785,59
5698db5f2fb0de2600f22d4e,60627,ORG3402 Organisasjonsatferd og ledelse,1452863243,2016-01-15 14:07:23,1452863483,240
5698db5f2fb0de2600f22d4e,11954,ORG3402 Organisasjonsatferd og ledelse,1453050375,2016-01-17 18:06:15,1453050894,519
5698db5f2fb0de2600f22d4e,98195,ORG3402 Organisasjonsatferd og ledelse,1453060107,2016-01-17 20:48:27,1453060107,0
5698db5f2fb0de2600f22d4e,53341,ORG3402 Organisasjonsatferd og ledelse,1453075939,2016-01-18 01:12:19,1453076060,121
5698db5f2fb0de2600f22d4e,78661,ORG3402 Organisasjonsatferd og ledelse,1453676690,2016-01-25 00:04:50,1453676691,1
5698db5f2fb0de2600f22d4e,18468,ORG3402 Organisasjonsatferd og ledelse,1454062151,2016-01-29 11:09:11,1454062227,76
5698db5f2fb0de2600f22d4e,15665,ORG3402 Organisasjonsatferd og ledelse,1454070332,2016-01-29 13:25:32,1454070347,15
5698db6041a9d72100240bf1,2206,ORG3402 Organisasjonsatferd og ledelse,1453128391,2016-01-18 15:46:31,1453128391,0
5698db6041a9d72100240bf1,66185,ORG3402 Organisasjonsatferd og ledelse,1453129623,2016-01-18 16:07:03,1453130428,805
5698db6041a9d72100240bf3,87002,ORG3402 Organisasjonsatferd og ledelse,1453725454,2016-01-25 13:37:34,1453725536,82
5698db6041a9d72100240bf3,57278,ORG3402 Organisasjonsatferd og ledelse,1453747252,2016-01-25 19:40:52,1453747252,0
5698db6041a9d72100240bf3,84958,ORG3402 Organisasjonsatferd og ledelse,1453914801,2016-01-27 18:13:21,1453914909,108
5698db6041a9d72100240bf6,90468,ORG3402 Organisasjonsatferd og ledelse,1453720077,2016-01-25 12:07:57,1453720213,136
5698db6041a9d72100240bf6,20173,ORG3402 Organisasjonsatferd og ledelse,1453843078,2016-01-26 22:17:58,1453843352,274
5698db612fb0de2600f22d52,42571,ORG3402 Organisasjonsatferd og ledelse,1453719722,2016-01-25 12:02:02,1453720133,411
5698db612fb0de2600f22d53,44124,ORG3402 Organisasjonsatferd og ledelse,1453953430,2016-01-28 04:57:10,1453953534,104
5698db612fb0de2600f22d54,65746,ORG3402 Organisasjonsatferd og ledelse,1453195847,2016-01-19 10:30:47,1453196533,686
5698db612fb0de2600f22d54,62329,ORG3402 Organisasjonsatferd og ledelse,1453220367,2016-01-19 17:19:27,1453220375,8
5698db612fb0de2600f22d54,42485,ORG3402 Organisasjonsatferd og ledelse,1453574946,2016-01-23 19:49:06,1453575011,65
5698db612fb0de2600f22d59,34907,ORG3402 Organisasjonsatferd og ledelse,1453237371,2016-01-19 22:02:51,1453237458,87
5698db612fb0de2600f22d5a,55462,ORG3402 Organisasjonsatferd og ledelse,1453719881,2016-01-25 12:04:41,1453720366,485
5698db6141a9d72100240bf7,45101,ORG3402 Organisasjonsatferd og ledelse,1453120457,2016-01-18 13:34:17,1453120777,320
5698db6141a9d72100240bf7,19156,ORG3402 Organisasjonsatferd og ledelse,1453808150,2016-01-26 12:35:50,1453808182,32
5698db632fb0de2600f22d78,66387,ORG3402 Organisasjonsatferd og ledelse,1453144409,2016-01-18 20:13:29,1453144451,42
5698db632fb0de2600f22d78,32053,ORG3402 Organisasjonsatferd og ledelse,1453498464,2016-01-22 22:34:24,1453498465,1
5698db632fb0de2600f22d79,57258,ORG3402 Organisasjonsatferd og ledelse,1452863084,2016-01-15 14:04:44,1452863163,79
5698db632fb0de2600f22d79,49510,ORG3402 Organisasjonsatferd og ledelse,1453050804,2016-01-17 18:13:24,1453050844,40
5698db632fb0de2600f22d79,50997,ORG3402 Organisasjonsatferd og ledelse,1453128323,2016-01-18 15:45:23,1453128326,3
5698db632fb0de2600f22d79,44759,ORG3402 Organisasjonsatferd og ledelse,1453287349,2016-01-20 11:55:49,1453287353,4
5698db632fb0de2600f22d79,25479,ORG3402 Organisasjonsatferd og ledelse,1453294249,2016-01-20 13:50:49,1453294250,1
5698db632fb0de2600f22d79,60068,ORG3402 Organisasjonsatferd og ledelse,1453668559,2016-01-24 21:49:19,1453668565,6
5698db632fb0de2600f22d79,92196,ORG3402 Organisasjonsatferd og ledelse,1453709563,2016-01-25 09:12:43,1453709565,2
5698db632fb0de2600f22d79,32584,ORG3402 Organisasjonsatferd og ledelse,1454255232,2016-01-31 16:47:12,1454255693,461
5698db632fb0de2600f22d7b,15594,ORG3402 Organisasjonsatferd og ledelse,1453720215,2016-01-25 12:10:15,1453720259,44
5698db632fb0de2600f22d7c,96575,ORG3402 Organisasjonsatferd og ledelse,1453720075,2016-01-25 12:07:55,1453720534,459
5698db6341a9d72100240c1b,74737,ORG3402 Organisasjonsatferd og ledelse,1453646973,2016-01-24 15:49:33,1453647123,150
5698db6341a9d72100240c1e,81924,ORG3402 Organisasjonsatferd og ledelse,1453148772,2016-01-18 21:26:12,1453148939,167
5698db6341a9d72100240c1e,5699,ORG3402 Organisasjonsatferd og ledelse,1453719521,2016-01-25 11:58:41,1453720781,1260
5698db6341a9d72100240c1e,81389,ORG3402 Organisasjonsatferd og ledelse,1453723968,2016-01-25 13:12:48,1453723971,3
5698db6341a9d72100240c1e,28459,ORG3402 Organisasjonsatferd og ledelse,1454314177,2016-02-01 09:09:37,1454314193,16
5698db642fb0de2600f22d7d,83656,ORG3402 Organisasjonsatferd og ledelse,1453108190,2016-01-18 10:09:50,1453108244,54
5698db642fb0de2600f22d7d,95274,ORG3402 Organisasjonsatferd og ledelse,1453115109,2016-01-18 12:05:09,1453115171,62
5698db642fb0de2600f22d7d,2586,ORG3402 Organisasjonsatferd og ledelse,1453654550,2016-01-24 17:55:50,1453655890,1340
5698db642fb0de2600f22d7d,3973,ORG3402 Organisasjonsatferd og ledelse,1453669974,2016-01-24 22:12:54,1453669974,0
5698db642fb0de2600f22d7d,33510,ORG3402 Organisasjonsatferd og ledelse,1454252375,2016-01-31 15:59:35,1454252439,64
5698db642fb0de2600f22d7e,89851,ORG3402 Organisasjonsatferd og ledelse,1452865107,2016-01-15 14:38:27,1452865152,45
5698db642fb0de2600f22d7e,5998,ORG3402 Organisasjonsatferd og ledelse,1453129259,2016-01-18 16:00:59,1453129291,32
5698db642fb0de2600f22d7e,88800,ORG3402 Organisasjonsatferd og ledelse,1453202461,2016-01-19 12:21:01,1453202758,297
5698db642fb0de2600f22d7e,97340,ORG3402 Organisasjonsatferd og ledelse,1453212558,2016-01-19 15:09:18,1453212560,2
5698db642fb0de2600f22d7e,86448,ORG3402 Organisasjonsatferd og ledelse,1453659349,2016-01-24 19:15:49,1453659385,36
5698db642fb0de2600f22d7e,41377,ORG3402 Organisasjonsatferd og ledelse,1453670681,2016-01-24 22:24:41,1453670685,4
5698db642fb0de2600f22d7e,58494,ORG3402 Organisasjonsatferd og ledelse,1453680767,2016-01-25 01:12:47,1453680767,0
5698db642fb0de2600f22d7e,14114,ORG3402 Organisasjonsatferd og ledelse,1453918014,2016-01-27 19:06:54,1453918069,55
5698db642fb0de2600f22d85,90960,ORG3402 Organisasjonsatferd og ledelse,1454273673,2016-01-31 21:54:33,1454273783,110
5698db642fb0de2600f22d85,77676,ORG3402 Organisasjonsatferd og ledelse,1454288657,2016-02-01 02:04:17,1454288657,0
5698db6441a9d72100240c20,7825,ORG3402 Organisasjonsatferd og ledelse,1453794681,2016-01-26 08:51:21,1453794787,106
5698db6441a9d72100240c21,89423,ORG3402 Organisasjonsatferd og ledelse,1453650928,2016-01-24 16:55:28,1453651258,330
5698db6441a9d72100240c21,81967,ORG3402 Organisasjonsatferd og ledelse,1453719694,2016-01-25 12:01:34,1453720126,432
5698db6441a9d72100240c21,87199,ORG3402 Organisasjonsatferd og ledelse,1453728126,2016-01-25 14:22:06,1453728157,31
5698db6441a9d72100240c2b,62635,ORG3402 Organisasjonsatferd og ledelse,1452865970,2016-01-15 14:52:50,1452866015,45
5698db6441a9d72100240c2b,15325,ORG3402 Organisasjonsatferd og ledelse,1453115104,2016-01-18 12:05:04,1453115496,392
5698db6441a9d72100240c2b,1497,ORG3402 Organisasjonsatferd og ledelse,1453119318,2016-01-18 13:15:18,1453119374,56
5698db6541a9d72100240c42,73009,ORG3402 Organisasjonsatferd og ledelse,1453070072,2016-01-17 23:34:32,1453070082,10
5698db6541a9d72100240c42,73549,ORG3402 Organisasjonsatferd og ledelse,1453720204,2016-01-25 12:10:04,1453720249,45
5698db6541a9d72100240c42,20920,ORG3402 Organisasjonsatferd og ledelse,1453723464,2016-01-25 13:04:24,1453723748,284
5698db6541a9d72100240c42,67734,ORG3402 Organisasjonsatferd og ledelse,1453728235,2016-01-25 14:23:55,1453729385,1150
5698db662fb0de2600f22da1,13331,ORG3402 Organisasjonsatferd og ledelse,1453116022,2016-01-18 12:20:22,1453116846,824
5698db662fb0de2600f22da1,58335,ORG3402 Organisasjonsatferd og ledelse,1453119295,2016-01-18 13:14:55,1453119370,75
5698db662fb0de2600f22da1,5030,ORG3402 Organisasjonsatferd og ledelse,1453123115,2016-01-18 14:18:35,1453123854,739
5698db662fb0de2600f22da1,19502,ORG3402 Organisasjonsatferd og ledelse,1453151758,2016-01-18 22:15:58,1453151758,0
5698db662fb0de2600f22da2,86230,ORG3402 Organisasjonsatferd og ledelse,1453124490,2016-01-18 14:41:30,1453124614,124
5698db662fb0de2600f22da2,6250,ORG3402 Organisasjonsatferd og ledelse,1453239493,2016-01-19 22:38:13,1453239497,4
5698db662fb0de2600f22da3,42449,ORG3402 Organisasjonsatferd og ledelse,1453120296,2016-01-18 13:31:36,1453120487,191
5698db662fb0de2600f22da3,42378,ORG3402 Organisasjonsatferd og ledelse,1453122364,2016-01-18 14:06:04,1453122836,472
5698db662fb0de2600f22da3,33424,ORG3402 Organisasjonsatferd og ledelse,1453720041,2016-01-25 12:07:21,1453721563,1522
5698db662fb0de2600f22da3,94357,ORG3402 Organisasjonsatferd og ledelse,1453728365,2016-01-25 14:26:05,1453728369,4
5698db6641a9d72100240c43,38031,ORG3402 Organisasjonsatferd og ledelse,1453052943,2016-01-17 18:49:03,1453053167,224
5698db6641a9d72100240c43,26003,ORG3402 Organisasjonsatferd og ledelse,1453393753,2016-01-21 17:29:13,1453393774,21
5698db6641a9d72100240c43,89330,ORG3402 Organisasjonsatferd og ledelse,1453665774,2016-01-24 21:02:54,1453665798,24
5698db6641a9d72100240c43,55603,ORG3402 Organisasjonsatferd og ledelse,1453983439,2016-01-28 13:17:19,1453983651,212
5698db6641a9d72100240c43,4350,ORG3402 Organisasjonsatferd og ledelse,1454018567,2016-01-28 23:02:47,1454018600,33
5698db6641a9d72100240c44,30887,ORG3402 Organisasjonsatferd og ledelse,1453053963,2016-01-17 19:06:03,1453054220,257
5698db6641a9d72100240c44,84330,ORG3402 Organisasjonsatferd og ledelse,1454317330,2016-02-01 10:02:10,1454317918,588
5698db6641a9d72100240c46,1471,ORG3402 Organisasjonsatferd og ledelse,1452989750,2016-01-17 01:15:50,1452990064,314
5698db6641a9d72100240c46,36540,ORG3402 Organisasjonsatferd og ledelse,1454090186,2016-01-29 18:56:26,1454092246,2060
5698db6641a9d72100240c46,95160,ORG3402 Organisasjonsatferd og ledelse,1454093750,2016-01-29 19:55:50,1454093750,0
5698db672fb0de2600f22da4,53206,ORG3402 Organisasjonsatferd og ledelse,1452862815,2016-01-15 14:00:15,1452862882,67
5698db672fb0de2600f22da4,7004,ORG3402 Organisasjonsatferd og ledelse,1452870850,2016-01-15 16:14:10,1452870852,2
5698db672fb0de2600f22da4,31137,ORG3402 Organisasjonsatferd og ledelse,1453065164,2016-01-17 22:12:44,1453065172,8
5698db672fb0de2600f22da4,4367,ORG3402 Organisasjonsatferd og ledelse,1453126950,2016-01-18 15:22:30,1453126951,1
5698db672fb0de2600f22da4,43318,ORG3402 Organisasjonsatferd og ledelse,1453220227,2016-01-19 17:17:07,1453220263,36
5698db672fb0de2600f22da4,47166,ORG3402 Organisasjonsatferd og ledelse,1453289977,2016-01-20 12:39:37,1453289985,8
5698db672fb0de2600f22da4,6456,ORG3402 Organisasjonsatferd og ledelse,1453639694,2016-01-24 13:48:14,1453639704,10
5698db672fb0de2600f22da4,36509,ORG3402 Organisasjonsatferd og ledelse,1453670268,2016-01-24 22:17:48,1453670274,6
5698db672fb0de2600f22da4,22205,ORG3402 Organisasjonsatferd og ledelse,1453676849,2016-01-25 00:07:29,1453676850,1
5698db672fb0de2600f22da4,50668,ORG3402 Organisasjonsatferd og ledelse,1453720893,2016-01-25 12:21:33,1453720901,8
5698db672fb0de2600f22da4,57039,ORG3402 Organisasjonsatferd og ledelse,1453730193,2016-01-25 14:56:33,1453730194,1
5698db672fb0de2600f22da4,46074,ORG3402 Organisasjonsatferd og ledelse,1454081614,2016-01-29 16:33:34,1454081628,14
5698db672fb0de2600f22da5,14422,ORG3402 Organisasjonsatferd og ledelse,1453125682,2016-01-18 15:01:22,1453125720,38
5698db6741a9d72100240c4f,81920,ORG3402 Organisasjonsatferd og ledelse,1453923602,2016-01-27 20:40:02,1453923690,88
5698db6741a9d72100240c4f,58526,ORG3402 Organisasjonsatferd og ledelse,1453982018,2016-01-28 12:53:38,1453982018,0
5698db6741a9d72100240c4f,29583,ORG3402 Organisasjonsatferd og ledelse,1454270565,2016-01-31 21:02:45,1454270565,0
5698db6741a9d72100240c4f,28300,ORG3402 Organisasjonsatferd og ledelse,1454316952,2016-02-01 09:55:52,1454316954,2
5698db682fb0de2600f22da9,32986,ORG3402 Organisasjonsatferd og ledelse,1453039680,2016-01-17 15:08:00,1453041019,1339
5698db682fb0de2600f22da9,14496,ORG3402 Organisasjonsatferd og ledelse,1453148385,2016-01-18 21:19:45,1453148689,304
5698db682fb0de2600f22da9,57049,ORG3402 Organisasjonsatferd og ledelse,1453377362,2016-01-21 12:56:02,1453377363,1
5698db682fb0de2600f22da9,59670,ORG3402 Organisasjonsatferd og ledelse,1453653621,2016-01-24 17:40:21,1453653629,8
5698db682fb0de2600f22da9,12826,ORG3402 Organisasjonsatferd og ledelse,1453670288,2016-01-24 22:18:08,1453670301,13
5698db682fb0de2600f22da9,67733,ORG3402 Organisasjonsatferd og ledelse,1453910622,2016-01-27 17:03:42,1453910622,0
5698db682fb0de2600f22da9,3323,ORG3402 Organisasjonsatferd og ledelse,1453982477,2016-01-28 13:01:17,1453982477,0
5698db682fb0de2600f22da9,38391,ORG3402 Organisasjonsatferd og ledelse,1454002231,2016-01-28 18:30:31,1454002232,1
5698db682fb0de2600f22da9,4261,ORG3402 Organisasjonsatferd og ledelse,1454084196,2016-01-29 17:16:36,1454084196,0
5698db682fb0de2600f22da9,18063,ORG3402 Organisasjonsatferd og ledelse,1454091119,2016-01-29 19:11:59,1454091119,0
5698db682fb0de2600f22da9,59878,ORG3402 Organisasjonsatferd og ledelse,1454277089,2016-01-31 22:51:29,1454277128,39
5698db682fb0de2600f22daa,29208,ORG3402 Organisasjonsatferd og ledelse,1453113467,2016-01-18 11:37:47,1453113554,87
5698db6841a9d72100240c53,40799,ORG3402 Organisasjonsatferd og ledelse,1452876007,2016-01-15 17:40:07,1452876007,0
5698db6841a9d72100240c53,78951,ORG3402 Organisasjonsatferd og ledelse,1453115071,2016-01-18 12:04:31,1453115423,352
5698db6841a9d72100240c53,2292,ORG3402 Organisasjonsatferd og ledelse,1453575906,2016-01-23 20:05:06,1453576199,293
5698db6841a9d72100240c53,22417,ORG3402 Organisasjonsatferd og ledelse,1453718058,2016-01-25 11:34:18,1453718085,27
5698db6841a9d72100240c53,22524,ORG3402 Organisasjonsatferd og ledelse,1453749060,2016-01-25 20:11:00,1453749060,0
5698db6841a9d72100240c53,46389,ORG3402 Organisasjonsatferd og ledelse,1454087630,2016-01-29 18:13:50,1454089648,2018
5698db6941a9d72100240c6d,12667,ORG3402 Organisasjonsatferd og ledelse,1453239552,2016-01-19 22:39:12,1453239632,80
5698db6941a9d72100240c6d,559,ORG3402 Organisasjonsatferd og ledelse,1453922303,2016-01-27 20:18:23,1453922481,178
5698db6941a9d72100240c6d,10025,ORG3402 Organisasjonsatferd og ledelse,1454029864,2016-01-29 02:11:04,1454029865,1
5698db6a2fb0de2600f22dc9,43674,ORG3402 Organisasjonsatferd og ledelse,1453117602,2016-01-18 12:46:42,1453117759,157
5698db6a2fb0de2600f22dc9,66885,ORG3402 Organisasjonsatferd og ledelse,1453123845,2016-01-18 14:30:45,1453123876,31
5698db6a2fb0de2600f22dc9,44792,ORG3402 Organisasjonsatferd og ledelse,1453719823,2016-01-25 12:03:43,1453720034,211
5698db6a2fb0de2600f22dcc,85523,ORG3402 Organisasjonsatferd og ledelse,1453310482,2016-01-20 18:21:22,1453310576,94
5698db6a2fb0de2600f22dcc,47031,ORG3402 Organisasjonsatferd og ledelse,1453475925,2016-01-22 16:18:45,1453476013,88
5698db6a2fb0de2600f22dcc,8337,ORG3402 Organisasjonsatferd og ledelse,1453660354,2016-01-24 19:32:34,1453661217,863
5698db6a2fb0de2600f22dcc,27037,ORG3402 Organisasjonsatferd og ledelse,1454070466,2016-01-29 13:27:46,1454070523,57
5698db6a2fb0de2600f22dcd,23519,ORG3402 Organisasjonsatferd og ledelse,1452862413,2016-01-15 13:53:33,1452862414,1
5698db6a2fb0de2600f22dce,18705,ORG3402 Organisasjonsatferd og ledelse,1453148524,2016-01-18 21:22:04,1453148579,55
5698db6a2fb0de2600f22dce,84962,ORG3402 Organisasjonsatferd og ledelse,1453806046,2016-01-26 12:00:46,1453806084,38
5698db6a2fb0de2600f22dce,33398,ORG3402 Organisasjonsatferd og ledelse,1453812885,2016-01-26 13:54:45,1453813987,1102
5698db6a41a9d72100240c6f,96894,ORG3402 Organisasjonsatferd og ledelse,1453210592,2016-01-19 14:36:32,1453210742,150
5698db6a41a9d72100240c6f,83260,ORG3402 Organisasjonsatferd og ledelse,1453459364,2016-01-22 11:42:44,1453459372,8
5698db6a41a9d72100240c6f,81408,ORG3402 Organisasjonsatferd og ledelse,1453643665,2016-01-24 14:54:25,1453644988,1323
5698db6a41a9d72100240c6f,25438,ORG3402 Organisasjonsatferd og ledelse,1453900273,2016-01-27 14:11:13,1453900302,29
5698db6a41a9d72100240c6f,95756,ORG3402 Organisasjonsatferd og ledelse,1453914395,2016-01-27 18:06:35,1453914459,64
5698db6a41a9d72100240c70,89890,ORG3402 Organisasjonsatferd og ledelse,1452876890,2016-01-15 17:54:50,1452877232,342
5698db6a41a9d72100240c70,22,ORG3402 Organisasjonsatferd og ledelse,1453158130,2016-01-19 00:02:10,1453158721,591
5698db6a41a9d72100240c70,79015,ORG3402 Organisasjonsatferd og ledelse,1453161660,2016-01-19 01:01:00,1453161660,0
5698db6a41a9d72100240c70,17139,ORG3402 Organisasjonsatferd og ledelse,1453672744,2016-01-24 22:59:04,1453672943,199
5698db6a41a9d72100240c71,45912,ORG3402 Organisasjonsatferd og ledelse,1453717858,2016-01-25 11:30:58,1453719100,1242
5698db6a41a9d72100240c71,9101,ORG3402 Organisasjonsatferd og ledelse,1454031325,2016-01-29 02:35:25,1454031326,1
5698db6a41a9d72100240c71,15320,ORG3402 Organisasjonsatferd og ledelse,1454202964,2016-01-31 02:16:04,1454203050,86
5698db6a41a9d72100240c72,12257,ORG3402 Organisasjonsatferd og ledelse,1453723638,2016-01-25 13:07:18,1453724101,463
5698db6a41a9d72100240c72,91444,ORG3402 Organisasjonsatferd og ledelse,1453805382,2016-01-26 11:49:42,1453805383,1
5698db6a41a9d72100240c72,84806,ORG3402 Organisasjonsatferd og ledelse,1453894848,2016-01-27 12:40:48,1453895416,568
5698db6a41a9d72100240c72,81065,ORG3402 Organisasjonsatferd og ledelse,1454066217,2016-01-29 12:16:57,1454066449,232
5698db6b2fb0de2600f22dd9,86387,ORG3402 Organisasjonsatferd og ledelse,1453228367,2016-01-19 19:32:47,1453228548,181
5698db6b2fb0de2600f22dd9,79245,ORG3402 Organisasjonsatferd og ledelse,1453310844,2016-01-20 18:27:24,1453310851,7
5698db6b2fb0de2600f22dd9,80297,ORG3402 Organisasjonsatferd og ledelse,1453668585,2016-01-24 21:49:45,1453668596,11
5698db6b2fb0de2600f22dd9,28981,ORG3402 Organisasjonsatferd og ledelse,1453671032,2016-01-24 22:30:32,1453671034,2
5698db6b2fb0de2600f22dd9,33732,ORG3402 Organisasjonsatferd og ledelse,1454074124,2016-01-29 14:28:44,1454074153,29
5698db6b2fb0de2600f22dee,80610,ORG3402 Organisasjonsatferd og ledelse,1453124885,2016-01-18 14:48:05,1453125410,525
5698db6c2fb0de2600f22df1,72920,ORG3402 Organisasjonsatferd og ledelse,1453719967,2016-01-25 12:06:07,1453720713,746
5698db6c2fb0de2600f22df3,79160,ORG3402 Organisasjonsatferd og ledelse,1453115128,2016-01-18 12:05:28,1453116392,1264
5698db6c2fb0de2600f22df3,46270,ORG3402 Organisasjonsatferd og ledelse,1453117646,2016-01-18 12:47:26,1453117647,1
5698db6c2fb0de2600f22df3,13483,ORG3402 Organisasjonsatferd og ledelse,1453119772,2016-01-18 13:22:52,1453120999,1227
5698db6c2fb0de2600f22df3,87489,ORG3402 Organisasjonsatferd og ledelse,1453124448,2016-01-18 14:40:48,1453124449,1
5698db6c2fb0de2600f22df4,58864,ORG3402 Organisasjonsatferd og ledelse,1453677837,2016-01-25 00:23:57,1453677901,64
5698db6c2fb0de2600f22df4,45831,ORG3402 Organisasjonsatferd og ledelse,1453687252,2016-01-25 03:00:52,1453687252,0
5698db6c41a9d72100240c92,30832,ORG3402 Organisasjonsatferd og ledelse,1452977640,2016-01-16 21:54:00,1452977642,2
5698db6c41a9d72100240c92,39919,ORG3402 Organisasjonsatferd og ledelse,1452985612,2016-01-17 00:06:52,1452985612,0
5698db6c41a9d72100240c92,8328,ORG3402 Organisasjonsatferd og ledelse,1453114417,2016-01-18 11:53:37,1453115362,945
5698db6c41a9d72100240c92,90304,ORG3402 Organisasjonsatferd og ledelse,1453127302,2016-01-18 15:28:22,1453127302,0
5698db6c41a9d72100240c92,39637,ORG3402 Organisasjonsatferd og ledelse,1453474860,2016-01-22 16:01:00,1453475768,908
5698db6c41a9d72100240c92,68865,ORG3402 Organisasjonsatferd og ledelse,1453646299,2016-01-24 15:38:19,1453646321,22
5698db6c41a9d72100240c92,44371,ORG3402 Organisasjonsatferd og ledelse,1453648202,2016-01-24 16:10:02,1453648267,65
5698db6c41a9d72100240c92,6511,ORG3402 Organisasjonsatferd og ledelse,1453720097,2016-01-25 12:08:17,1453720123,26
5698db6c41a9d72100240c93,2274,ORG3402 Organisasjonsatferd og ledelse,1453117899,2016-01-18 12:51:39,1453118553,654
5698db6c41a9d72100240c93,8172,ORG3402 Organisasjonsatferd og ledelse,1453122347,2016-01-18 14:05:47,1453123239,892
5698db6c41a9d72100240c93,31355,nan,1453124655,2016-01-18 14:44:15,1453124655,0
5698db6c41a9d72100240c93,46145,ORG3402 Organisasjonsatferd og ledelse,1453126913,2016-01-18 15:21:53,1453126926,13
5698db6c41a9d72100240c93,4412,ORG3402 Organisasjonsatferd og ledelse,1453680507,2016-01-25 01:08:27,1453680537,30
5698db6c41a9d72100240c93,47905,ORG3402 Organisasjonsatferd og ledelse,1453685541,2016-01-25 02:32:21,1453685558,17
5698db6c41a9d72100240c93,44367,ORG3402 Organisasjonsatferd og ledelse,1453744331,2016-01-25 18:52:11,1453744898,567
5698db6c41a9d72100240c93,81963,ORG3402 Organisasjonsatferd og ledelse,1453816813,2016-01-26 15:00:13,1453816813,0
5698db6d2fb0de2600f22df5,83521,ORG3402 Organisasjonsatferd og ledelse,1453033449,2016-01-17 13:24:09,1453033875,426
5698db6d2fb0de2600f22df5,89099,ORG3402 Organisasjonsatferd og ledelse,1453035495,2016-01-17 13:58:15,1453035911,416
5698db6d2fb0de2600f22df5,1037,ORG3402 Organisasjonsatferd og ledelse,1453040138,2016-01-17 15:15:38,1453040197,59
5698db6d2fb0de2600f22df5,30912,ORG3402 Organisasjonsatferd og ledelse,1453115054,2016-01-18 12:04:14,1453116017,963
5698db6d2fb0de2600f22df5,32628,ORG3402 Organisasjonsatferd og ledelse,1453119299,2016-01-18 13:14:59,1453119306,7
5698db6d2fb0de2600f22df5,36181,ORG3402 Organisasjonsatferd og ledelse,1453121990,2016-01-18 13:59:50,1453122767,777
5698db6d2fb0de2600f22df5,3177,ORG3402 Organisasjonsatferd og ledelse,1453810503,2016-01-26 13:15:03,1453810615,112
5698db6d2fb0de2600f22df5,9282,ORG3402 Organisasjonsatferd og ledelse,1453812327,2016-01-26 13:45:27,1453812355,28
5698db6d2fb0de2600f22df5,44945,ORG3402 Organisasjonsatferd og ledelse,1453815768,2016-01-26 14:42:48,1453815768,0
5698db6d2fb0de2600f22df5,18020,ORG3402 Organisasjonsatferd og ledelse,1453817587,2016-01-26 15:13:07,1453817587,0
5698db6d2fb0de2600f22df6,26262,ORG3402 Organisasjonsatferd og ledelse,1453293705,2016-01-20 13:41:45,1453293901,196
5698db6d2fb0de2600f22df6,93939,ORG3402 Organisasjonsatferd og ledelse,1453764944,2016-01-26 00:35:44,1453764954,10
5698db6d2fb0de2600f22df6,35230,ORG3402 Organisasjonsatferd og ledelse,1453914881,2016-01-27 18:14:41,1453914913,32
5698db6d2fb0de2600f22df6,42695,ORG3402 Organisasjonsatferd og ledelse,1453979064,2016-01-28 12:04:24,1453979096,32
5698db6e2fb0de2600f22dfc,93115,ORG3402 Organisasjonsatferd og ledelse,1453031182,2016-01-17 12:46:22,1453032044,862
5698db6e41a9d72100240c9d,62455,ORG3402 Organisasjonsatferd og ledelse,1452870453,2016-01-15 16:07:33,1452870577,124
5698db6e41a9d72100240c9d,23554,ORG3402 Organisasjonsatferd og ledelse,1453120037,2016-01-18 13:27:17,1453120124,87
5698db6e41a9d72100240c9d,1630,ORG3402 Organisasjonsatferd og ledelse,1453148388,2016-01-18 21:19:48,1453148605,217
5698db6e41a9d72100240c9d,97783,ORG3402 Organisasjonsatferd og ledelse,1453641879,2016-01-24 14:24:39,1453641882,3
5698db6e41a9d72100240c9e,15743,ORG3402 Organisasjonsatferd og ledelse,1453720524,2016-01-25 12:15:24,1453720525,1
5698db6e41a9d72100240c9e,46832,ORG3402 Organisasjonsatferd og ledelse,1454042771,2016-01-29 05:46:11,1454042777,6
5698db6e41a9d72100240c9f,56450,ORG3402 Organisasjonsatferd og ledelse,1453055120,2016-01-17 19:25:20,1453055720,600
5698db6e41a9d72100240c9f,3328,ORG3402 Organisasjonsatferd og ledelse,1453108988,2016-01-18 10:23:08,1453108999,11
5698db6e41a9d72100240c9f,91036,ORG3402 Organisasjonsatferd og ledelse,1453110581,2016-01-18 10:49:41,1453110581,0
5698db6e41a9d72100240c9f,99460,ORG3402 Organisasjonsatferd og ledelse,1453115377,2016-01-18 12:09:37,1453115445,68
5698db6e41a9d72100240c9f,44641,ORG3402 Organisasjonsatferd og ledelse,1453118778,2016-01-18 13:06:18,1453118796,18
5698db6e41a9d72100240c9f,14889,ORG3402 Organisasjonsatferd og ledelse,1453755703,2016-01-25 22:01:43,1453755774,71
5698db6e41a9d72100240c9f,33444,ORG3402 Organisasjonsatferd og ledelse,1453886745,2016-01-27 10:25:45,1453887030,285
5698db6e41a9d72100240c9f,89489,ORG3402 Organisasjonsatferd og ledelse,1453896622,2016-01-27 13:10:22,1453896631,9
5698db6e41a9d72100240ca2,62812,ORG3402 Organisasjonsatferd og ledelse,1453720274,2016-01-25 12:11:14,1453720593,319
5698db6e41a9d72100240ca2,26452,ORG3402 Organisasjonsatferd og ledelse,1453724314,2016-01-25 13:18:34,1453724338,24
5698db6e41a9d72100240ca2,11123,ORG3402 Organisasjonsatferd og ledelse,1453729431,2016-01-25 14:43:51,1453729432,1
5698db6f2fb0de2600f22e16,97775,ORG3402 Organisasjonsatferd og ledelse,1453240411,2016-01-19 22:53:31,1453240580,169
5698db6f2fb0de2600f22e16,81473,ORG3402 Organisasjonsatferd og ledelse,1453724985,2016-01-25 13:29:45,1453725769,784
5698db6f2fb0de2600f22e17,47785,ORG3402 Organisasjonsatferd og ledelse,1453472614,2016-01-22 15:23:34,1453473097,483
5698db6f41a9d72100240cbd,56874,ORG3402 Organisasjonsatferd og ledelse,1452958003,2016-01-16 16:26:43,1452959034,1031
5698db6f41a9d72100240cbd,41050,ORG3402 Organisasjonsatferd og ledelse,1453039277,2016-01-17 15:01:17,1453039277,0
5698db6f41a9d72100240cbd,74819,ORG3402 Organisasjonsatferd og ledelse,1453073942,2016-01-18 00:39:02,1453073960,18
5698db6f41a9d72100240cbd,36999,ORG3402 Organisasjonsatferd og ledelse,1453155883,2016-01-18 23:24:43,1453155892,9
5698db6f41a9d72100240cbd,54008,ORG3402 Organisasjonsatferd og ledelse,1453720771,2016-01-25 12:19:31,1453720782,11
5698db6f41a9d72100240cbd,41786,ORG3402 Organisasjonsatferd og ledelse,1453728185,2016-01-25 14:23:05,1453729188,1003
5698db702fb0de2600f22e1c,8361,ORG3402 Organisasjonsatferd og ledelse,1453720731,2016-01-25 12:18:51,1453720769,38
5698db702fb0de2600f22e1c,92752,ORG3402 Organisasjonsatferd og ledelse,1453728286,2016-01-25 14:24:46,1453728391,105
5698db702fb0de2600f22e1d,66222,ORG3402 Organisasjonsatferd og ledelse,1453119911,2016-01-18 13:25:11,1453119971,60
5698db702fb0de2600f22e1d,59182,ORG3402 Organisasjonsatferd og ledelse,1453719710,2016-01-25 12:01:50,1453720001,291
5698db702fb0de2600f22e1e,21167,ORG3402 Organisasjonsatferd og ledelse,1453479799,2016-01-22 17:23:19,1453479861,62
5698db702fb0de2600f22e20,17961,ORG3402 Organisasjonsatferd og ledelse,1452871240,2016-01-15 16:20:40,1452872268,1028
5698db702fb0de2600f22e20,15304,ORG3402 Organisasjonsatferd og ledelse,1452874084,2016-01-15 17:08:04,1452874084,0
5698db702fb0de2600f22e20,38628,ORG3402 Organisasjonsatferd og ledelse,1452887644,2016-01-15 20:54:04,1452887650,6
5698db702fb0de2600f22e20,13318,ORG3402 Organisasjonsatferd og ledelse,1452889219,2016-01-15 21:20:19,1452889219,0
5698db702fb0de2600f22e20,46276,ORG3402 Organisasjonsatferd og ledelse,1452974719,2016-01-16 21:05:19,1452974829,110
5698db702fb0de2600f22e20,35797,ORG3402 Organisasjonsatferd og ledelse,1453061291,2016-01-17 21:08:11,1453062352,1061
5698db702fb0de2600f22e20,7671,ORG3402 Organisasjonsatferd og ledelse,1453115230,2016-01-18 12:07:10,1453115634,404
5698db702fb0de2600f22e20,21858,ORG3402 Organisasjonsatferd og ledelse,1453206235,2016-01-19 13:23:55,1453206254,19
5698db702fb0de2600f22e20,39666,ORG3402 Organisasjonsatferd og ledelse,1453501552,2016-01-22 23:25:52,1453501571,19
5698db702fb0de2600f22e20,29363,ORG3402 Organisasjonsatferd og ledelse,1453655653,2016-01-24 18:14:13,1453655691,38
5698db702fb0de2600f22e20,15721,ORG3402 Organisasjonsatferd og ledelse,1453671078,2016-01-24 22:31:18,1453671085,7
5698db702fb0de2600f22e20,15723,ORG3402 Organisasjonsatferd og ledelse,1454097787,2016-01-29 21:03:07,1454098981,1194
5698db712fb0de2600f22e22,94259,ORG3402 Organisasjonsatferd og ledelse,1453808390,2016-01-26 12:39:50,1453808430,40
5698db712fb0de2600f22e23,82966,ORG3402 Organisasjonsatferd og ledelse,1453119380,2016-01-18 13:16:20,1453119380,0
5698db7141a9d72100240cbe,37187,ORG3402 Organisasjonsatferd og ledelse,1453118066,2016-01-18 12:54:26,1453118640,574
5698db7141a9d72100240cbf,78837,ORG3402 Organisasjonsatferd og ledelse,1453037715,2016-01-17 14:35:15,1453040427,2712
5698db7141a9d72100240cbf,35186,ORG3402 Organisasjonsatferd og ledelse,1453926857,2016-01-27 21:34:17,1453926891,34
5698db7141a9d72100240cbf,99061,ORG3402 Organisasjonsatferd og ledelse,1453928111,2016-01-27 21:55:11,1453928112,1
5698db7141a9d72100240cc0,43875,ORG3402 Organisasjonsatferd og ledelse,1453113998,2016-01-18 11:46:38,1453114165,167
5698db7141a9d72100240cc0,50442,ORG3402 Organisasjonsatferd og ledelse,1453122750,2016-01-18 14:12:30,1453123117,367
5698db7141a9d72100240cc0,64734,ORG3402 Organisasjonsatferd og ledelse,1453220496,2016-01-19 17:21:36,1453220580,84
5698db7141a9d72100240cc0,4626,ORG3402 Organisasjonsatferd og ledelse,1453718448,2016-01-25 11:40:48,1453718547,99
5698db7141a9d72100240cc0,41853,ORG3402 Organisasjonsatferd og ledelse,1453887373,2016-01-27 10:36:13,1453887373,0
5698db7141a9d72100240cc0,98521,ORG3402 Organisasjonsatferd og ledelse,1453894884,2016-01-27 12:41:24,1453894892,8
5698db7141a9d72100240cc0,99472,ORG3402 Organisasjonsatferd og ledelse,1453903497,2016-01-27 15:04:57,1453903788,291
5698db7141a9d72100240cc0,90465,ORG3402 Organisasjonsatferd og ledelse,1454321645,2016-02-01 11:14:05,1454321659,14
5698db7141a9d72100240cc4,21769,ORG3402 Organisasjonsatferd og ledelse,1453157626,2016-01-18 23:53:46,1453157756,130
5698db7141a9d72100240cc4,95598,ORG3402 Organisasjonsatferd og ledelse,1453720533,2016-01-25 12:15:33,1453721228,695
5698db7141a9d72100240cc4,3303,ORG3402 Organisasjonsatferd og ledelse,1453724174,2016-01-25 13:16:14,1453724335,161
5698db7141a9d72100240cc4,41381,ORG3402 Organisasjonsatferd og ledelse,1453728261,2016-01-25 14:24:21,1453728571,310
5698db7141a9d72100240cc4,38355,ORG3402 Organisasjonsatferd og ledelse,1453929452,2016-01-27 22:17:32,1453929452,0
5698db7141a9d72100240cc4,30656,ORG3402 Organisasjonsatferd og ledelse,1454120054,2016-01-30 03:14:14,1454120055,1
5698db7141a9d72100240cc4,26219,ORG3402 Organisasjonsatferd og ledelse,1454273206,2016-01-31 21:46:46,1454273207,1
5698db722fb0de2600f22e3e,41596,ORG3402 Organisasjonsatferd og ledelse,1453055019,2016-01-17 19:23:39,1453055221,202
5698db722fb0de2600f22e3e,47622,ORG3402 Organisasjonsatferd og ledelse,1453152093,2016-01-18 22:21:33,1453152104,11
5698db722fb0de2600f22e3e,81783,ORG3402 Organisasjonsatferd og ledelse,1453226704,2016-01-19 19:05:04,1453226744,40
5698db722fb0de2600f22e3e,78650,ORG3402 Organisasjonsatferd og ledelse,1453227947,2016-01-19 19:25:47,1453227947,0
5698db722fb0de2600f22e3f,12924,ORG3402 Organisasjonsatferd og ledelse,1452862185,2016-01-15 13:49:45,1452862499,314
5698db722fb0de2600f22e3f,79084,ORG3402 Organisasjonsatferd og ledelse,1453050176,2016-01-17 18:02:56,1453050458,282
5698db722fb0de2600f22e3f,55378,ORG3402 Organisasjonsatferd og ledelse,1453055839,2016-01-17 19:37:19,1453055840,1
5698db722fb0de2600f22e3f,60974,ORG3402 Organisasjonsatferd og ledelse,1453060137,2016-01-17 20:48:57,1453060219,82
5698db722fb0de2600f22e3f,65651,ORG3402 Organisasjonsatferd og ledelse,1453116139,2016-01-18 12:22:19,1453117473,1334
5698db722fb0de2600f22e3f,16683,ORG3402 Organisasjonsatferd og ledelse,1453122572,2016-01-18 14:09:32,1453122822,250
5698db722fb0de2600f22e3f,49777,ORG3402 Organisasjonsatferd og ledelse,1453128254,2016-01-18 15:44:14,1453128275,21
5698db722fb0de2600f22e3f,57923,ORG3402 Organisasjonsatferd og ledelse,1453210923,2016-01-19 14:42:03,1453211826,903
5698db722fb0de2600f22e3f,78604,ORG3402 Organisasjonsatferd og ledelse,1453382028,2016-01-21 14:13:48,1453382079,51
5698db722fb0de2600f22e3f,24978,ORG3402 Organisasjonsatferd og ledelse,1453644138,2016-01-24 15:02:18,1453644360,222
5698db722fb0de2600f22e3f,29037,ORG3402 Organisasjonsatferd og ledelse,1453668967,2016-01-24 21:56:07,1453668971,4
5698db722fb0de2600f22e3f,78146,ORG3402 Organisasjonsatferd og ledelse,1454263646,2016-01-31 19:07:26,1454263670,24
5698db7241a9d72100240ce2,36332,ORG3402 Organisasjonsatferd og ledelse,1453720333,2016-01-25 12:12:13,1453720439,106
5698db7241a9d72100240ce2,3392,ORG3402 Organisasjonsatferd og ledelse,1453722688,2016-01-25 12:51:28,1453723549,861
5698db7241a9d72100240ce2,17718,ORG3402 Organisasjonsatferd og ledelse,1453724851,2016-01-25 13:27:31,1453725262,411
5698db7241a9d72100240ce2,75108,ORG3402 Organisasjonsatferd og ledelse,1453726598,2016-01-25 13:56:38,1453726671,73
5698db7241a9d72100240ce2,47337,ORG3402 Organisasjonsatferd og ledelse,1453728202,2016-01-25 14:23:22,1453728296,94
5698db7241a9d72100240ce2,55115,ORG3402 Organisasjonsatferd og ledelse,1453729999,2016-01-25 14:53:19,1453730471,472
5698db7241a9d72100240ce6,7522,ORG3402 Organisasjonsatferd og ledelse,1453965080,2016-01-28 08:11:20,1453965178,98
5698db7241a9d72100240ce8,1345,ORG3402 Organisasjonsatferd og ledelse,1453235392,2016-01-19 21:29:52,1453236245,853
5698db732fb0de2600f22e44,72492,ORG3402 Organisasjonsatferd og ledelse,1453144759,2016-01-18 20:19:19,1453145487,728
5698db732fb0de2600f22e45,6910,ORG3402 Organisasjonsatferd og ledelse,1453058416,2016-01-17 20:20:16,1453060416,2000
5698db732fb0de2600f22e47,98139,ORG3402 Organisasjonsatferd og ledelse,1452863376,2016-01-15 14:09:36,1452867289,3913
5698db732fb0de2600f22e47,75173,ORG3402 Organisasjonsatferd og ledelse,1453051782,2016-01-17 18:29:42,1453051944,162
5698db732fb0de2600f22e47,68358,ORG3402 Organisasjonsatferd og ledelse,1453060227,2016-01-17 20:50:27,1453060295,68
5698db732fb0de2600f22e47,49169,ORG3402 Organisasjonsatferd og ledelse,1453149069,2016-01-18 21:31:09,1453149962,893
5698db732fb0de2600f22e47,14690,ORG3402 Organisasjonsatferd og ledelse,1453229016,2016-01-19 19:43:36,1453229024,8
5698db732fb0de2600f22e47,59108,ORG3402 Organisasjonsatferd og ledelse,1453315533,2016-01-20 19:45:33,1453315734,201
5698db732fb0de2600f22e47,7251,ORG3402 Organisasjonsatferd og ledelse,1453471193,2016-01-22 14:59:53,1453471196,3
5698db732fb0de2600f22e47,38986,ORG3402 Organisasjonsatferd og ledelse,1453504579,2016-01-23 00:16:19,1453504580,1
5698db732fb0de2600f22e47,6236,ORG3402 Organisasjonsatferd og ledelse,1453582562,2016-01-23 21:56:02,1453582572,10
5698db732fb0de2600f22e47,33839,ORG3402 Organisasjonsatferd og ledelse,1453640787,2016-01-24 14:06:27,1453641029,242
5698db732fb0de2600f22e47,8980,ORG3402 Organisasjonsatferd og ledelse,1453668568,2016-01-24 21:49:28,1453668572,4
5698db732fb0de2600f22e47,80679,ORG3402 Organisasjonsatferd og ledelse,1453670299,2016-01-24 22:18:19,1453670306,7
5698db732fb0de2600f22e47,59265,ORG3402 Organisasjonsatferd og ledelse,1453750814,2016-01-25 20:40:14,1453750856,42
5698db732fb0de2600f22e47,79180,ORG3402 Organisasjonsatferd og ledelse,1453819477,2016-01-26 15:44:37,1453819506,29
5698db732fb0de2600f22e47,81942,ORG3402 Organisasjonsatferd og ledelse,1453890187,2016-01-27 11:23:07,1453890190,3
5698db732fb0de2600f22e47,67028,ORG3402 Organisasjonsatferd og ledelse,1453898441,2016-01-27 13:40:41,1453898448,7
5698db732fb0de2600f22e47,86488,ORG3402 Organisasjonsatferd og ledelse,1453933616,2016-01-27 23:26:56,1453933690,74
5698db732fb0de2600f22e47,76548,ORG3402 Organisasjonsatferd og ledelse,1453979656,2016-01-28 12:14:16,1453980012,356
5698db732fb0de2600f22e47,88641,ORG3402 Organisasjonsatferd og ledelse,1453992700,2016-01-28 15:51:40,1453992710,10
5698db732fb0de2600f22e47,60657,ORG3402 Organisasjonsatferd og ledelse,1454086176,2016-01-29 17:49:36,1454086177,1
5698db7441a9d72100240cea,53802,ORG3402 Organisasjonsatferd og ledelse,1452861919,2016-01-15 13:45:19,1452862406,487
5698db7441a9d72100240cea,59913,ORG3402 Organisasjonsatferd og ledelse,1453648627,2016-01-24 16:17:07,1453648743,116
5698db7441a9d72100240cea,8402,ORG3402 Organisasjonsatferd og ledelse,1453754688,2016-01-25 21:44:48,1453754726,38
5698db7441a9d72100240cec,82551,ORG3402 Organisasjonsatferd og ledelse,1452862176,2016-01-15 13:49:36,1452862224,48
5698db7441a9d72100240cec,69692,ORG3402 Organisasjonsatferd og ledelse,1452886408,2016-01-15 20:33:28,1452886409,1
5698db7441a9d72100240cec,36996,ORG3402 Organisasjonsatferd og ledelse,1453158872,2016-01-19 00:14:32,1453158873,1
5698db7441a9d72100240cec,45239,ORG3402 Organisasjonsatferd og ledelse,1453185242,2016-01-19 07:34:02,1453185784,542
5698db7441a9d72100240cec,33620,ORG3402 Organisasjonsatferd og ledelse,1453679990,2016-01-25 00:59:50,1453680232,242
5698db7441a9d72100240ced,73770,ORG3402 Organisasjonsatferd og ledelse,1452861893,2016-01-15 13:44:53,1452862121,228
5698db7441a9d72100240ced,29344,ORG3402 Organisasjonsatferd og ledelse,1453050081,2016-01-17 18:01:21,1453050729,648
5698db7441a9d72100240ced,16606,ORG3402 Organisasjonsatferd og ledelse,1453055980,2016-01-17 19:39:40,1453055981,1
5698db7441a9d72100240ced,71732,ORG3402 Organisasjonsatferd og ledelse,1453115273,2016-01-18 12:07:53,1453115339,66
5698db7441a9d72100240ced,2304,ORG3402 Organisasjonsatferd og ledelse,1453290257,2016-01-20 12:44:17,1453290258,1
5698db7441a9d72100240ced,50560,ORG3402 Organisasjonsatferd og ledelse,1453719978,2016-01-25 12:06:18,1453721791,1813
5698db7441a9d72100240ced,61526,ORG3402 Organisasjonsatferd og ledelse,1453725553,2016-01-25 13:39:13,1453725553,0
5698db7441a9d72100240cf0,37021,ORG3402 Organisasjonsatferd og ledelse,1453070265,2016-01-17 23:37:45,1453071731,1466
5698db7441a9d72100240cf0,60918,ORG3402 Organisasjonsatferd og ledelse,1453242930,2016-01-19 23:35:30,1453243009,79
5698db7441a9d72100240cf0,43106,ORG3402 Organisasjonsatferd og ledelse,1453326885,2016-01-20 22:54:45,1453326907,22
5698db7441a9d72100240cf0,90906,ORG3402 Organisasjonsatferd og ledelse,1453402650,2016-01-21 19:57:30,1453402653,3
5698db7441a9d72100240cf0,96490,ORG3402 Organisasjonsatferd og ledelse,1453405702,2016-01-21 20:48:22,1453405705,3
5698db7441a9d72100240cf0,25241,ORG3402 Organisasjonsatferd og ledelse,1453918026,2016-01-27 19:07:06,1453918109,83
5698db7441a9d72100240cf4,26615,ORG3402 Organisasjonsatferd og ledelse,1453894377,2016-01-27 12:32:57,1453894958,581
5698db752fb0de2600f22e66,53358,ORG3402 Organisasjonsatferd og ledelse,1453136744,2016-01-18 18:05:44,1453136830,86
5698db752fb0de2600f22e67,58544,ORG3402 Organisasjonsatferd og ledelse,1453149038,2016-01-18 21:30:38,1453150085,1047
5698db752fb0de2600f22e67,28996,ORG3402 Organisasjonsatferd og ledelse,1453901445,2016-01-27 14:30:45,1453901445,0
5698db7541a9d72100240d0d,94302,ORG3402 Organisasjonsatferd og ledelse,1453666340,2016-01-24 21:12:20,1453666382,42
5698db7541a9d72100240d0d,23528,ORG3402 Organisasjonsatferd og ledelse,1454321661,2016-02-01 11:14:21,1454321694,33
5698db762fb0de2600f22e6c,46764,ORG3402 Organisasjonsatferd og ledelse,1453205216,2016-01-19 13:06:56,1453207109,1893
5698db762fb0de2600f22e6c,98335,ORG3402 Organisasjonsatferd og ledelse,1453383393,2016-01-21 14:36:33,1453383463,70
5698db762fb0de2600f22e6c,89149,ORG3402 Organisasjonsatferd og ledelse,1453719541,2016-01-25 11:59:01,1453720206,665
5698db762fb0de2600f22e6c,91504,ORG3402 Organisasjonsatferd og ledelse,1453742687,2016-01-25 18:24:47,1453742812,125
5698db762fb0de2600f22e6c,1719,ORG3402 Organisasjonsatferd og ledelse,1453822951,2016-01-26 16:42:31,1453822963,12
5698db762fb0de2600f22e6c,36465,ORG3402 Organisasjonsatferd og ledelse,1453828622,2016-01-26 18:17:02,1453828683,61
5698db762fb0de2600f22e6c,17382,ORG3402 Organisasjonsatferd og ledelse,1453985978,2016-01-28 13:59:38,1453986103,125
5698db762fb0de2600f22e70,6378,ORG3402 Organisasjonsatferd og ledelse,1452959542,2016-01-16 16:52:22,1452959632,90
5698db762fb0de2600f22e70,97304,ORG3402 Organisasjonsatferd og ledelse,1452968851,2016-01-16 19:27:31,1452968852,1
5698db762fb0de2600f22e70,74949,ORG3402 Organisasjonsatferd og ledelse,1453720515,2016-01-25 12:15:15,1453720761,246
5698db762fb0de2600f22e70,58819,ORG3402 Organisasjonsatferd og ledelse,1453896043,2016-01-27 13:00:43,1453896477,434
5698db772fb0de2600f22e72,38698,ORG3402 Organisasjonsatferd og ledelse,1453113340,2016-01-18 11:35:40,1453113962,622
5698db772fb0de2600f22e72,78531,ORG3402 Organisasjonsatferd og ledelse,1453115198,2016-01-18 12:06:38,1453115327,129
5698db772fb0de2600f22e72,30776,ORG3402 Organisasjonsatferd og ledelse,1453719508,2016-01-25 11:58:28,1453719508,0
5698db7741a9d72100240d0f,55082,ORG3402 Organisasjonsatferd og ledelse,1453115773,2016-01-18 12:16:13,1453117318,1545
5698db7741a9d72100240d0f,96073,ORG3402 Organisasjonsatferd og ledelse,1453119710,2016-01-18 13:21:50,1453120814,1104
5698db782fb0de2600f22e8e,83709,ORG3402 Organisasjonsatferd og ledelse,1453116033,2016-01-18 12:20:33,1453116394,361
5698db782fb0de2600f22e8e,99688,ORG3402 Organisasjonsatferd og ledelse,1453117781,2016-01-18 12:49:41,1453117802,21
5698db782fb0de2600f22e8e,78717,ORG3402 Organisasjonsatferd og ledelse,1453122863,2016-01-18 14:14:23,1453124590,1727
5698db782fb0de2600f22e8e,56724,ORG3402 Organisasjonsatferd og ledelse,1453143251,2016-01-18 19:54:11,1453143261,10
5698db782fb0de2600f22e8e,30675,ORG3402 Organisasjonsatferd og ledelse,1453980320,2016-01-28 12:25:20,1453980354,34
5698db792fb0de2600f22e90,6992,ORG3402 Organisasjonsatferd og ledelse,1453202846,2016-01-19 12:27:26,1453202938,92
5698db792fb0de2600f22e92,93776,ORG3402 Organisasjonsatferd og ledelse,1453392135,2016-01-21 17:02:15,1453392249,114
5698db7941a9d72100240d32,11512,ORG3402 Organisasjonsatferd og ledelse,1453287589,2016-01-20 11:59:49,1453287730,141
5698db7941a9d72100240d35,27040,ORG3402 Organisasjonsatferd og ledelse,1453709911,2016-01-25 09:18:31,1453710042,131
5698db7941a9d72100240d35,79269,ORG3402 Organisasjonsatferd og ledelse,1453712427,2016-01-25 10:00:27,1453712449,22
5698db7941a9d72100240d35,16437,ORG3402 Organisasjonsatferd og ledelse,1453715298,2016-01-25 10:48:18,1453715652,354
5698db7941a9d72100240d35,5192,ORG3402 Organisasjonsatferd og ledelse,1453967474,2016-01-28 08:51:14,1453967516,42
5698db7941a9d72100240d35,57726,ORG3402 Organisasjonsatferd og ledelse,1454320012,2016-02-01 10:46:52,1454320042,30
5698db7a2fb0de2600f22e95,68345,ORG3402 Organisasjonsatferd og ledelse,1452861895,2016-01-15 13:44:55,1452862197,302
5698db7a2fb0de2600f22e95,49439,ORG3402 Organisasjonsatferd og ledelse,1452925755,2016-01-16 07:29:15,1452925756,1
5698db7a2fb0de2600f22e95,97583,ORG3402 Organisasjonsatferd og ledelse,1452970784,2016-01-16 19:59:44,1452970784,0
5698db7a2fb0de2600f22e95,76385,ORG3402 Organisasjonsatferd og ledelse,1453191385,2016-01-19 09:16:25,1453191492,107
5698db7a2fb0de2600f22e95,61374,ORG3402 Organisasjonsatferd og ledelse,1453297897,2016-01-20 14:51:37,1453297939,42
5698db7a2fb0de2600f22e95,78905,ORG3402 Organisasjonsatferd og ledelse,1453817986,2016-01-26 15:19:46,1453818001,15
5698db7a2fb0de2600f22e97,66380,ORG3402 Organisasjonsatferd og ledelse,1452862800,2016-01-15 14:00:00,1452862800,0
5698db7a2fb0de2600f22e97,30510,ORG3402 Organisasjonsatferd og ledelse,1452959826,2016-01-16 16:57:06,1452959826,0
5698db7a2fb0de2600f22e97,82131,ORG3402 Organisasjonsatferd og ledelse,1453130172,2016-01-18 16:16:12,1453131212,1040
5698db7a2fb0de2600f22e97,3805,ORG3402 Organisasjonsatferd og ledelse,1453132991,2016-01-18 17:03:11,1453132991,0
5698db7a2fb0de2600f22e97,88344,ORG3402 Organisasjonsatferd og ledelse,1453414174,2016-01-21 23:09:34,1453414175,1
5698db7a2fb0de2600f22e97,27247,ORG3402 Organisasjonsatferd og ledelse,1453658851,2016-01-24 19:07:31,1453658851,0
5698db7a2fb0de2600f22e97,59795,ORG3402 Organisasjonsatferd og ledelse,1454070181,2016-01-29 13:23:01,1454070215,34
5698db7a2fb0de2600f22e98,7047,ORG3402 Organisasjonsatferd og ledelse,1452863299,2016-01-15 14:08:19,1452864297,998
5698db7a2fb0de2600f22e98,60180,ORG3402 Organisasjonsatferd og ledelse,1452870107,2016-01-15 16:01:47,1452870120,13
5698db7a2fb0de2600f22e98,66358,ORG3402 Organisasjonsatferd og ledelse,1452872033,2016-01-15 16:33:53,1452873052,1019
5698db7a2fb0de2600f22e98,29689,ORG3402 Organisasjonsatferd og ledelse,1452951121,2016-01-16 14:32:01,1452951122,1
5698db7a2fb0de2600f22e98,35773,ORG3402 Organisasjonsatferd og ledelse,1453817660,2016-01-26 15:14:20,1453817745,85
5698db7a41a9d72100240d3a,45554,ORG3402 Organisasjonsatferd og ledelse,1452866922,2016-01-15 15:08:42,1452867077,155
5698db7a41a9d72100240d3a,25436,ORG3402 Organisasjonsatferd og ledelse,1453028797,2016-01-17 12:06:37,1453028809,12
5698db7a41a9d72100240d3a,6642,ORG3402 Organisasjonsatferd og ledelse,1453060440,2016-01-17 20:54:00,1453060511,71
5698db7a41a9d72100240d3a,67142,ORG3402 Organisasjonsatferd og ledelse,1454247952,2016-01-31 14:45:52,1454248117,165
5698db7a41a9d72100240d3c,63276,ORG3402 Organisasjonsatferd og ledelse,1453042243,2016-01-17 15:50:43,1453042303,60
5698db7a41a9d72100240d3c,47519,ORG3402 Organisasjonsatferd og ledelse,1453045648,2016-01-17 16:47:28,1453045730,82
5698db7a41a9d72100240d3c,96937,ORG3402 Organisasjonsatferd og ledelse,1453059151,2016-01-17 20:32:31,1453059169,18
5698db7a41a9d72100240d3c,25063,ORG3402 Organisasjonsatferd og ledelse,1453112243,2016-01-18 11:17:23,1453112484,241
5698db7a41a9d72100240d3c,7001,ORG3402 Organisasjonsatferd og ledelse,1453653389,2016-01-24 17:36:29,1453653504,115
5698db7a41a9d72100240d3c,61823,ORG3402 Organisasjonsatferd og ledelse,1453655411,2016-01-24 18:10:11,1453655418,7
5698db7a41a9d72100240d3c,94643,ORG3402 Organisasjonsatferd og ledelse,1453657116,2016-01-24 18:38:36,1453657142,26
5698db7b2fb0de2600f22eb6,15353,ORG3402 Organisasjonsatferd og ledelse,1453111146,2016-01-18 10:59:06,1453111261,115
5698db7b2fb0de2600f22eb6,19039,ORG3402 Organisasjonsatferd og ledelse,1453119337,2016-01-18 13:15:37,1453119338,1
5698db7b2fb0de2600f22eb6,73010,ORG3402 Organisasjonsatferd og ledelse,1453122315,2016-01-18 14:05:15,1453123018,703
5698db7b41a9d72100240d5a,81820,ORG3402 Organisasjonsatferd og ledelse,1453124945,2016-01-18 14:49:05,1453125005,60
5698db7b41a9d72100240d5a,82562,ORG3402 Organisasjonsatferd og ledelse,1453127610,2016-01-18 15:33:30,1453128402,792
5698db7b41a9d72100240d5a,11294,ORG3402 Organisasjonsatferd og ledelse,1453147580,2016-01-18 21:06:20,1453147582,2
5698db7b41a9d72100240d5a,63612,ORG3402 Organisasjonsatferd og ledelse,1453328436,2016-01-20 23:20:36,1453328436,0
5698db7c2fb0de2600f22eb7,34071,ORG3402 Organisasjonsatferd og ledelse,1453314652,2016-01-20 19:30:52,1453314743,91
5698db7c2fb0de2600f22eb8,59129,ORG3402 Organisasjonsatferd og ledelse,1453119269,2016-01-18 13:14:29,1453119403,134
5698db7c2fb0de2600f22eb8,35205,ORG3402 Organisasjonsatferd og ledelse,1453122746,2016-01-18 14:12:26,1453122746,0
5698db7c2fb0de2600f22eb8,49288,ORG3402 Organisasjonsatferd og ledelse,1453124693,2016-01-18 14:44:53,1453124712,19
5698db7c2fb0de2600f22eb8,71938,ORG3402 Organisasjonsatferd og ledelse,1453129984,2016-01-18 16:13:04,1453130263,279
5698db7c2fb0de2600f22eb8,54733,ORG3402 Organisasjonsatferd og ledelse,1453137731,2016-01-18 18:22:11,1453138390,659
5698db7c2fb0de2600f22eb8,17660,ORG3402 Organisasjonsatferd og ledelse,1453667302,2016-01-24 21:28:22,1453667389,87
5698db7c2fb0de2600f22eb8,87394,ORG3402 Organisasjonsatferd og ledelse,1453668951,2016-01-24 21:55:51,1453668967,16
5698db7c2fb0de2600f22eb8,83538,ORG3402 Organisasjonsatferd og ledelse,1453721419,2016-01-25 12:30:19,1453721443,24
5698db7c2fb0de2600f22eb9,29610,ORG3402 Organisasjonsatferd og ledelse,1453116157,2016-01-18 12:22:37,1453116570,413
5698db7c2fb0de2600f22ebb,6087,ORG3402 Organisasjonsatferd og ledelse,1452864582,2016-01-15 14:29:42,1452864623,41
5698db7c2fb0de2600f22ebb,12052,ORG3402 Organisasjonsatferd og ledelse,1453051321,2016-01-17 18:22:01,1453051471,150
5698db7c2fb0de2600f22ebb,96192,ORG3402 Organisasjonsatferd og ledelse,1453114911,2016-01-18 12:01:51,1453115003,92
5698db7c41a9d72100240d5c,28439,ORG3402 Organisasjonsatferd og ledelse,1452863108,2016-01-15 14:05:08,1452863108,0
5698db7c41a9d72100240d5c,28219,ORG3402 Organisasjonsatferd og ledelse,1452866665,2016-01-15 15:04:25,1452866667,2
5698db7c41a9d72100240d5c,85085,ORG3402 Organisasjonsatferd og ledelse,1453118210,2016-01-18 12:56:50,1453118836,626
5698db7c41a9d72100240d5c,76809,ORG3402 Organisasjonsatferd og ledelse,1453720006,2016-01-25 12:06:46,1453720108,102
5698db7c41a9d72100240d5c,31966,ORG3402 Organisasjonsatferd og ledelse,1454243312,2016-01-31 13:28:32,1454243779,467
5698db7c41a9d72100240d5c,9642,ORG3402 Organisasjonsatferd og ledelse,1454247230,2016-01-31 14:33:50,1454247528,298
5698db7d2fb0de2600f22ec2,28023,ORG3402 Organisasjonsatferd og ledelse,1453210554,2016-01-19 14:35:54,1453210975,421
5698db7d41a9d72100240d5f,35253,ORG3402 Organisasjonsatferd og ledelse,1453913938,2016-01-27 17:58:58,1453914015,77
5698db7d41a9d72100240d62,84749,ORG3402 Organisasjonsatferd og ledelse,1453720109,2016-01-25 12:08:29,1453720225,116
5698db7d41a9d72100240d62,2972,ORG3402 Organisasjonsatferd og ledelse,1453721513,2016-01-25 12:31:53,1453721572,59
5698db7d41a9d72100240d63,88225,ORG3402 Organisasjonsatferd og ledelse,1453075075,2016-01-18 00:57:55,1453075117,42
5698db7d41a9d72100240d63,49049,ORG3402 Organisasjonsatferd og ledelse,1453198750,2016-01-19 11:19:10,1453198781,31
5698db7d41a9d72100240d63,52609,ORG3402 Organisasjonsatferd og ledelse,1453670535,2016-01-24 22:22:15,1453670604,69
5698db7d41a9d72100240d63,70456,ORG3402 Organisasjonsatferd og ledelse,1453725752,2016-01-25 13:42:32,1453725780,28
5698db7e2fb0de2600f22ecb,80785,ORG3402 Organisasjonsatferd og ledelse,1453126960,2016-01-18 15:22:40,1453127080,120
5698db7e2fb0de2600f22ecb,72141,ORG3402 Organisasjonsatferd og ledelse,1453372086,2016-01-21 11:28:06,1453372099,13
5698db7e2fb0de2600f22ecb,9021,ORG3402 Organisasjonsatferd og ledelse,1453467854,2016-01-22 14:04:14,1453467999,145
5698db7e41a9d72100240d64,37277,ORG3402 Organisasjonsatferd og ledelse,1453135496,2016-01-18 17:44:56,1453135786,290
5698db7f2fb0de2600f22edd,34804,ORG3402 Organisasjonsatferd og ledelse,1453225747,2016-01-19 18:49:07,1453225833,86
5698db7f2fb0de2600f22edd,11274,ORG3402 Organisasjonsatferd og ledelse,1453661851,2016-01-24 19:57:31,1453661918,67
5698db7f2fb0de2600f22edd,68881,ORG3402 Organisasjonsatferd og ledelse,1453668689,2016-01-24 21:51:29,1453668772,83
5698db7f2fb0de2600f22edd,36352,ORG3402 Organisasjonsatferd og ledelse,1453671029,2016-01-24 22:30:29,1453671030,1
5698db7f2fb0de2600f22edf,23133,ORG3402 Organisasjonsatferd og ledelse,1453108160,2016-01-18 10:09:20,1453109333,1173
5698db7f2fb0de2600f22edf,52698,ORG3402 Organisasjonsatferd og ledelse,1453111446,2016-01-18 11:04:06,1453112748,1302
5698db7f41a9d72100240d82,70908,ORG3402 Organisasjonsatferd og ledelse,1453654037,2016-01-24 17:47:17,1453654109,72
5698db7f41a9d72100240d82,51015,ORG3402 Organisasjonsatferd og ledelse,1453657658,2016-01-24 18:47:38,1453657704,46
5698db7f41a9d72100240d82,96465,ORG3402 Organisasjonsatferd og ledelse,1453668713,2016-01-24 21:51:53,1453668714,1
5698db7f41a9d72100240d83,40923,ORG3402 Organisasjonsatferd og ledelse,1453720186,2016-01-25 12:09:46,1453720296,110
5698db7f41a9d72100240d83,3902,ORG3402 Organisasjonsatferd og ledelse,1453741145,2016-01-25 17:59:05,1453741244,99
5698db7f41a9d72100240d84,66863,ORG3402 Organisasjonsatferd og ledelse,1453119609,2016-01-18 13:20:09,1453119637,28
5698db7f41a9d72100240d84,15070,ORG3402 Organisasjonsatferd og ledelse,1453133696,2016-01-18 17:14:56,1453134125,429
5698db7f41a9d72100240d84,80754,ORG3402 Organisasjonsatferd og ledelse,1453137046,2016-01-18 18:10:46,1453137074,28
5698db7f41a9d72100240d84,18361,ORG3402 Organisasjonsatferd og ledelse,1453138381,2016-01-18 18:33:01,1453138443,62
5698db7f41a9d72100240d84,30695,ORG3402 Organisasjonsatferd og ledelse,1453148382,2016-01-18 21:19:42,1453148426,44
5698db7f41a9d72100240d86,97885,ORG3402 Organisasjonsatferd og ledelse,1453123858,2016-01-18 14:30:58,1453123920,62
5698db802fb0de2600f22eea,72727,ORG3402 Organisasjonsatferd og ledelse,1453807383,2016-01-26 12:23:03,1453807907,524
5698db802fb0de2600f22eea,65941,ORG3402 Organisasjonsatferd og ledelse,1453892677,2016-01-27 12:04:37,1453892934,257
5698db802fb0de2600f22eea,84462,ORG3402 Organisasjonsatferd og ledelse,1453900424,2016-01-27 14:13:44,1453900455,31
5698db802fb0de2600f22eea,30632,ORG3402 Organisasjonsatferd og ledelse,1454070052,2016-01-29 13:20:52,1454070063,11
5698db802fb0de2600f22ef0,53680,ORG3402 Organisasjonsatferd og ledelse,1452872864,2016-01-15 16:47:44,1452872998,134
5698db802fb0de2600f22ef0,25615,ORG3402 Organisasjonsatferd og ledelse,1453652412,2016-01-24 17:20:12,1453653604,1192
5698db802fb0de2600f22ef0,15122,ORG3402 Organisasjonsatferd og ledelse,1453661277,2016-01-24 19:47:57,1453661282,5
5698db802fb0de2600f22ef0,4821,ORG3402 Organisasjonsatferd og ledelse,1453893649,2016-01-27 12:20:49,1453894233,584
5698db802fb0de2600f22ef0,70771,ORG3402 Organisasjonsatferd og ledelse,1453899476,2016-01-27 13:57:56,1453900328,852
5698db802fb0de2600f22ef0,92297,ORG3402 Organisasjonsatferd og ledelse,1453902385,2016-01-27 14:46:25,1453902443,58
5698db8041a9d72100240d88,86591,ORG3402 Organisasjonsatferd og ledelse,1453153397,2016-01-18 22:43:17,1453153436,39
5698db8041a9d72100240d88,47931,ORG3402 Organisasjonsatferd og ledelse,1453755744,2016-01-25 22:02:24,1453755799,55
5698db8041a9d72100240d95,12782,ORG3402 Organisasjonsatferd og ledelse,1453119795,2016-01-18 13:23:15,1453119827,32
5698db8041a9d72100240d95,76987,ORG3402 Organisasjonsatferd og ledelse,1453722157,2016-01-25 12:42:37,1453723425,1268
5698db8041a9d72100240d95,50065,ORG3402 Organisasjonsatferd og ledelse,1454261872,2016-01-31 18:37:52,1454261947,75
5698db8141a9d72100240d99,28880,ORG3402 Organisasjonsatferd og ledelse,1453113539,2016-01-18 11:38:59,1453114273,734
5698db8141a9d72100240d99,81218,ORG3402 Organisasjonsatferd og ledelse,1453709816,2016-01-25 09:16:56,1453709842,26
5698db8141a9d72100240d99,71492,ORG3402 Organisasjonsatferd og ledelse,1453713442,2016-01-25 10:17:22,1453713460,18
5698db8141a9d72100240d99,2311,ORG3402 Organisasjonsatferd og ledelse,1454075281,2016-01-29 14:48:01,1454075290,9
5698db8241a9d72100240daa,11300,ORG3402 Organisasjonsatferd og ledelse,1453115097,2016-01-18 12:04:57,1453115647,550
5698db8241a9d72100240daa,9455,ORG3402 Organisasjonsatferd og ledelse,1453638986,2016-01-24 13:36:26,1453639015,29
5698db8241a9d72100240daa,67707,ORG3402 Organisasjonsatferd og ledelse,1453728725,2016-01-25 14:32:05,1453728750,25
5698db8241a9d72100240daa,91554,ORG3402 Organisasjonsatferd og ledelse,1453814967,2016-01-26 14:29:27,1453814968,1
5698db8241a9d72100240dab,67349,ORG3402 Organisasjonsatferd og ledelse,1453064095,2016-01-17 21:54:55,1453064409,314
5698db8241a9d72100240dab,99575,ORG3402 Organisasjonsatferd og ledelse,1453113880,2016-01-18 11:44:40,1453113881,1
5698db8241a9d72100240dab,17917,ORG3402 Organisasjonsatferd og ledelse,1453115148,2016-01-18 12:05:48,1453115262,114
5698db8241a9d72100240dab,54231,ORG3402 Organisasjonsatferd og ledelse,1453119266,2016-01-18 13:14:26,1453119868,602
5698db8241a9d72100240dab,61170,ORG3402 Organisasjonsatferd og ledelse,1453122751,2016-01-18 14:12:31,1453122768,17
5698db8241a9d72100240dab,68393,ORG3402 Organisasjonsatferd og ledelse,1453136603,2016-01-18 18:03:23,1453136610,7
5698db8241a9d72100240dab,18847,ORG3402 Organisasjonsatferd og ledelse,1453361653,2016-01-21 08:34:13,1453361653,0
5698db8241a9d72100240dab,19902,ORG3402 Organisasjonsatferd og ledelse,1453669684,2016-01-24 22:08:04,1453669688,4
5698db8241a9d72100240dac,8019,ORG3402 Organisasjonsatferd og ledelse,1452862775,2016-01-15 13:59:35,1452863047,272
5698db8241a9d72100240dac,48157,ORG3402 Organisasjonsatferd og ledelse,1453051085,2016-01-17 18:18:05,1453051187,102
5698db8241a9d72100240dac,7450,ORG3402 Organisasjonsatferd og ledelse,1453111099,2016-01-18 10:58:19,1453112119,1020
5698db8241a9d72100240dac,26462,ORG3402 Organisasjonsatferd og ledelse,1453982371,2016-01-28 12:59:31,1453983536,1165
5698db832fb0de2600f22f08,83298,ORG3402 Organisasjonsatferd og ledelse,1452861924,2016-01-15 13:45:24,1452862063,139
5698db832fb0de2600f22f08,68855,ORG3402 Organisasjonsatferd og ledelse,1453055475,2016-01-17 19:31:15,1453055865,390
5698db842fb0de2600f22f0b,1130,ORG3402 Organisasjonsatferd og ledelse,1453288576,2016-01-20 12:16:16,1453288730,154
5698db842fb0de2600f22f0d,8134,ORG3402 Organisasjonsatferd og ledelse,1452865175,2016-01-15 14:39:35,1452865231,56
5698db842fb0de2600f22f0d,17016,ORG3402 Organisasjonsatferd og ledelse,1453050146,2016-01-17 18:02:26,1453050286,140
5698db842fb0de2600f22f0d,98913,ORG3402 Organisasjonsatferd og ledelse,1453060234,2016-01-17 20:50:34,1453060256,22
5698db842fb0de2600f22f0d,7806,ORG3402 Organisasjonsatferd og ledelse,1453668727,2016-01-24 21:52:07,1453668761,34
5698db842fb0de2600f22f0d,86859,ORG3402 Organisasjonsatferd og ledelse,1453678548,2016-01-25 00:35:48,1453678549,1
5698db842fb0de2600f22f0d,45020,ORG3402 Organisasjonsatferd og ledelse,1453916920,2016-01-27 18:48:40,1453916955,35
5698db8441a9d72100240db2,86793,ORG3402 Organisasjonsatferd og ledelse,1453725612,2016-01-25 13:40:12,1453725703,91
5698db8441a9d72100240db2,36530,ORG3402 Organisasjonsatferd og ledelse,1453894158,2016-01-27 12:29:18,1453894500,342
5698db8441a9d72100240db2,86520,ORG3402 Organisasjonsatferd og ledelse,1453898740,2016-01-27 13:45:40,1453898965,225
5698db8441a9d72100240db6,89701,ORG3402 Organisasjonsatferd og ledelse,1453958195,2016-01-28 06:16:35,1453958532,337
5698db8441a9d72100240db6,97453,ORG3402 Organisasjonsatferd og ledelse,1454040054,2016-01-29 05:00:54,1454040112,58
5698db8441a9d72100240db6,11682,ORG3402 Organisasjonsatferd og ledelse,1454095574,2016-01-29 20:26:14,1454095575,1
5698db8441a9d72100240db8,68717,ORG3402 Organisasjonsatferd og ledelse,1453120626,2016-01-18 13:37:06,1453120685,59
5698db8441a9d72100240db8,54534,ORG3402 Organisasjonsatferd og ledelse,1453311010,2016-01-20 18:30:10,1453311650,640
5698db8441a9d72100240db8,20063,ORG3402 Organisasjonsatferd og ledelse,1454252001,2016-01-31 15:53:21,1454252234,233
5698db8441a9d72100240db9,96618,ORG3402 Organisasjonsatferd og ledelse,1453067245,2016-01-17 22:47:25,1453067803,558
5698db8441a9d72100240db9,15981,ORG3402 Organisasjonsatferd og ledelse,1453470921,2016-01-22 14:55:21,1453471244,323
5698db8441a9d72100240db9,34457,ORG3402 Organisasjonsatferd og ledelse,1453514328,2016-01-23 02:58:48,1453514330,2
5698db8441a9d72100240db9,93761,ORG3402 Organisasjonsatferd og ledelse,1453675173,2016-01-24 23:39:33,1453675416,243
5698db8441a9d72100240db9,81169,ORG3402 Organisasjonsatferd og ledelse,1453679969,2016-01-25 00:59:29,1453679972,3
5698db852fb0de2600f22f10,68102,ORG3402 Organisasjonsatferd og ledelse,1452863914,2016-01-15 14:18:34,1452863915,1
5698db852fb0de2600f22f13,79153,ORG3402 Organisasjonsatferd og ledelse,1452864060,2016-01-15 14:21:00,1452864206,146
5698db852fb0de2600f22f14,64086,ORG3402 Organisasjonsatferd og ledelse,1452941234,2016-01-16 11:47:14,1452941431,197
5698db852fb0de2600f22f14,1455,ORG3402 Organisasjonsatferd og ledelse,1453153320,2016-01-18 22:42:00,1453154426,1106
5698db852fb0de2600f22f14,2880,ORG3402 Organisasjonsatferd og ledelse,1453500778,2016-01-22 23:12:58,1453500869,91
5698db8541a9d72100240dd2,6528,ORG3402 Organisasjonsatferd og ledelse,1453469787,2016-01-22 14:36:27,1453470377,590
5698db8541a9d72100240dd2,51814,ORG3402 Organisasjonsatferd og ledelse,1453705853,2016-01-25 08:10:53,1453705986,133
5698db8541a9d72100240dd2,4229,ORG3402 Organisasjonsatferd og ledelse,1453714591,2016-01-25 10:36:31,1453714659,68
5698db8541a9d72100240dd2,21108,ORG3402 Organisasjonsatferd og ledelse,1453717108,2016-01-25 11:18:28,1453717215,107
5698db8541a9d72100240dd2,30251,ORG3402 Organisasjonsatferd og ledelse,1453719849,2016-01-25 12:04:09,1453720419,570
5698db8541a9d72100240dd2,22825,ORG3402 Organisasjonsatferd og ledelse,1454312701,2016-02-01 08:45:01,1454313044,343
5698db8541a9d72100240dd2,69074,ORG3402 Organisasjonsatferd og ledelse,1454318553,2016-02-01 10:22:33,1454318572,19
5698db862fb0de2600f22f34,66150,ORG3402 Organisasjonsatferd og ledelse,1453118043,2016-01-18 12:54:03,1453118079,36
5698db8641a9d72100240dd5,11788,ORG3402 Organisasjonsatferd og ledelse,1452866643,2016-01-15 15:04:03,1452866764,121
5698db8641a9d72100240dd5,21182,ORG3402 Organisasjonsatferd og ledelse,1452932715,2016-01-16 09:25:15,1452932716,1
5698db8641a9d72100240dd5,31456,ORG3402 Organisasjonsatferd og ledelse,1453052218,2016-01-17 18:36:58,1453052218,0
5698db8641a9d72100240dd5,7421,ORG3402 Organisasjonsatferd og ledelse,1453127469,2016-01-18 15:31:09,1453127594,125
5698db8641a9d72100240dd5,16697,ORG3402 Organisasjonsatferd og ledelse,1453670743,2016-01-24 22:25:43,1453670774,31
5698db8641a9d72100240dd7,53158,ORG3402 Organisasjonsatferd og ledelse,1453036887,2016-01-17 14:21:27,1453036887,0
5698db8641a9d72100240dd7,56430,ORG3402 Organisasjonsatferd og ledelse,1453052560,2016-01-17 18:42:40,1453052561,1
5698db8641a9d72100240dd7,15,ORG3402 Organisasjonsatferd og ledelse,1453089693,2016-01-18 05:01:33,1453089789,96
5698db8641a9d72100240dd7,56148,ORG3402 Organisasjonsatferd og ledelse,1453091010,2016-01-18 05:23:30,1453091301,291
5698db8641a9d72100240dd7,31712,ORG3402 Organisasjonsatferd og ledelse,1453130110,2016-01-18 16:15:10,1453130112,2
5698db872fb0de2600f22f3a,21230,ORG3402 Organisasjonsatferd og ledelse,1452885568,2016-01-15 20:19:28,1452886066,498
5698db872fb0de2600f22f3a,81061,ORG3402 Organisasjonsatferd og ledelse,1452944072,2016-01-16 12:34:32,1452944308,236
5698db872fb0de2600f22f3a,65714,ORG3402 Organisasjonsatferd og ledelse,1453074638,2016-01-18 00:50:38,1453074675,37
5698db872fb0de2600f22f3a,92078,ORG3402 Organisasjonsatferd og ledelse,1453114480,2016-01-18 11:54:40,1453114765,285
5698db872fb0de2600f22f3a,76408,ORG3402 Organisasjonsatferd og ledelse,1453127389,2016-01-18 15:29:49,1453127390,1
5698db872fb0de2600f22f3a,4184,ORG3402 Organisasjonsatferd og ledelse,1453719711,2016-01-25 12:01:51,1453720578,867
5698db872fb0de2600f22f3a,91765,ORG3402 Organisasjonsatferd og ledelse,1453729417,2016-01-25 14:43:37,1453729523,106
5698db872fb0de2600f22f3c,56443,ORG3402 Organisasjonsatferd og ledelse,1453651363,2016-01-24 17:02:43,1453651921,558
5698db872fb0de2600f22f3c,86125,ORG3402 Organisasjonsatferd og ledelse,1453664754,2016-01-24 20:45:54,1453664764,10
5698db872fb0de2600f22f3c,32626,ORG3402 Organisasjonsatferd og ledelse,1453669980,2016-01-24 22:13:00,1453670016,36
5698db872fb0de2600f22f3c,4529,ORG3402 Organisasjonsatferd og ledelse,1453726430,2016-01-25 13:53:50,1453726516,86
5698db8741a9d72100240dd8,58685,ORG3402 Organisasjonsatferd og ledelse,1453221555,2016-01-19 17:39:15,1453221963,408
5698db8741a9d72100240dd8,82996,ORG3402 Organisasjonsatferd og ledelse,1453471679,2016-01-22 15:07:59,1453471679,0
5698db8741a9d72100240dd8,46688,ORG3402 Organisasjonsatferd og ledelse,1453473036,2016-01-22 15:30:36,1453474087,1051
5698db8741a9d72100240dd8,37376,ORG3402 Organisasjonsatferd og ledelse,1453658779,2016-01-24 19:06:19,1453658804,25
5698db8741a9d72100240dd8,91944,ORG3402 Organisasjonsatferd og ledelse,1453844364,2016-01-26 22:39:24,1453844372,8
5698db8741a9d72100240dd9,59733,ORG3402 Organisasjonsatferd og ledelse,1453118067,2016-01-18 12:54:27,1453118894,827
5698db8741a9d72100240dd9,25001,ORG3402 Organisasjonsatferd og ledelse,1453297844,2016-01-20 14:50:44,1453297895,51
5698db8741a9d72100240dd9,18500,ORG3402 Organisasjonsatferd og ledelse,1453397654,2016-01-21 18:34:14,1453397778,124
5698db8741a9d72100240dda,75132,ORG3402 Organisasjonsatferd og ledelse,1454255070,2016-01-31 16:44:30,1454255070,0
5698db8741a9d72100240ddb,78493,ORG3402 Organisasjonsatferd og ledelse,1453036537,2016-01-17 14:15:37,1453036711,174
5698db8741a9d72100240ddb,82165,ORG3402 Organisasjonsatferd og ledelse,1453055112,2016-01-17 19:25:12,1453055118,6
5698db8741a9d72100240ddb,20693,ORG3402 Organisasjonsatferd og ledelse,1453065413,2016-01-17 22:16:53,1453065414,1
5698db8741a9d72100240ddb,79360,ORG3402 Organisasjonsatferd og ledelse,1453146638,2016-01-18 20:50:38,1453146639,1
5698db8741a9d72100240ddb,95527,ORG3402 Organisasjonsatferd og ledelse,1453677714,2016-01-25 00:21:54,1453677715,1
5698db8741a9d72100240ddb,4298,ORG3402 Organisasjonsatferd og ledelse,1454265979,2016-01-31 19:46:19,1454266003,24
5698db8741a9d72100240ddc,73747,ORG3402 Organisasjonsatferd og ledelse,1453044232,2016-01-17 16:23:52,1453045616,1384
5698db8741a9d72100240ddc,75592,ORG3402 Organisasjonsatferd og ledelse,1453046957,2016-01-17 17:09:17,1453046957,0
5698db8741a9d72100240ddc,65356,ORG3402 Organisasjonsatferd og ledelse,1453075912,2016-01-18 01:11:52,1453076179,267
5698db8741a9d72100240ddc,66780,ORG3402 Organisasjonsatferd og ledelse,1453114935,2016-01-18 12:02:15,1453115787,852
5698db8741a9d72100240ddc,42772,ORG3402 Organisasjonsatferd og ledelse,1453117474,2016-01-18 12:44:34,1453117474,0
5698db8741a9d72100240ddc,18060,ORG3402 Organisasjonsatferd og ledelse,1453118825,2016-01-18 13:07:05,1453119999,1174
5698db8741a9d72100240ddc,16034,ORG3402 Organisasjonsatferd og ledelse,1453208673,2016-01-19 14:04:33,1453208705,32
5698db8741a9d72100240ddc,62178,ORG3402 Organisasjonsatferd og ledelse,1453237223,2016-01-19 22:00:23,1453237255,32
5698db8741a9d72100240ddc,47844,ORG3402 Organisasjonsatferd og ledelse,1453459783,2016-01-22 11:49:43,1453459870,87
5698db8741a9d72100240ddc,83141,ORG3402 Organisasjonsatferd og ledelse,1453550591,2016-01-23 13:03:11,1453550591,0
5698db8741a9d72100240ddc,58627,ORG3402 Organisasjonsatferd og ledelse,1453649092,2016-01-24 16:24:52,1453649092,0
5698db8741a9d72100240ddc,95503,ORG3402 Organisasjonsatferd og ledelse,1453719606,2016-01-25 12:00:06,1453720655,1049
5698db8741a9d72100240ddc,92183,ORG3402 Organisasjonsatferd og ledelse,1453723456,2016-01-25 13:04:16,1453723953,497
5698db8741a9d72100240ddc,85993,ORG3402 Organisasjonsatferd og ledelse,1454250431,2016-01-31 15:27:11,1454250778,347
5698db882fb0de2600f22f3f,9712,ORG3402 Organisasjonsatferd og ledelse,1452871269,2016-01-15 16:21:09,1452871541,272
5698db882fb0de2600f22f3f,11391,ORG3402 Organisasjonsatferd og ledelse,1453836851,2016-01-26 20:34:11,1453837829,978
5698db882fb0de2600f22f40,80889,ORG3402 Organisasjonsatferd og ledelse,1454262529,2016-01-31 18:48:49,1454262913,384
5698db8841a9d72100240def,99191,ORG3402 Organisasjonsatferd og ledelse,1453124258,2016-01-18 14:37:38,1453124371,113
5698db8841a9d72100240def,15028,ORG3402 Organisasjonsatferd og ledelse,1453134087,2016-01-18 17:21:27,1453135872,1785
5698db8841a9d72100240def,27727,ORG3402 Organisasjonsatferd og ledelse,1453933224,2016-01-27 23:20:24,1453933263,39
5698db8841a9d72100240dfe,42198,ORG3402 Organisasjonsatferd og ledelse,1453216275,2016-01-19 16:11:15,1453216275,0
5698db8841a9d72100240dfe,16318,ORG3402 Organisasjonsatferd og ledelse,1453217554,2016-01-19 16:32:34,1453217870,316
5698db8841a9d72100240dfe,60669,ORG3402 Organisasjonsatferd og ledelse,1453219105,2016-01-19 16:58:25,1453219107,2
5698db8841a9d72100240dfe,96528,ORG3402 Organisasjonsatferd og ledelse,1453309561,2016-01-20 18:06:01,1453309570,9
5698db8841a9d72100240dfe,97164,ORG3402 Organisasjonsatferd og ledelse,1453719888,2016-01-25 12:04:48,1453720764,876
5698db8841a9d72100240dfe,33075,ORG3402 Organisasjonsatferd og ledelse,1453728217,2016-01-25 14:23:37,1453728218,1
5698db8841a9d72100240dfe,6568,ORG3402 Organisasjonsatferd og ledelse,1454274599,2016-01-31 22:09:59,1454274622,23
5698db892fb0de2600f22f57,36572,ORG3402 Organisasjonsatferd og ledelse,1453115108,2016-01-18 12:05:08,1453115344,236
5698db892fb0de2600f22f57,88487,ORG3402 Organisasjonsatferd og ledelse,1453118398,2016-01-18 12:59:58,1453118446,48
5698db892fb0de2600f22f57,60511,ORG3402 Organisasjonsatferd og ledelse,1453122696,2016-01-18 14:11:36,1453122714,18
5698db892fb0de2600f22f57,65825,ORG3402 Organisasjonsatferd og ledelse,1453719555,2016-01-25 11:59:15,1453720608,1053
5698db892fb0de2600f22f5c,47064,ORG3402 Organisasjonsatferd og ledelse,1453112757,2016-01-18 11:25:57,1453113102,345
5698db892fb0de2600f22f5c,87582,ORG3402 Organisasjonsatferd og ledelse,1453672741,2016-01-24 22:59:01,1453672741,0
5698db892fb0de2600f22f5c,62326,ORG3402 Organisasjonsatferd og ledelse,1454288185,2016-02-01 01:56:25,1454288310,125
5698db8941a9d72100240e00,59159,ORG3402 Organisasjonsatferd og ledelse,1453842636,2016-01-26 22:10:36,1453842853,217
5698db8a2fb0de2600f22f5e,89643,ORG3402 Organisasjonsatferd og ledelse,1453108073,2016-01-18 10:07:53,1453109121,1048
5698db8a2fb0de2600f22f5e,6333,ORG3402 Organisasjonsatferd og ledelse,1453111438,2016-01-18 11:03:58,1453111776,338
5698db8a2fb0de2600f22f5e,39703,ORG3402 Organisasjonsatferd og ledelse,1453710657,2016-01-25 09:30:57,1453710686,29
5698db8a2fb0de2600f22f5e,99240,ORG3402 Organisasjonsatferd og ledelse,1453713530,2016-01-25 10:18:50,1453715320,1790
5698db8a2fb0de2600f22f5f,59648,ORG3402 Organisasjonsatferd og ledelse,1453720268,2016-01-25 12:11:08,1453720398,130
5698db8a2fb0de2600f22f61,23316,ORG3402 Organisasjonsatferd og ledelse,1453898293,2016-01-27 13:38:13,1453899340,1047
5698db8a41a9d72100240e04,92973,ORG3402 Organisasjonsatferd og ledelse,1453075850,2016-01-18 01:10:50,1453075912,62
5698db8a41a9d72100240e05,24783,ORG3402 Organisasjonsatferd og ledelse,1453719980,2016-01-25 12:06:20,1453720018,38
5698db8a41a9d72100240e05,40943,ORG3402 Organisasjonsatferd og ledelse,1453725493,2016-01-25 13:38:13,1453725581,88
5698db8a41a9d72100240e06,70434,ORG3402 Organisasjonsatferd og ledelse,1453115114,2016-01-18 12:05:14,1453115941,827
5698db8a41a9d72100240e06,65614,ORG3402 Organisasjonsatferd og ledelse,1453119864,2016-01-18 13:24:24,1453120790,926
5698db8a41a9d72100240e06,72114,ORG3402 Organisasjonsatferd og ledelse,1453122379,2016-01-18 14:06:19,1453123683,1304
5698db8a41a9d72100240e06,9206,ORG3402 Organisasjonsatferd og ledelse,1453488022,2016-01-22 19:40:22,1453488038,16
5698db8a41a9d72100240e06,1753,ORG3402 Organisasjonsatferd og ledelse,1453562229,2016-01-23 16:17:09,1453562245,16
5698db8a41a9d72100240e06,24518,ORG3402 Organisasjonsatferd og ledelse,1453674793,2016-01-24 23:33:13,1453674794,1
5698db8a41a9d72100240e06,30463,ORG3402 Organisasjonsatferd og ledelse,1453679911,2016-01-25 00:58:31,1453679912,1
5698db8a41a9d72100240e06,65444,ORG3402 Organisasjonsatferd og ledelse,1453721448,2016-01-25 12:30:48,1453721520,72
5698db8a41a9d72100240e06,12320,ORG3402 Organisasjonsatferd og ledelse,1453725629,2016-01-25 13:40:29,1453725629,0
5698db8a41a9d72100240e06,32123,ORG3402 Organisasjonsatferd og ledelse,1453727390,2016-01-25 14:09:50,1453728384,994
5698db8a41a9d72100240e06,19269,ORG3402 Organisasjonsatferd og ledelse,1453758186,2016-01-25 22:43:06,1453758186,0
5698db8a41a9d72100240e06,24586,ORG3402 Organisasjonsatferd og ledelse,1453763263,2016-01-26 00:07:43,1453763283,20
5698db8b2fb0de2600f22f62,16971,ORG3402 Organisasjonsatferd og ledelse,1453878187,2016-01-27 08:03:07,1453878741,554
5698db8b2fb0de2600f22f63,2717,ORG3402 Organisasjonsatferd og ledelse,1453125564,2016-01-18 14:59:24,1453125564,0
5698db8b2fb0de2600f22f63,38273,ORG3402 Organisasjonsatferd og ledelse,1453128405,2016-01-18 15:46:45,1453128487,82
5698db8b2fb0de2600f22f63,11494,ORG3402 Organisasjonsatferd og ledelse,1453132246,2016-01-18 16:50:46,1453132253,7
5698db8b2fb0de2600f22f63,81286,ORG3402 Organisasjonsatferd og ledelse,1453141923,2016-01-18 19:32:03,1453141926,3
5698db8b2fb0de2600f22f63,65464,ORG3402 Organisasjonsatferd og ledelse,1453636400,2016-01-24 12:53:20,1453637236,836
5698db8b2fb0de2600f22f63,80509,ORG3402 Organisasjonsatferd og ledelse,1453705892,2016-01-25 08:11:32,1453705932,40
5698db8b2fb0de2600f22f63,10067,ORG3402 Organisasjonsatferd og ledelse,1453985633,2016-01-28 13:53:53,1453985638,5
5698db8b2fb0de2600f22f7e,53085,ORG3402 Organisasjonsatferd og ledelse,1453054435,2016-01-17 19:13:55,1453054618,183
5698db8b2fb0de2600f22f7e,23950,ORG3402 Organisasjonsatferd og ledelse,1453635179,2016-01-24 12:32:59,1453635260,81
5698db8b2fb0de2600f22f7e,26767,ORG3402 Organisasjonsatferd og ledelse,1453675151,2016-01-24 23:39:11,1453675161,10
5698db8b2fb0de2600f22f7e,40347,ORG3402 Organisasjonsatferd og ledelse,1453721867,2016-01-25 12:37:47,1453721896,29
5698db8b2fb0de2600f22f7e,43021,ORG3402 Organisasjonsatferd og ledelse,1453751552,2016-01-25 20:52:32,1453751553,1
5698db8b41a9d72100240e16,26418,ORG3402 Organisasjonsatferd og ledelse,1453119223,2016-01-18 13:13:43,1453119997,774
5698db8b41a9d72100240e16,51232,ORG3402 Organisasjonsatferd og ledelse,1453126748,2016-01-18 15:19:08,1453126848,100
5698db8b41a9d72100240e16,96205,ORG3402 Organisasjonsatferd og ledelse,1453137324,2016-01-18 18:15:24,1453138706,1382
5698db8b41a9d72100240e16,52881,ORG3402 Organisasjonsatferd og ledelse,1453140600,2016-01-18 19:10:00,1453140673,73
5698db8b41a9d72100240e16,15422,ORG3402 Organisasjonsatferd og ledelse,1453298902,2016-01-20 15:08:22,1453298902,0
5698db8b41a9d72100240e16,63199,ORG3402 Organisasjonsatferd og ledelse,1453300337,2016-01-20 15:32:17,1453300343,6
5698db8b41a9d72100240e16,98008,ORG3402 Organisasjonsatferd og ledelse,1453408444,2016-01-21 21:34:04,1453408445,1
5698db8b41a9d72100240e16,12339,ORG3402 Organisasjonsatferd og ledelse,1453608921,2016-01-24 05:15:21,1453608921,0
5698db8b41a9d72100240e16,79196,ORG3402 Organisasjonsatferd og ledelse,1453721285,2016-01-25 12:28:05,1453721291,6
5698db8b41a9d72100240e17,95182,ORG3402 Organisasjonsatferd og ledelse,1453586383,2016-01-23 22:59:43,1453587039,656
5698db8c41a9d72100240e26,17798,ORG3402 Organisasjonsatferd og ledelse,1453220808,2016-01-19 17:26:48,1453221009,201
5698db8c41a9d72100240e26,80463,ORG3402 Organisasjonsatferd og ledelse,1453648804,2016-01-24 16:20:04,1453648854,50
5698db8c41a9d72100240e26,4909,ORG3402 Organisasjonsatferd og ledelse,1453908610,2016-01-27 16:30:10,1453909676,1066
5698db8c41a9d72100240e26,96049,ORG3402 Organisasjonsatferd og ledelse,1453915697,2016-01-27 18:28:17,1453915701,4
5698db8c41a9d72100240e27,73917,ORG3402 Organisasjonsatferd og ledelse,1452869975,2016-01-15 15:59:35,1452870049,74
5698db8c41a9d72100240e27,23934,ORG3402 Organisasjonsatferd og ledelse,1453055322,2016-01-17 19:28:42,1453055342,20
5698db8c41a9d72100240e27,23200,ORG3402 Organisasjonsatferd og ledelse,1453119878,2016-01-18 13:24:38,1453119887,9
5698db8c41a9d72100240e27,53267,ORG3402 Organisasjonsatferd og ledelse,1453215600,2016-01-19 16:00:00,1453215631,31
5698db8d2fb0de2600f22f81,49442,ORG3402 Organisasjonsatferd og ledelse,1453832909,2016-01-26 19:28:29,1453832968,59
5698db8d2fb0de2600f22f84,98824,ORG3402 Organisasjonsatferd og ledelse,1453117736,2016-01-18 12:48:56,1453118022,286
5698db8d2fb0de2600f22f84,96081,ORG3402 Organisasjonsatferd og ledelse,1453719544,2016-01-25 11:59:04,1453720474,930
5698db8d2fb0de2600f22f84,45152,ORG3402 Organisasjonsatferd og ledelse,1453725288,2016-01-25 13:34:48,1453725295,7
5698db8d41a9d72100240e2a,21505,ORG3402 Organisasjonsatferd og ledelse,1453122245,2016-01-18 14:04:05,1453122751,506
5698db8d41a9d72100240e2a,55458,ORG3402 Organisasjonsatferd og ledelse,1453129925,2016-01-18 16:12:05,1453129987,62
5698db8d41a9d72100240e2d,34918,ORG3402 Organisasjonsatferd og ledelse,1453065100,2016-01-17 22:11:40,1453065560,460
5698db8d41a9d72100240e2d,83585,ORG3402 Organisasjonsatferd og ledelse,1453722370,2016-01-25 12:46:10,1453722393,23
5698db8d41a9d72100240e30,40456,ORG3402 Organisasjonsatferd og ledelse,1453029306,2016-01-17 12:15:06,1453029667,361
5698db8d41a9d72100240e30,75953,ORG3402 Organisasjonsatferd og ledelse,1453031618,2016-01-17 12:53:38,1453031641,23
5698db8d41a9d72100240e30,27650,ORG3402 Organisasjonsatferd og ledelse,1453033266,2016-01-17 13:21:06,1453033270,4
5698db8d41a9d72100240e30,74160,ORG3402 Organisasjonsatferd og ledelse,1453112263,2016-01-18 11:17:43,1453112363,100
5698db8d41a9d72100240e30,420,ORG3402 Organisasjonsatferd og ledelse,1453115340,2016-01-18 12:09:00,1453115940,600
5698db8d41a9d72100240e30,77053,ORG3402 Organisasjonsatferd og ledelse,1453119278,2016-01-18 13:14:38,1453119279,1
5698db8d41a9d72100240e30,12164,ORG3402 Organisasjonsatferd og ledelse,1453122772,2016-01-18 14:12:52,1453122772,0
5698db8d41a9d72100240e30,49849,ORG3402 Organisasjonsatferd og ledelse,1453639287,2016-01-24 13:41:27,1453639287,0
5698db8d41a9d72100240e30,82606,ORG3402 Organisasjonsatferd og ledelse,1453759068,2016-01-25 22:57:48,1453759083,15
5698db8d41a9d72100240e30,21159,ORG3402 Organisasjonsatferd og ledelse,1453885689,2016-01-27 10:08:09,1453885704,15
5698db8d41a9d72100240e30,45638,ORG3402 Organisasjonsatferd og ledelse,1454269683,2016-01-31 20:48:03,1454269683,0
5698db8e2fb0de2600f22f86,88326,ORG3402 Organisasjonsatferd og ledelse,1452869238,2016-01-15 15:47:18,1452869764,526
5698db8e2fb0de2600f22f86,23986,ORG3402 Organisasjonsatferd og ledelse,1453051636,2016-01-17 18:27:16,1453051675,39
5698db8e2fb0de2600f22f86,16250,ORG3402 Organisasjonsatferd og ledelse,1453058735,2016-01-17 20:25:35,1453059118,383
5698db8e2fb0de2600f22f86,31228,ORG3402 Organisasjonsatferd og ledelse,1453122825,2016-01-18 14:13:45,1453122856,31
5698db8e2fb0de2600f22f86,58041,ORG3402 Organisasjonsatferd og ledelse,1453644986,2016-01-24 15:16:26,1453646249,1263
5698db8e2fb0de2600f22f86,92624,ORG3402 Organisasjonsatferd og ledelse,1453652031,2016-01-24 17:13:51,1453652031,0
5698db8e2fb0de2600f22f86,57640,ORG3402 Organisasjonsatferd og ledelse,1453668646,2016-01-24 21:50:46,1453668659,13
5698db8e2fb0de2600f22f88,39874,ORG3402 Organisasjonsatferd og ledelse,1453041723,2016-01-17 15:42:03,1453041889,166
5698db8e2fb0de2600f22f88,49622,ORG3402 Organisasjonsatferd og ledelse,1453045840,2016-01-17 16:50:40,1453045842,2
5698db8e2fb0de2600f22f88,96851,ORG3402 Organisasjonsatferd og ledelse,1453047779,2016-01-17 17:22:59,1453047780,1
5698db8e2fb0de2600f22f88,4998,ORG3402 Organisasjonsatferd og ledelse,1453056378,2016-01-17 19:46:18,1453056378,0
5698db8e2fb0de2600f22f88,42181,ORG3402 Organisasjonsatferd og ledelse,1453060279,2016-01-17 20:51:19,1453060318,39
5698db8e2fb0de2600f22f88,61900,ORG3402 Organisasjonsatferd og ledelse,1453109572,2016-01-18 10:32:52,1453109600,28
5698db8e2fb0de2600f22f88,57495,ORG3402 Organisasjonsatferd og ledelse,1453720067,2016-01-25 12:07:47,1453720749,682
5698db8e41a9d72100240e35,47631,ORG3402 Organisasjonsatferd og ledelse,1453032590,2016-01-17 13:09:50,1453032645,55
5698db8e41a9d72100240e35,7026,ORG3402 Organisasjonsatferd og ledelse,1453898646,2016-01-27 13:44:06,1453898963,317
5698db8f2fb0de2600f22faa,91141,ORG3402 Organisasjonsatferd og ledelse,1453215587,2016-01-19 15:59:47,1453216441,854
5698db8f2fb0de2600f22faa,94821,ORG3402 Organisasjonsatferd og ledelse,1453710901,2016-01-25 09:35:01,1453710994,93
5698db8f2fb0de2600f22faa,14933,ORG3402 Organisasjonsatferd og ledelse,1453719456,2016-01-25 11:57:36,1453720739,1283
5698db8f2fb0de2600f22faa,78289,ORG3402 Organisasjonsatferd og ledelse,1453728125,2016-01-25 14:22:05,1453728125,0
5698db8f2fb0de2600f22fab,99673,ORG3402 Organisasjonsatferd og ledelse,1453066831,2016-01-17 22:40:31,1453066869,38
5698db8f2fb0de2600f22fab,84667,ORG3402 Organisasjonsatferd og ledelse,1453650696,2016-01-24 16:51:36,1453650700,4
5698db8f41a9d72100240e4e,76405,ORG3402 Organisasjonsatferd og ledelse,1453675306,2016-01-24 23:41:46,1453675469,163
5698db8f41a9d72100240e4e,11881,ORG3402 Organisasjonsatferd og ledelse,1453889574,2016-01-27 11:12:54,1453889575,1
5698db8f41a9d72100240e4f,4359,ORG3402 Organisasjonsatferd og ledelse,1453304828,2016-01-20 16:47:08,1453305094,266
5698db902fb0de2600f22fad,2099,ORG3402 Organisasjonsatferd og ledelse,1452862401,2016-01-15 13:53:21,1452862611,210
5698db902fb0de2600f22fad,74763,ORG3402 Organisasjonsatferd og ledelse,1453053809,2016-01-17 19:03:29,1453054108,299
5698db902fb0de2600f22faf,19349,ORG3402 Organisasjonsatferd og ledelse,1454320916,2016-02-01 11:01:56,1454321945,1029
5698db902fb0de2600f22fb0,28682,ORG3402 Organisasjonsatferd og ledelse,1453113010,2016-01-18 11:30:10,1453115093,2083
5698db902fb0de2600f22fb0,98398,ORG3402 Organisasjonsatferd og ledelse,1453116986,2016-01-18 12:36:26,1453117397,411
5698db902fb0de2600f22fb0,7616,ORG3402 Organisasjonsatferd og ledelse,1453320633,2016-01-20 21:10:33,1453320634,1
5698db902fb0de2600f22fb0,42897,ORG3402 Organisasjonsatferd og ledelse,1454321067,2016-02-01 11:04:27,1454321103,36
5698db9041a9d72100240e50,43204,ORG3402 Organisasjonsatferd og ledelse,1453202749,2016-01-19 12:25:49,1453203509,760
5698db9041a9d72100240e50,90232,ORG3402 Organisasjonsatferd og ledelse,1453754486,2016-01-25 21:41:26,1453754510,24
5698db9041a9d72100240e50,15013,ORG3402 Organisasjonsatferd og ledelse,1453825948,2016-01-26 17:32:28,1453825948,0
5698db9041a9d72100240e50,31488,ORG3402 Organisasjonsatferd og ledelse,1453902303,2016-01-27 14:45:03,1453902304,1
5698db9041a9d72100240e5a,20491,ORG3402 Organisasjonsatferd og ledelse,1453073196,2016-01-18 00:26:36,1453073458,262
5698db9041a9d72100240e5a,91455,ORG3402 Organisasjonsatferd og ledelse,1453232154,2016-01-19 20:35:54,1453232615,461
5698db9041a9d72100240e5a,65092,ORG3402 Organisasjonsatferd og ledelse,1453289124,2016-01-20 12:25:24,1453289124,0
5698db9041a9d72100240e5a,81773,ORG3402 Organisasjonsatferd og ledelse,1453290576,2016-01-20 12:49:36,1453290684,108
5698db9041a9d72100240e5a,39364,ORG3402 Organisasjonsatferd og ledelse,1453584353,2016-01-23 22:25:53,1453584353,0
5698db9041a9d72100240e5a,15112,ORG3402 Organisasjonsatferd og ledelse,1453758184,2016-01-25 22:43:04,1453758223,39
5698db912fb0de2600f22fb3,48535,ORG3402 Organisasjonsatferd og ledelse,1453221684,2016-01-19 17:41:24,1453222510,826
5698db912fb0de2600f22fb3,52114,ORG3402 Organisasjonsatferd og ledelse,1453728353,2016-01-25 14:25:53,1453729087,734
5698db912fb0de2600f22fb3,81092,ORG3402 Organisasjonsatferd og ledelse,1453832410,2016-01-26 19:20:10,1453832504,94
5698db912fb0de2600f22fb3,46437,ORG3402 Organisasjonsatferd og ledelse,1453897240,2016-01-27 13:20:40,1453898342,1102
5698db912fb0de2600f22fb3,49087,ORG3402 Organisasjonsatferd og ledelse,1454166747,2016-01-30 16:12:27,1454166750,3
5698db912fb0de2600f22fb4,33666,ORG3402 Organisasjonsatferd og ledelse,1453050483,2016-01-17 18:08:03,1453050516,33
5698db912fb0de2600f22fb4,21275,ORG3402 Organisasjonsatferd og ledelse,1453113618,2016-01-18 11:40:18,1453113672,54
5698db912fb0de2600f22fb4,79983,ORG3402 Organisasjonsatferd og ledelse,1453201624,2016-01-19 12:07:04,1453201629,5
5698db912fb0de2600f22fb4,5671,ORG3402 Organisasjonsatferd og ledelse,1453287852,2016-01-20 12:04:12,1453287902,50
5698db912fb0de2600f22fb4,4603,ORG3402 Organisasjonsatferd og ledelse,1453293058,2016-01-20 13:30:58,1453293101,43
5698db912fb0de2600f22fb4,4328,ORG3402 Organisasjonsatferd og ledelse,1453370491,2016-01-21 11:01:31,1453370494,3
5698db912fb0de2600f22fb4,71058,ORG3402 Organisasjonsatferd og ledelse,1453389441,2016-01-21 16:17:21,1453389897,456
5698db912fb0de2600f22fb4,62327,ORG3402 Organisasjonsatferd og ledelse,1453551264,2016-01-23 13:14:24,1453551264,0
5698db912fb0de2600f22fb4,29553,ORG3402 Organisasjonsatferd og ledelse,1453672097,2016-01-24 22:48:17,1453672107,10
5698db912fb0de2600f22fc5,34710,ORG3402 Organisasjonsatferd og ledelse,1452863561,2016-01-15 14:12:41,1452864088,527
5698db912fb0de2600f22fc5,53825,ORG3402 Organisasjonsatferd og ledelse,1453132715,2016-01-18 16:58:35,1453132774,59
5698db912fb0de2600f22fc5,75899,ORG3402 Organisasjonsatferd og ledelse,1453675762,2016-01-24 23:49:22,1453675766,4
5698db9141a9d72100240e60,1789,ORG3402 Organisasjonsatferd og ledelse,1453203657,2016-01-19 12:40:57,1453203874,217
5698db9141a9d72100240e62,11568,ORG3402 Organisasjonsatferd og ledelse,1453115361,2016-01-18 12:09:21,1453115519,158
5698db9141a9d72100240e62,61075,ORG3402 Organisasjonsatferd og ledelse,1453121861,2016-01-18 13:57:41,1453122764,903
5698db9141a9d72100240e62,4492,ORG3402 Organisasjonsatferd og ledelse,1453674772,2016-01-24 23:32:52,1453674839,67
5698db9141a9d72100240e62,31021,ORG3402 Organisasjonsatferd og ledelse,1453676241,2016-01-24 23:57:21,1453676246,5
5698db9141a9d72100240e62,80023,ORG3402 Organisasjonsatferd og ledelse,1453720475,2016-01-25 12:14:35,1453720476,1
5698db9141a9d72100240e62,53485,ORG3402 Organisasjonsatferd og ledelse,1453723802,2016-01-25 13:10:02,1453723815,13
5698db922fb0de2600f22fd6,11551,ORG3402 Organisasjonsatferd og ledelse,1452950521,2016-01-16 14:22:01,1452950568,47
5698db922fb0de2600f22fd6,21320,ORG3402 Organisasjonsatferd og ledelse,1453069544,2016-01-17 23:25:44,1453069552,8
5698db922fb0de2600f22fd6,54732,ORG3402 Organisasjonsatferd og ledelse,1453122237,2016-01-18 14:03:57,1453122296,59
5698db922fb0de2600f22fd6,85476,ORG3402 Organisasjonsatferd og ledelse,1453322463,2016-01-20 21:41:03,1453322464,1
5698db922fb0de2600f22fd6,83475,ORG3402 Organisasjonsatferd og ledelse,1453884260,2016-01-27 09:44:20,1453884267,7
5698db922fb0de2600f22fd7,16488,ORG3402 Organisasjonsatferd og ledelse,1452865394,2016-01-15 14:43:14,1452865395,1
5698db9241a9d72100240e72,83955,ORG3402 Organisasjonsatferd og ledelse,1453115142,2016-01-18 12:05:42,1453115212,70
5698db9241a9d72100240e72,15006,ORG3402 Organisasjonsatferd og ledelse,1453122920,2016-01-18 14:15:20,1453123959,1039
5698db9241a9d72100240e72,19999,ORG3402 Organisasjonsatferd og ledelse,1453719616,2016-01-25 12:00:16,1453721701,2085
5698db932fb0de2600f22fdb,33672,ORG3402 Organisasjonsatferd og ledelse,1452943813,2016-01-16 12:30:13,1452944221,408
5698db932fb0de2600f22fdb,46627,ORG3402 Organisasjonsatferd og ledelse,1453728389,2016-01-25 14:26:29,1453728445,56
5698db932fb0de2600f22fde,76768,ORG3402 Organisasjonsatferd og ledelse,1453109386,2016-01-18 10:29:46,1453110495,1109
5698db932fb0de2600f22fde,17724,ORG3402 Organisasjonsatferd og ledelse,1453111815,2016-01-18 11:10:15,1453112079,264
5698db932fb0de2600f22fde,22941,ORG3402 Organisasjonsatferd og ledelse,1453715992,2016-01-25 10:59:52,1453716060,68
5698db932fb0de2600f22fde,30219,ORG3402 Organisasjonsatferd og ledelse,1453987254,2016-01-28 14:20:54,1453987291,37
5698db9341a9d72100240e75,85309,ORG3402 Organisasjonsatferd og ledelse,1453240372,2016-01-19 22:52:52,1453240376,4
5698db9341a9d72100240e75,76045,ORG3402 Organisasjonsatferd og ledelse,1453719662,2016-01-25 12:01:02,1453719689,27
5698db9341a9d72100240e76,96454,ORG3402 Organisasjonsatferd og ledelse,1453125642,2016-01-18 15:00:42,1453125642,0
5698db9341a9d72100240e77,28310,ORG3402 Organisasjonsatferd og ledelse,1453297120,2016-01-20 14:38:40,1453297186,66
5698db9341a9d72100240e77,11669,ORG3402 Organisasjonsatferd og ledelse,1453719592,2016-01-25 11:59:52,1453720316,724
5698db9341a9d72100240e77,74425,ORG3402 Organisasjonsatferd og ledelse,1453724851,2016-01-25 13:27:31,1453724917,66
5698db9341a9d72100240e78,52314,ORG3402 Organisasjonsatferd og ledelse,1453121800,2016-01-18 13:56:40,1453122233,433
5698db9341a9d72100240e78,12656,ORG3402 Organisasjonsatferd og ledelse,1453227275,2016-01-19 19:14:35,1453228306,1031
5698db9341a9d72100240e78,17838,ORG3402 Organisasjonsatferd og ledelse,1453412024,2016-01-21 22:33:44,1453412024,0
5698db9341a9d72100240e78,92505,ORG3402 Organisasjonsatferd og ledelse,1453729220,2016-01-25 14:40:20,1453729280,60
5698db9341a9d72100240e78,40956,ORG3402 Organisasjonsatferd og ledelse,1453842332,2016-01-26 22:05:32,1453842437,105
5698db9341a9d72100240e78,4854,ORG3402 Organisasjonsatferd og ledelse,1453902382,2016-01-27 14:46:22,1453902383,1
5698db9341a9d72100240e7b,48867,ORG3402 Organisasjonsatferd og ledelse,1453115772,2016-01-18 12:16:12,1453115773,1
5698db9341a9d72100240e7b,49926,ORG3402 Organisasjonsatferd og ledelse,1453714462,2016-01-25 10:34:22,1453714827,365
5698db9341a9d72100240e7b,44943,nan,1453719257,2016-01-25 11:54:17,1453719257,0
5698db9341a9d72100240e7e,18065,ORG3402 Organisasjonsatferd og ledelse,1453839668,2016-01-26 21:21:08,1453839801,133
5698db942fb0de2600f22fe2,2400,ORG3402 Organisasjonsatferd og ledelse,1453151338,2016-01-18 22:08:58,1453151417,79
5698db942fb0de2600f22fe2,48412,ORG3402 Organisasjonsatferd og ledelse,1453714521,2016-01-25 10:35:21,1453714570,49
5698db942fb0de2600f22fe2,25044,ORG3402 Organisasjonsatferd og ledelse,1453747232,2016-01-25 19:40:32,1453747232,0
5698db942fb0de2600f22fe2,97852,ORG3402 Organisasjonsatferd og ledelse,1453905652,2016-01-27 15:40:52,1453905658,6
5698db942fb0de2600f22fe2,82729,ORG3402 Organisasjonsatferd og ledelse,1453907857,2016-01-27 16:17:37,1453908933,1076
5698db942fb0de2600f22fe3,49630,ORG3402 Organisasjonsatferd og ledelse,1453156992,2016-01-18 23:43:12,1453157263,271
5698db942fb0de2600f22fe3,92489,ORG3402 Organisasjonsatferd og ledelse,1453158983,2016-01-19 00:16:23,1453160448,1465
5698db942fb0de2600f22fe4,9616,nan,1453116050,2016-01-18 12:20:50,1453116109,59
5698db942fb0de2600f22fe4,29818,ORG3402 Organisasjonsatferd og ledelse,1453120310,2016-01-18 13:31:50,1453120412,102
5698db942fb0de2600f22fe4,2437,ORG3402 Organisasjonsatferd og ledelse,1453129845,2016-01-18 16:10:45,1453130627,782
5698db9441a9d72100240e89,81271,ORG3402 Organisasjonsatferd og ledelse,1453401042,2016-01-21 19:30:42,1453401042,0
5698db9441a9d72100240e8c,295,ORG3402 Organisasjonsatferd og ledelse,1453331657,2016-01-21 00:14:17,1453331715,58
5698db9441a9d72100240e8c,87656,ORG3402 Organisasjonsatferd og ledelse,1453726466,2016-01-25 13:54:26,1453726474,8
5698db952fb0de2600f22ff7,16767,ORG3402 Organisasjonsatferd og ledelse,1452987760,2016-01-17 00:42:40,1452987877,117
5698db952fb0de2600f22ff7,55487,ORG3402 Organisasjonsatferd og ledelse,1453115131,2016-01-18 12:05:31,1453115241,110
5698db952fb0de2600f22ff7,27297,ORG3402 Organisasjonsatferd og ledelse,1453118805,2016-01-18 13:06:45,1453118833,28
5698db952fb0de2600f22ff7,79849,ORG3402 Organisasjonsatferd og ledelse,1453120892,2016-01-18 13:41:32,1453120899,7
5698db952fb0de2600f22ff7,22420,ORG3402 Organisasjonsatferd og ledelse,1453903776,2016-01-27 15:09:36,1453903845,69
5698db952fb0de2600f22ff8,26251,ORG3402 Organisasjonsatferd og ledelse,1453806525,2016-01-26 12:08:45,1453807182,657
5698db962fb0de2600f22ffb,66563,ORG3402 Organisasjonsatferd og ledelse,1453121859,2016-01-18 13:57:39,1453122014,155
5698db962fb0de2600f22ffb,90842,ORG3402 Organisasjonsatferd og ledelse,1453674627,2016-01-24 23:30:27,1453675103,476
5698db962fb0de2600f22ffb,42119,ORG3402 Organisasjonsatferd og ledelse,1453719617,2016-01-25 12:00:17,1453720593,976
5698db962fb0de2600f22ffb,47571,ORG3402 Organisasjonsatferd og ledelse,1453992012,2016-01-28 15:40:12,1453992063,51
5698db962fb0de2600f22ffb,85847,ORG3402 Organisasjonsatferd og ledelse,1453993643,2016-01-28 16:07:23,1453993643,0
5698db962fb0de2600f22ffb,77213,ORG3402 Organisasjonsatferd og ledelse,1454271261,2016-01-31 21:14:21,1454271261,0
5698db962fb0de2600f22ffe,18964,ORG3402 Organisasjonsatferd og ledelse,1453061673,2016-01-17 21:14:33,1453061673,0
5698db962fb0de2600f22ffe,75089,ORG3402 Organisasjonsatferd og ledelse,1453070233,2016-01-17 23:37:13,1453070243,10
5698db962fb0de2600f22ffe,33407,ORG3402 Organisasjonsatferd og ledelse,1453227237,2016-01-19 19:13:57,1453227550,313
5698db962fb0de2600f22ffe,34928,ORG3402 Organisasjonsatferd og ledelse,1453237349,2016-01-19 22:02:29,1453237353,4
5698db962fb0de2600f22ffe,23930,ORG3402 Organisasjonsatferd og ledelse,1453829124,2016-01-26 18:25:24,1453829181,57
5698db962fb0de2600f23001,7724,ORG3402 Organisasjonsatferd og ledelse,1453058062,2016-01-17 20:14:22,1453058938,876
5698db962fb0de2600f23001,27917,ORG3402 Organisasjonsatferd og ledelse,1453080836,2016-01-18 02:33:56,1453080928,92
5698db962fb0de2600f23002,20329,ORG3402 Organisasjonsatferd og ledelse,1452865996,2016-01-15 14:53:16,1452866138,142
5698db962fb0de2600f23002,73438,ORG3402 Organisasjonsatferd og ledelse,1453051319,2016-01-17 18:21:59,1453051359,40
5698db962fb0de2600f23002,41158,ORG3402 Organisasjonsatferd og ledelse,1453076597,2016-01-18 01:23:17,1453076636,39
5698db962fb0de2600f23002,95851,ORG3402 Organisasjonsatferd og ledelse,1453116333,2016-01-18 12:25:33,1453116861,528
5698db962fb0de2600f23002,39029,ORG3402 Organisasjonsatferd og ledelse,1453118380,2016-01-18 12:59:40,1453118901,521
5698db962fb0de2600f23002,89514,ORG3402 Organisasjonsatferd og ledelse,1453120824,2016-01-18 13:40:24,1453120920,96
5698db962fb0de2600f23002,18990,ORG3402 Organisasjonsatferd og ledelse,1453126987,2016-01-18 15:23:07,1453127112,125
5698db962fb0de2600f23002,31991,ORG3402 Organisasjonsatferd og ledelse,1453278164,2016-01-20 09:22:44,1453278194,30
5698db962fb0de2600f23002,15297,ORG3402 Organisasjonsatferd og ledelse,1453280977,2016-01-20 10:09:37,1453280977,0
5698db962fb0de2600f23002,55095,ORG3402 Organisasjonsatferd og ledelse,1453671658,2016-01-24 22:40:58,1453671659,1
5698db962fb0de2600f23002,54657,ORG3402 Organisasjonsatferd og ledelse,1453710786,2016-01-25 09:33:06,1453710788,2
5698db9641a9d72100240ea8,27015,ORG3402 Organisasjonsatferd og ledelse,1453056068,2016-01-17 19:41:08,1453056089,21
5698db9641a9d72100240ea8,15982,ORG3402 Organisasjonsatferd og ledelse,1453115464,2016-01-18 12:11:04,1453115778,314
5698db9641a9d72100240ea8,15343,ORG3402 Organisasjonsatferd og ledelse,1453205474,2016-01-19 13:11:14,1453205522,48
5698db9641a9d72100240ea8,34070,ORG3402 Organisasjonsatferd og ledelse,1453752112,2016-01-25 21:01:52,1453752122,10
5698db9641a9d72100240ea8,85253,ORG3402 Organisasjonsatferd og ledelse,1454072614,2016-01-29 14:03:34,1454072614,0
5698db972fb0de2600f2300b,37809,ORG3402 Organisasjonsatferd og ledelse,1453900031,2016-01-27 14:07:11,1453900113,82
5698db972fb0de2600f2300b,45656,ORG3402 Organisasjonsatferd og ledelse,1453902736,2016-01-27 14:52:16,1453902749,13
5698db972fb0de2600f2300b,78441,ORG3402 Organisasjonsatferd og ledelse,1453927573,2016-01-27 21:46:13,1453927580,7
5698db972fb0de2600f2300b,81555,ORG3402 Organisasjonsatferd og ledelse,1454064767,2016-01-29 11:52:47,1454064767,0
5698db972fb0de2600f2300b,3925,ORG3402 Organisasjonsatferd og ledelse,1454073658,2016-01-29 14:20:58,1454073675,17
5698dc3741a9d72100240f97,79162,ORG3402 Organisasjonsatferd og ledelse,1453897712,2016-01-27 13:28:32,1453897910,198
5698dc3741a9d72100240f97,46343,ORG3402 Organisasjonsatferd og ledelse,1454059332,2016-01-29 10:22:12,1454059761,429
5698dc3741a9d72100240f98,66478,ORG3402 Organisasjonsatferd og ledelse,1452899239,2016-01-16 00:07:19,1452899369,130
5698dc3741a9d72100240f98,50474,ORG3402 Organisasjonsatferd og ledelse,1453143645,2016-01-18 20:00:45,1453144473,828
5698dc3741a9d72100240f98,1403,ORG3402 Organisasjonsatferd og ledelse,1453206125,2016-01-19 13:22:05,1453206126,1
5698dc3741a9d72100240f98,24258,ORG3402 Organisasjonsatferd og ledelse,1453748387,2016-01-25 19:59:47,1453748482,95
5698dc3741a9d72100240f99,3639,ORG3402 Organisasjonsatferd og ledelse,1454066221,2016-01-29 12:17:01,1454066444,223
5698dc3741a9d72100240f99,98864,ORG3402 Organisasjonsatferd og ledelse,1454070071,2016-01-29 13:21:11,1454070071,0
5698dc3741a9d72100240f9a,99756,ORG3402 Organisasjonsatferd og ledelse,1453212792,2016-01-19 15:13:12,1453212964,172
5698dc3741a9d72100240f9a,25849,ORG3402 Organisasjonsatferd og ledelse,1453297091,2016-01-20 14:38:11,1453297135,44
5698dc3741a9d72100240f9b,7467,ORG3402 Organisasjonsatferd og ledelse,1453213871,2016-01-19 15:31:11,1453215605,1734
5698dc3741a9d72100240f9b,57648,ORG3402 Organisasjonsatferd og ledelse,1453740102,2016-01-25 17:41:42,1453741354,1252
5698dc3741a9d72100240f9b,10559,ORG3402 Organisasjonsatferd og ledelse,1453759743,2016-01-25 23:09:03,1453759745,2
5698dc3741a9d72100240f9d,20374,ORG3402 Organisasjonsatferd og ledelse,1453992703,2016-01-28 15:51:43,1453992733,30
5698dc3741a9d72100240f9d,55749,ORG3402 Organisasjonsatferd og ledelse,1454258131,2016-01-31 17:35:31,1454258155,24
5698dc3741a9d72100240f9d,52812,ORG3402 Organisasjonsatferd og ledelse,1454261356,2016-01-31 18:29:16,1454261362,6
5698dc382fb0de2600f2314b,65307,ORG3402 Organisasjonsatferd og ledelse,1453288314,2016-01-20 12:11:54,1453288432,118
5698dc382fb0de2600f2314c,36713,ORG3402 Organisasjonsatferd og ledelse,1453063501,2016-01-17 21:45:01,1453063760,259
5698dc382fb0de2600f2314c,63077,ORG3402 Organisasjonsatferd og ledelse,1453145128,2016-01-18 20:25:28,1453146203,1075
5698dc382fb0de2600f2314c,44107,ORG3402 Organisasjonsatferd og ledelse,1453234916,2016-01-19 21:21:56,1453234919,3
5698dc382fb0de2600f2314d,33927,ORG3402 Organisasjonsatferd og ledelse,1454081097,2016-01-29 16:24:57,1454081272,175
5698dc382fb0de2600f23151,28763,ORG3402 Organisasjonsatferd og ledelse,1452981790,2016-01-16 23:03:10,1452982208,418
5698dc382fb0de2600f23151,30001,ORG3402 Organisasjonsatferd og ledelse,1453124492,2016-01-18 14:41:32,1453124746,254
5698dc382fb0de2600f23151,17042,ORG3402 Organisasjonsatferd og ledelse,1453127126,2016-01-18 15:25:26,1453127129,3
5698dc382fb0de2600f23152,90585,ORG3402 Organisasjonsatferd og ledelse,1453300804,2016-01-20 15:40:04,1453300865,61
5698dc382fb0de2600f23152,53800,ORG3402 Organisasjonsatferd og ledelse,1453892969,2016-01-27 12:09:29,1453893037,68
5698dc382fb0de2600f23152,3315,ORG3402 Organisasjonsatferd og ledelse,1453894933,2016-01-27 12:42:13,1453895731,798
5698dc382fb0de2600f23152,31970,ORG3402 Organisasjonsatferd og ledelse,1453901987,2016-01-27 14:39:47,1453901987,0
5698dc382fb0de2600f23152,6404,ORG3402 Organisasjonsatferd og ledelse,1453941838,2016-01-28 01:43:58,1453941840,2
5698dc382fb0de2600f23152,26858,ORG3402 Organisasjonsatferd og ledelse,1453946416,2016-01-28 03:00:16,1453946418,2
5698dc382fb0de2600f23152,72186,ORG3402 Organisasjonsatferd og ledelse,1454066143,2016-01-29 12:15:43,1454066154,11
5698dc382fb0de2600f23152,88162,ORG3402 Organisasjonsatferd og ledelse,1454070072,2016-01-29 13:21:12,1454070072,0
5698dc382fb0de2600f23152,26392,ORG3402 Organisasjonsatferd og ledelse,1454073339,2016-01-29 14:15:39,1454073596,257
5698dc382fb0de2600f23157,3608,ORG3402 Organisasjonsatferd og ledelse,1452948442,2016-01-16 13:47:22,1452948511,69
5698dc382fb0de2600f23157,10459,ORG3402 Organisasjonsatferd og ledelse,1453220196,2016-01-19 17:16:36,1453220262,66
5698dc382fb0de2600f23157,27594,ORG3402 Organisasjonsatferd og ledelse,1453230124,2016-01-19 20:02:04,1453230134,10
5698dc382fb0de2600f23157,27168,ORG3402 Organisasjonsatferd og ledelse,1453476305,2016-01-22 16:25:05,1453476439,134
5698dc382fb0de2600f23157,47620,ORG3402 Organisasjonsatferd og ledelse,1453892679,2016-01-27 12:04:39,1453893349,670
5698dc382fb0de2600f23157,33079,ORG3402 Organisasjonsatferd og ledelse,1453896439,2016-01-27 13:07:19,1453896470,31
5698dc3841a9d72100240f9f,6400,ORG3402 Organisasjonsatferd og ledelse,1453911723,2016-01-27 17:22:03,1453912442,719
5698dc392fb0de2600f23159,88073,ORG3402 Organisasjonsatferd og ledelse,1453895516,2016-01-27 12:51:56,1453895622,106
5698dc392fb0de2600f23159,30584,ORG3402 Organisasjonsatferd og ledelse,1453989385,2016-01-28 14:56:25,1453989385,0
5698dc392fb0de2600f23159,36475,ORG3402 Organisasjonsatferd og ledelse,1454026183,2016-01-29 01:09:43,1454026183,0
5698dc392fb0de2600f23159,72497,ORG3402 Organisasjonsatferd og ledelse,1454053595,2016-01-29 08:46:35,1454053595,0
5698dc392fb0de2600f23173,93960,ORG3402 Organisasjonsatferd og ledelse,1453825290,2016-01-26 17:21:30,1453825541,251
5698dc392fb0de2600f23174,68647,ORG3402 Organisasjonsatferd og ledelse,1452903550,2016-01-16 01:19:10,1452903608,58
5698dc392fb0de2600f23174,41524,ORG3402 Organisasjonsatferd og ledelse,1452905167,2016-01-16 01:46:07,1452905181,14
5698dc392fb0de2600f23174,63437,ORG3402 Organisasjonsatferd og ledelse,1452953380,2016-01-16 15:09:40,1452953400,20
5698dc392fb0de2600f23174,93604,ORG3402 Organisasjonsatferd og ledelse,1453052004,2016-01-17 18:33:24,1453052220,216
5698dc392fb0de2600f23174,35166,ORG3402 Organisasjonsatferd og ledelse,1453060599,2016-01-17 20:56:39,1453060622,23
5698dc392fb0de2600f23174,19224,ORG3402 Organisasjonsatferd og ledelse,1453063936,2016-01-17 21:52:16,1453063972,36
5698dc392fb0de2600f23174,89232,ORG3402 Organisasjonsatferd og ledelse,1453140345,2016-01-18 19:05:45,1453140362,17
5698dc392fb0de2600f23174,26678,ORG3402 Organisasjonsatferd og ledelse,1453412380,2016-01-21 22:39:40,1453412403,23
5698dc392fb0de2600f23174,52373,ORG3402 Organisasjonsatferd og ledelse,1453689106,2016-01-25 03:31:46,1453689135,29
5698dc392fb0de2600f23174,17143,ORG3402 Organisasjonsatferd og ledelse,1454087417,2016-01-29 18:10:17,1454087527,110
5698dc3a2fb0de2600f23175,6606,ORG3402 Organisasjonsatferd og ledelse,1452865820,2016-01-15 14:50:20,1452865899,79
5698dc3a2fb0de2600f23175,94292,ORG3402 Organisasjonsatferd og ledelse,1452895048,2016-01-15 22:57:28,1452895070,22
5698dc3a2fb0de2600f23175,45031,ORG3402 Organisasjonsatferd og ledelse,1452951006,2016-01-16 14:30:06,1452951007,1
5698dc3a2fb0de2600f23175,95127,ORG3402 Organisasjonsatferd og ledelse,1452953355,2016-01-16 15:09:15,1452953356,1
5698dc3a2fb0de2600f23175,24808,ORG3402 Organisasjonsatferd og ledelse,1453049990,2016-01-17 17:59:50,1453051350,1360
5698dc3a2fb0de2600f23175,81676,ORG3402 Organisasjonsatferd og ledelse,1453056893,2016-01-17 19:54:53,1453056901,8
5698dc3a2fb0de2600f23175,18710,ORG3402 Organisasjonsatferd og ledelse,1453224922,2016-01-19 18:35:22,1453226107,1185
5698dc3a2fb0de2600f23175,49191,ORG3402 Organisasjonsatferd og ledelse,1453381948,2016-01-21 14:12:28,1453381948,0
5698dc3a2fb0de2600f23175,27938,ORG3402 Organisasjonsatferd og ledelse,1453515639,2016-01-23 03:20:39,1453515639,0
5698dc3a2fb0de2600f23175,52918,ORG3402 Organisasjonsatferd og ledelse,1453668591,2016-01-24 21:49:51,1453668596,5
5698dc3a2fb0de2600f23175,31705,ORG3402 Organisasjonsatferd og ledelse,1453670930,2016-01-24 22:28:50,1453670931,1
5698dc3a2fb0de2600f23175,48677,ORG3402 Organisasjonsatferd og ledelse,1453822332,2016-01-26 16:32:12,1453822342,10
5698dc3a2fb0de2600f23175,435,ORG3402 Organisasjonsatferd og ledelse,1453892643,2016-01-27 12:04:03,1453892877,234
5698dc3a2fb0de2600f23175,28036,ORG3402 Organisasjonsatferd og ledelse,1453936339,2016-01-28 00:12:19,1453936481,142
5698dc3a2fb0de2600f23175,84136,ORG3402 Organisasjonsatferd og ledelse,1454003966,2016-01-28 18:59:26,1454003967,1
5698dc3a2fb0de2600f23175,96040,ORG3402 Organisasjonsatferd og ledelse,1454015142,2016-01-28 22:05:42,1454015186,44
5698dc3a2fb0de2600f23175,97647,ORG3402 Organisasjonsatferd og ledelse,1454065322,2016-01-29 12:02:02,1454065323,1
5698dc3a2fb0de2600f23175,39878,ORG3402 Organisasjonsatferd og ledelse,1454073997,2016-01-29 14:26:37,1454073997,0
5698dc3a2fb0de2600f23177,188,ORG3402 Organisasjonsatferd og ledelse,1453041104,2016-01-17 15:31:44,1453041138,34
5698dc3a2fb0de2600f23177,87293,ORG3402 Organisasjonsatferd og ledelse,1453058456,2016-01-17 20:20:56,1453058480,24
5698dc3a2fb0de2600f23177,39663,ORG3402 Organisasjonsatferd og ledelse,1453902447,2016-01-27 14:47:27,1453902482,35
5698dc3a41a9d72100240fc1,67588,ORG3402 Organisasjonsatferd og ledelse,1452862094,2016-01-15 13:48:14,1452862111,17
5698dc3a41a9d72100240fc1,73797,ORG3402 Organisasjonsatferd og ledelse,1453060127,2016-01-17 20:48:47,1453060223,96
5698dc3a41a9d72100240fc1,9415,ORG3402 Organisasjonsatferd og ledelse,1453804715,2016-01-26 11:38:35,1453804744,29
5698dc3a41a9d72100240fc1,92862,ORG3402 Organisasjonsatferd og ledelse,1453808413,2016-01-26 12:40:13,1453808413,0
5698dc3a41a9d72100240fc2,90808,ORG3402 Organisasjonsatferd og ledelse,1453107756,2016-01-18 10:02:36,1453107892,136
5698dc3a41a9d72100240fc2,81450,ORG3402 Organisasjonsatferd og ledelse,1453480501,2016-01-22 17:35:01,1453480501,0
5698dc3a41a9d72100240fc2,3691,ORG3402 Organisasjonsatferd og ledelse,1453556382,2016-01-23 14:39:42,1453556387,5
5698dc3a41a9d72100240fc2,50078,ORG3402 Organisasjonsatferd og ledelse,1453639548,2016-01-24 13:45:48,1453639551,3
5698dc3a41a9d72100240fc2,39095,ORG3402 Organisasjonsatferd og ledelse,1453731617,2016-01-25 15:20:17,1453731617,0
5698dc3a41a9d72100240fc2,8899,ORG3402 Organisasjonsatferd og ledelse,1453733886,2016-01-25 15:58:06,1453734300,414
5698dc3a41a9d72100240fc2,58103,ORG3402 Organisasjonsatferd og ledelse,1453738965,2016-01-25 17:22:45,1453738965,0
5698dc3a41a9d72100240fc2,1387,ORG3402 Organisasjonsatferd og ledelse,1453895950,2016-01-27 12:59:10,1453895950,0
5698dc3a41a9d72100240fc7,21990,ORG3402 Organisasjonsatferd og ledelse,1453319522,2016-01-20 20:52:02,1453319522,0
5698dc3a41a9d72100240fc7,35527,ORG3402 Organisasjonsatferd og ledelse,1453550281,2016-01-23 12:58:01,1453550293,12
5698dc3a41a9d72100240fc7,20752,ORG3402 Organisasjonsatferd og ledelse,1453749175,2016-01-25 20:12:55,1453749179,4
5698dc3a41a9d72100240fc7,39131,ORG3402 Organisasjonsatferd og ledelse,1453825130,2016-01-26 17:18:50,1453825145,15
5698dc3a41a9d72100240fc7,66799,ORG3402 Organisasjonsatferd og ledelse,1453892898,2016-01-27 12:08:18,1453892903,5
5698dc3a41a9d72100240fc7,98819,ORG3402 Organisasjonsatferd og ledelse,1454246424,2016-01-31 14:20:24,1454246446,22
5698dc3a41a9d72100240fc7,10278,ORG3402 Organisasjonsatferd og ledelse,1454248894,2016-01-31 15:01:34,1454248897,3
5698dc3a41a9d72100240fc8,7951,ORG3402 Organisasjonsatferd og ledelse,1453893189,2016-01-27 12:13:09,1453893262,73
5698dc3b2fb0de2600f2317e,55731,ORG3402 Organisasjonsatferd og ledelse,1454076570,2016-01-29 15:09:30,1454076723,153
5698dc3b2fb0de2600f2317e,9343,ORG3402 Organisasjonsatferd og ledelse,1454244134,2016-01-31 13:42:14,1454244632,498
5698dc3b41a9d72100240fca,4134,ORG3402 Organisasjonsatferd og ledelse,1452894832,2016-01-15 22:53:52,1452894849,17
5698dc3b41a9d72100240fca,22110,ORG3402 Organisasjonsatferd og ledelse,1452942844,2016-01-16 12:14:04,1452942847,3
5698dc3b41a9d72100240fca,15044,ORG3402 Organisasjonsatferd og ledelse,1453084616,2016-01-18 03:36:56,1453084616,0
5698dc3b41a9d72100240fca,42226,ORG3402 Organisasjonsatferd og ledelse,1453670364,2016-01-24 22:19:24,1453670434,70
5698dc3b41a9d72100240fcc,17776,ORG3402 Organisasjonsatferd og ledelse,1453124298,2016-01-18 14:38:18,1453124333,35
5698dc3b41a9d72100240fcc,25832,ORG3402 Organisasjonsatferd og ledelse,1453286023,2016-01-20 11:33:43,1453286088,65
5698dc3b41a9d72100240fcc,90830,ORG3402 Organisasjonsatferd og ledelse,1453739347,2016-01-25 17:29:07,1453739362,15
5698dc3b41a9d72100240fcc,59552,ORG3402 Organisasjonsatferd og ledelse,1453902843,2016-01-27 14:54:03,1453902897,54
5698dc3d2fb0de2600f2319d,49340,ORG3402 Organisasjonsatferd og ledelse,1453070335,2016-01-17 23:38:55,1453070335,0
5698dc3d2fb0de2600f2319d,7215,ORG3402 Organisasjonsatferd og ledelse,1453071830,2016-01-18 00:03:50,1453071831,1
5698dc3d2fb0de2600f2319d,3309,ORG3402 Organisasjonsatferd og ledelse,1453933876,2016-01-27 23:31:16,1453933882,6
5698dc3d2fb0de2600f2319d,36441,ORG3402 Organisasjonsatferd og ledelse,1453984596,2016-01-28 13:36:36,1453985213,617
5698dc3d2fb0de2600f231a1,53248,ORG3402 Organisasjonsatferd og ledelse,1453895094,2016-01-27 12:44:54,1453897093,1999
5698dc3d2fb0de2600f231a1,99809,ORG3402 Organisasjonsatferd og ledelse,1453924853,2016-01-27 21:00:53,1453925099,246
5698dc3d41a9d72100240fec,51914,ORG3402 Organisasjonsatferd og ledelse,1453999606,2016-01-28 17:46:46,1453999791,185
5698dc3d41a9d72100240fed,80440,ORG3402 Organisasjonsatferd og ledelse,1453924600,2016-01-27 20:56:40,1453924639,39
5698dc3d41a9d72100240fee,6231,ORG3402 Organisasjonsatferd og ledelse,1453127778,2016-01-18 15:36:18,1453127986,208
5698dc3d41a9d72100240fee,27271,ORG3402 Organisasjonsatferd og ledelse,1453141990,2016-01-18 19:33:10,1453142006,16
5698dc3d41a9d72100240fee,76109,ORG3402 Organisasjonsatferd og ledelse,1453672103,2016-01-24 22:48:23,1453672115,12
5698dc3d41a9d72100240fee,76789,ORG3402 Organisasjonsatferd og ledelse,1453913012,2016-01-27 17:43:32,1453913012,0
5698dc3d41a9d72100240fee,98872,ORG3402 Organisasjonsatferd og ledelse,1453916257,2016-01-27 18:37:37,1453916265,8
5698dc3e41a9d72100240ff0,13982,ORG3402 Organisasjonsatferd og ledelse,1453323584,2016-01-20 21:59:44,1453324192,608
5698dc3e41a9d72100240ff7,69552,ORG3402 Organisasjonsatferd og ledelse,1453288273,2016-01-20 12:11:13,1453288374,101
5698dc3f2fb0de2600f231ae,5889,ORG3402 Organisasjonsatferd og ledelse,1453215786,2016-01-19 16:03:06,1453216436,650
5698dc3f2fb0de2600f231ae,79333,ORG3402 Organisasjonsatferd og ledelse,1453838920,2016-01-26 21:08:40,1453838921,1
5698dc3f2fb0de2600f231ae,84261,ORG3402 Organisasjonsatferd og ledelse,1453986801,2016-01-28 14:13:21,1453986801,0
5698dc3f41a9d72100240ff8,58967,ORG3402 Organisasjonsatferd og ledelse,1454075908,2016-01-29 14:58:28,1454076003,95
5698dc3f41a9d72100240ff9,95505,ORG3402 Organisasjonsatferd og ledelse,1452877410,2016-01-15 18:03:30,1452877460,50
5698dc3f41a9d72100240ff9,53096,ORG3402 Organisasjonsatferd og ledelse,1453067221,2016-01-17 22:47:01,1453067268,47
5698dc3f41a9d72100240ff9,80644,ORG3402 Organisasjonsatferd og ledelse,1453130082,2016-01-18 16:14:42,1453130137,55
5698dc3f41a9d72100240ff9,86467,ORG3402 Organisasjonsatferd og ledelse,1453302969,2016-01-20 16:16:09,1453304093,1124
5698dc3f41a9d72100240ff9,79337,ORG3402 Organisasjonsatferd og ledelse,1453721721,2016-01-25 12:35:21,1453721809,88
5698dc3f41a9d72100240ffa,89798,ORG3402 Organisasjonsatferd og ledelse,1452881914,2016-01-15 19:18:34,1452882079,165
5698dc3f41a9d72100240ffa,76123,ORG3402 Organisasjonsatferd og ledelse,1452885635,2016-01-15 20:20:35,1452886811,1176
5698dc3f41a9d72100240ffa,89239,ORG3402 Organisasjonsatferd og ledelse,1453053279,2016-01-17 18:54:39,1453053322,43
5698dc3f41a9d72100240ffa,92921,ORG3402 Organisasjonsatferd og ledelse,1453142438,2016-01-18 19:40:38,1453142438,0
5698dc3f41a9d72100240ffa,91067,ORG3402 Organisasjonsatferd og ledelse,1453673013,2016-01-24 23:03:33,1453673149,136
5698dc4041a9d72100241010,71042,ORG3402 Organisasjonsatferd og ledelse,1452869495,2016-01-15 15:51:35,1452869521,26
5698dc4041a9d72100241010,49942,ORG3402 Organisasjonsatferd og ledelse,1453288248,2016-01-20 12:10:48,1453288482,234
5698dc4041a9d72100241010,84504,ORG3402 Organisasjonsatferd og ledelse,1453382423,2016-01-21 14:20:23,1453383524,1101
5698dc4041a9d72100241010,88191,ORG3402 Organisasjonsatferd og ledelse,1453505776,2016-01-23 00:36:16,1453505778,2
5698dc4041a9d72100241012,8744,ORG3402 Organisasjonsatferd og ledelse,1453740795,2016-01-25 17:53:15,1453741350,555
5698dc4041a9d72100241013,47164,ORG3402 Organisasjonsatferd og ledelse,1452862148,2016-01-15 13:49:08,1452862253,105
5698dc4041a9d72100241013,98721,ORG3402 Organisasjonsatferd og ledelse,1453036522,2016-01-17 14:15:22,1453036525,3
5698dc4041a9d72100241013,70516,ORG3402 Organisasjonsatferd og ledelse,1453051334,2016-01-17 18:22:14,1453051359,25
5698dc4041a9d72100241013,86692,ORG3402 Organisasjonsatferd og ledelse,1453053727,2016-01-17 19:02:07,1453055790,2063
5698dc4041a9d72100241013,43738,ORG3402 Organisasjonsatferd og ledelse,1453058216,2016-01-17 20:16:56,1453058543,327
5698dc4041a9d72100241013,40813,ORG3402 Organisasjonsatferd og ledelse,1453122383,2016-01-18 14:06:23,1453122500,117
5698dc4041a9d72100241013,44069,ORG3402 Organisasjonsatferd og ledelse,1453150833,2016-01-18 22:00:33,1453150863,30
5698dc4041a9d72100241013,22050,ORG3402 Organisasjonsatferd og ledelse,1453205146,2016-01-19 13:05:46,1453205148,2
5698dc4041a9d72100241013,57035,ORG3402 Organisasjonsatferd og ledelse,1453220839,2016-01-19 17:27:19,1453220839,0
5698dc4041a9d72100241013,68696,ORG3402 Organisasjonsatferd og ledelse,1453260447,2016-01-20 04:27:27,1453260447,0
5698dc4041a9d72100241013,86266,ORG3402 Organisasjonsatferd og ledelse,1453299044,2016-01-20 15:10:44,1453299046,2
5698dc4041a9d72100241013,3400,ORG3402 Organisasjonsatferd og ledelse,1453471466,2016-01-22 15:04:26,1453471467,1
5698dc4041a9d72100241013,26380,ORG3402 Organisasjonsatferd og ledelse,1453672185,2016-01-24 22:49:45,1453672309,124
5698dc4041a9d72100241013,36184,ORG3402 Organisasjonsatferd og ledelse,1453727436,2016-01-25 14:10:36,1453727438,2
5698dc4041a9d72100241013,77523,ORG3402 Organisasjonsatferd og ledelse,1453743853,2016-01-25 18:44:13,1453743858,5
5698dc4041a9d72100241013,26141,ORG3402 Organisasjonsatferd og ledelse,1453749632,2016-01-25 20:20:32,1453749642,10
5698dc4041a9d72100241013,70781,ORG3402 Organisasjonsatferd og ledelse,1453829149,2016-01-26 18:25:49,1453829161,12
5698dc4041a9d72100241013,30164,ORG3402 Organisasjonsatferd og ledelse,1454267210,2016-01-31 20:06:50,1454267215,5
5698dc412fb0de2600f231c7,55039,ORG3402 Organisasjonsatferd og ledelse,1453724530,2016-01-25 13:22:10,1453724572,42
5698dc412fb0de2600f231c8,82236,ORG3402 Organisasjonsatferd og ledelse,1452862563,2016-01-15 13:56:03,1452862585,22
5698dc412fb0de2600f231c8,48245,ORG3402 Organisasjonsatferd og ledelse,1453050022,2016-01-17 18:00:22,1453050171,149
5698dc412fb0de2600f231c8,72139,ORG3402 Organisasjonsatferd og ledelse,1453058522,2016-01-17 20:22:02,1453058522,0
5698dc412fb0de2600f231c8,78940,ORG3402 Organisasjonsatferd og ledelse,1453062502,2016-01-17 21:28:22,1453062600,98
5698dc412fb0de2600f231c8,90821,ORG3402 Organisasjonsatferd og ledelse,1453064478,2016-01-17 22:01:18,1453064492,14
5698dc412fb0de2600f231c9,98237,ORG3402 Organisasjonsatferd og ledelse,1453888277,2016-01-27 10:51:17,1453888347,70
5698dc412fb0de2600f231d4,66011,ORG3402 Organisasjonsatferd og ledelse,1453208959,2016-01-19 14:09:19,1453209013,54
5698dc412fb0de2600f231d4,59239,ORG3402 Organisasjonsatferd og ledelse,1454121264,2016-01-30 03:34:24,1454121344,80
5698dc4141a9d72100241016,91147,ORG3402 Organisasjonsatferd og ledelse,1453490976,2016-01-22 20:29:36,1453491307,331
5698dc4141a9d72100241016,84897,ORG3402 Organisasjonsatferd og ledelse,1453658757,2016-01-24 19:05:57,1453658897,140
5698dc4141a9d72100241016,53908,ORG3402 Organisasjonsatferd og ledelse,1453716638,2016-01-25 11:10:38,1453716646,8
5698dc4141a9d72100241016,69057,ORG3402 Organisasjonsatferd og ledelse,1453729631,2016-01-25 14:47:11,1453729878,247
5698dc4141a9d72100241016,20315,ORG3402 Organisasjonsatferd og ledelse,1453816561,2016-01-26 14:56:01,1453816783,222
5698dc4141a9d72100241016,47382,ORG3402 Organisasjonsatferd og ledelse,1453822751,2016-01-26 16:39:11,1453822751,0
5698dc4141a9d72100241016,36634,ORG3402 Organisasjonsatferd og ledelse,1453892657,2016-01-27 12:04:17,1453894393,1736
5698dc4141a9d72100241016,1143,ORG3402 Organisasjonsatferd og ledelse,1453896497,2016-01-27 13:08:17,1453896534,37
5698dc4141a9d72100241016,98309,ORG3402 Organisasjonsatferd og ledelse,1453900208,2016-01-27 14:10:08,1453900321,113
5698dc4141a9d72100241016,62194,ORG3402 Organisasjonsatferd og ledelse,1454065124,2016-01-29 11:58:44,1454065325,201
5698dc422fb0de2600f231d6,94619,ORG3402 Organisasjonsatferd og ledelse,1454066585,2016-01-29 12:23:05,1454066657,72
5698dc422fb0de2600f231d8,92480,ORG3402 Organisasjonsatferd og ledelse,1453058669,2016-01-17 20:24:29,1453059205,536
5698dc4241a9d72100241018,67885,ORG3402 Organisasjonsatferd og ledelse,1453299244,2016-01-20 15:14:04,1453299934,690
5698dc4241a9d7210024101b,49067,ORG3402 Organisasjonsatferd og ledelse,1453903526,2016-01-27 15:05:26,1453903540,14
5698dc4241a9d7210024101b,22668,ORG3402 Organisasjonsatferd og ledelse,1454121945,2016-01-30 03:45:45,1454121945,0
5698dc4341a9d72100241038,17342,ORG3402 Organisasjonsatferd og ledelse,1453203818,2016-01-19 12:43:38,1453203869,51
5698dc4341a9d72100241039,65617,ORG3402 Organisasjonsatferd og ledelse,1452870093,2016-01-15 16:01:33,1452870297,204
5698dc4341a9d72100241039,46742,ORG3402 Organisasjonsatferd og ledelse,1452891444,2016-01-15 21:57:24,1452891509,65
5698dc4341a9d72100241039,88678,ORG3402 Organisasjonsatferd og ledelse,1452952467,2016-01-16 14:54:27,1452952467,0
5698dc4341a9d72100241039,31573,ORG3402 Organisasjonsatferd og ledelse,1453120467,2016-01-18 13:34:27,1453121039,572
5698dc4341a9d72100241039,99217,ORG3402 Organisasjonsatferd og ledelse,1453128062,2016-01-18 15:41:02,1453128143,81
5698dc4341a9d72100241039,38078,ORG3402 Organisasjonsatferd og ledelse,1453144396,2016-01-18 20:13:16,1453144463,67
5698dc4341a9d72100241039,40392,ORG3402 Organisasjonsatferd og ledelse,1453222882,2016-01-19 18:01:22,1453222882,0
5698dc4341a9d72100241039,97205,ORG3402 Organisasjonsatferd og ledelse,1453388086,2016-01-21 15:54:46,1453388086,0
5698dc4341a9d72100241039,92073,ORG3402 Organisasjonsatferd og ledelse,1453557401,2016-01-23 14:56:41,1453557423,22
5698dc4341a9d72100241039,98533,ORG3402 Organisasjonsatferd og ledelse,1453591296,2016-01-24 00:21:36,1453591296,0
5698dc4341a9d72100241039,90578,ORG3402 Organisasjonsatferd og ledelse,1453729833,2016-01-25 14:50:33,1453730160,327
5698dc4341a9d72100241039,65588,ORG3402 Organisasjonsatferd og ledelse,1453831918,2016-01-26 19:11:58,1453831964,46
5698dc4341a9d72100241039,33619,ORG3402 Organisasjonsatferd og ledelse,1453892681,2016-01-27 12:04:41,1453893232,551
5698dc4341a9d72100241039,4596,ORG3402 Organisasjonsatferd og ledelse,1453972460,2016-01-28 10:14:20,1453972460,0
5698dc4341a9d72100241039,47770,ORG3402 Organisasjonsatferd og ledelse,1453980029,2016-01-28 12:20:29,1453980038,9
5698dc4341a9d72100241039,33907,ORG3402 Organisasjonsatferd og ledelse,1453981445,2016-01-28 12:44:05,1453981446,1
5698dc442fb0de2600f231ee,93016,ORG3402 Organisasjonsatferd og ledelse,1453827293,2016-01-26 17:54:53,1453828027,734
5698dc442fb0de2600f231ee,9695,ORG3402 Organisasjonsatferd og ledelse,1453893019,2016-01-27 12:10:19,1453893599,580
5698dc442fb0de2600f231ef,91804,ORG3402 Organisasjonsatferd og ledelse,1453905117,2016-01-27 15:31:57,1453905473,356
5698dc442fb0de2600f231f0,19106,ORG3402 Organisasjonsatferd og ledelse,1453224524,2016-01-19 18:28:44,1453224580,56
5698dc442fb0de2600f231f0,26499,ORG3402 Organisasjonsatferd og ledelse,1453247730,2016-01-20 00:55:30,1453247806,76
5698dc442fb0de2600f231f0,2632,ORG3402 Organisasjonsatferd og ledelse,1453908367,2016-01-27 16:26:07,1453908440,73
5698dc442fb0de2600f231f1,25674,ORG3402 Organisasjonsatferd og ledelse,1453299716,2016-01-20 15:21:56,1453300682,966
5698dc442fb0de2600f231f1,60569,ORG3402 Organisasjonsatferd og ledelse,1453819480,2016-01-26 15:44:40,1453819537,57
5698dc442fb0de2600f231f1,7423,ORG3402 Organisasjonsatferd og ledelse,1453832640,2016-01-26 19:24:00,1453832644,4
5698dc442fb0de2600f231fa,64585,ORG3402 Organisasjonsatferd og ledelse,1452902302,2016-01-16 00:58:22,1452902666,364
5698dc442fb0de2600f231fa,67207,ORG3402 Organisasjonsatferd og ledelse,1453709880,2016-01-25 09:18:00,1453709895,15
5698dc442fb0de2600f231fc,50391,ORG3402 Organisasjonsatferd og ledelse,1452895619,2016-01-15 23:06:59,1452895670,51
5698dc442fb0de2600f231fc,40036,ORG3402 Organisasjonsatferd og ledelse,1453130069,2016-01-18 16:14:29,1453130177,108
5698dc442fb0de2600f231fc,92866,ORG3402 Organisasjonsatferd og ledelse,1453204986,2016-01-19 13:03:06,1453204988,2
5698dc442fb0de2600f231fc,25717,ORG3402 Organisasjonsatferd og ledelse,1453741368,2016-01-25 18:02:48,1453741383,15
5698dc442fb0de2600f231fc,99767,ORG3402 Organisasjonsatferd og ledelse,1453892630,2016-01-27 12:03:50,1453892630,0
5698dc442fb0de2600f231fc,42321,ORG3402 Organisasjonsatferd og ledelse,1453899131,2016-01-27 13:52:11,1453899132,1
5698dc442fb0de2600f231fc,81161,ORG3402 Organisasjonsatferd og ledelse,1454069492,2016-01-29 13:11:32,1454070230,738
5698dc442fb0de2600f231fc,666,ORG3402 Organisasjonsatferd og ledelse,1454313835,2016-02-01 09:03:55,1454313836,1
5698dc452fb0de2600f231ff,39948,ORG3402 Organisasjonsatferd og ledelse,1452995725,2016-01-17 02:55:25,1452996155,430
5698dc452fb0de2600f231ff,7471,ORG3402 Organisasjonsatferd og ledelse,1453065890,2016-01-17 22:24:50,1453065903,13
5698dc452fb0de2600f231ff,68875,ORG3402 Organisasjonsatferd og ledelse,1453107950,2016-01-18 10:05:50,1453107953,3
5698dc452fb0de2600f231ff,79120,ORG3402 Organisasjonsatferd og ledelse,1453226086,2016-01-19 18:54:46,1453226087,1
5698dc452fb0de2600f231ff,69897,ORG3402 Organisasjonsatferd og ledelse,1453892726,2016-01-27 12:05:26,1453892968,242
5698dc452fb0de2600f231ff,88844,ORG3402 Organisasjonsatferd og ledelse,1453914039,2016-01-27 18:00:39,1453914039,0
5698dc452fb0de2600f23212,85069,ORG3402 Organisasjonsatferd og ledelse,1452866462,2016-01-15 15:01:02,1452866534,72
5698dc452fb0de2600f23212,7846,ORG3402 Organisasjonsatferd og ledelse,1453072299,2016-01-18 00:11:39,1453072392,93
5698dc452fb0de2600f23212,57553,ORG3402 Organisasjonsatferd og ledelse,1453154984,2016-01-18 23:09:44,1453155088,104
5698dc452fb0de2600f23212,96167,ORG3402 Organisasjonsatferd og ledelse,1453676609,2016-01-25 00:03:29,1453676843,234
5698dc452fb0de2600f23212,95536,ORG3402 Organisasjonsatferd og ledelse,1453728455,2016-01-25 14:27:35,1453728489,34
5698dc452fb0de2600f23212,65221,ORG3402 Organisasjonsatferd og ledelse,1453892639,2016-01-27 12:03:59,1453892642,3
5698dc452fb0de2600f23212,25413,ORG3402 Organisasjonsatferd og ledelse,1453901716,2016-01-27 14:35:16,1453901718,2
5698dc4541a9d72100241040,33857,ORG3402 Organisasjonsatferd og ledelse,1453310080,2016-01-20 18:14:40,1453311514,1434
5698dc4541a9d72100241041,30660,ORG3402 Organisasjonsatferd og ledelse,1452954190,2016-01-16 15:23:10,1452954289,99
5698dc4541a9d72100241041,26282,ORG3402 Organisasjonsatferd og ledelse,1453291468,2016-01-20 13:04:28,1453291660,192
5698dc4541a9d72100241041,69455,ORG3402 Organisasjonsatferd og ledelse,1453808259,2016-01-26 12:37:39,1453808277,18
5698dc4541a9d72100241041,82967,ORG3402 Organisasjonsatferd og ledelse,1453815974,2016-01-26 14:46:14,1453815993,19
5698dc4541a9d72100241041,82628,ORG3402 Organisasjonsatferd og ledelse,1454018614,2016-01-28 23:03:34,1454018657,43
5698dc4541a9d72100241043,7263,ORG3402 Organisasjonsatferd og ledelse,1453055583,2016-01-17 19:33:03,1453057709,2126
5698dc4541a9d72100241043,60776,ORG3402 Organisasjonsatferd og ledelse,1453060876,2016-01-17 21:01:16,1453060893,17
5698dc4541a9d72100241043,54824,ORG3402 Organisasjonsatferd og ledelse,1453127213,2016-01-18 15:26:53,1453127385,172
5698dc4541a9d72100241043,90791,ORG3402 Organisasjonsatferd og ledelse,1454015285,2016-01-28 22:08:05,1454015335,50
5698dc4541a9d72100241043,36391,ORG3402 Organisasjonsatferd og ledelse,1454249135,2016-01-31 15:05:35,1454249169,34
5698dc462fb0de2600f23215,251,ORG3402 Organisasjonsatferd og ledelse,1453141896,2016-01-18 19:31:36,1453141896,0
5698dc462fb0de2600f23215,46826,ORG3402 Organisasjonsatferd og ledelse,1453144474,2016-01-18 20:14:34,1453145062,588
5698dc462fb0de2600f23215,24595,ORG3402 Organisasjonsatferd og ledelse,1453838542,2016-01-26 21:02:22,1453839107,565
5698dc462fb0de2600f23215,51203,ORG3402 Organisasjonsatferd og ledelse,1453892551,2016-01-27 12:02:31,1453893176,625
5698dc462fb0de2600f23215,47218,ORG3402 Organisasjonsatferd og ledelse,1453900396,2016-01-27 14:13:16,1453900556,160
5698dc4641a9d72100241060,40971,ORG3402 Organisasjonsatferd og ledelse,1453892928,2016-01-27 12:08:48,1453893280,352
5698dc472fb0de2600f23219,33143,ORG3402 Organisasjonsatferd og ledelse,1452895124,2016-01-15 22:58:44,1452895592,468
5698dc472fb0de2600f23219,96910,ORG3402 Organisasjonsatferd og ledelse,1453407021,2016-01-21 21:10:21,1453407225,204
5698dc472fb0de2600f23219,79567,ORG3402 Organisasjonsatferd og ledelse,1453985523,2016-01-28 13:52:03,1453985951,428
5698dc4741a9d72100241064,55629,ORG3402 Organisasjonsatferd og ledelse,1453901915,2016-01-27 14:38:35,1453901916,1
5698dc4741a9d72100241065,43699,ORG3402 Organisasjonsatferd og ledelse,1452950403,2016-01-16 14:20:03,1452950497,94
5698dc4741a9d72100241067,95060,ORG3402 Organisasjonsatferd og ledelse,1453921087,2016-01-27 19:58:07,1453921412,325
5698dc4741a9d72100241068,46333,ORG3402 Organisasjonsatferd og ledelse,1453067619,2016-01-17 22:53:39,1453067979,360
5698dc4741a9d72100241068,4153,ORG3402 Organisasjonsatferd og ledelse,1453073405,2016-01-18 00:30:05,1453073528,123
5698dc482fb0de2600f2321e,42494,ORG3402 Organisasjonsatferd og ledelse,1453892893,2016-01-27 12:08:13,1453893314,421
5698dc482fb0de2600f2321e,76731,ORG3402 Organisasjonsatferd og ledelse,1453936464,2016-01-28 00:14:24,1453936464,0
5698dc482fb0de2600f2321f,93216,ORG3402 Organisasjonsatferd og ledelse,1453033773,2016-01-17 13:29:33,1453035035,1262
5698dc482fb0de2600f2321f,73931,ORG3402 Organisasjonsatferd og ledelse,1453378896,2016-01-21 13:21:36,1453378965,69
5698dc482fb0de2600f2321f,75895,ORG3402 Organisasjonsatferd og ledelse,1453855656,2016-01-27 01:47:36,1453855857,201
5698dc482fb0de2600f23220,43680,ORG3402 Organisasjonsatferd og ledelse,1453892815,2016-01-27 12:06:55,1453893092,277
5698dc482fb0de2600f23220,92425,ORG3402 Organisasjonsatferd og ledelse,1453907732,2016-01-27 16:15:32,1453908046,314
5698dc482fb0de2600f23220,190,ORG3402 Organisasjonsatferd og ledelse,1454098691,2016-01-29 21:18:11,1454098691,0
5698dc482fb0de2600f23220,98591,ORG3402 Organisasjonsatferd og ledelse,1454286395,2016-02-01 01:26:35,1454286395,0
5698dc482fb0de2600f23231,73293,ORG3402 Organisasjonsatferd og ledelse,1453233537,2016-01-19 20:58:57,1453233593,56
5698dc482fb0de2600f23231,97208,ORG3402 Organisasjonsatferd og ledelse,1453292049,2016-01-20 13:14:09,1453292156,107
5698dc482fb0de2600f23231,51009,ORG3402 Organisasjonsatferd og ledelse,1453892788,2016-01-27 12:06:28,1453892996,208
5698dc4841a9d72100241069,65311,ORG3402 Organisasjonsatferd og ledelse,1454065469,2016-01-29 12:04:29,1454066093,624
5698dc4841a9d72100241069,82202,ORG3402 Organisasjonsatferd og ledelse,1454073950,2016-01-29 14:25:50,1454073957,7
5698dc4841a9d7210024106a,77162,ORG3402 Organisasjonsatferd og ledelse,1453985616,2016-01-28 13:53:36,1453986404,788
5698dc492fb0de2600f2323e,42122,ORG3402 Organisasjonsatferd og ledelse,1453673184,2016-01-24 23:06:24,1453673184,0
5698dc492fb0de2600f23240,84233,ORG3402 Organisasjonsatferd og ledelse,1452862614,2016-01-15 13:56:54,1452862664,50
5698dc492fb0de2600f23240,90162,ORG3402 Organisasjonsatferd og ledelse,1452875958,2016-01-15 17:39:18,1452876166,208
5698dc492fb0de2600f23240,63573,ORG3402 Organisasjonsatferd og ledelse,1452975859,2016-01-16 21:24:19,1452976282,423
5698dc492fb0de2600f23240,41593,ORG3402 Organisasjonsatferd og ledelse,1453052753,2016-01-17 18:45:53,1453052886,133
5698dc492fb0de2600f23240,81931,ORG3402 Organisasjonsatferd og ledelse,1453149276,2016-01-18 21:34:36,1453149302,26
5698dc492fb0de2600f23240,5638,ORG3402 Organisasjonsatferd og ledelse,1453375637,2016-01-21 12:27:17,1453377709,2072
5698dc492fb0de2600f23240,76691,ORG3402 Organisasjonsatferd og ledelse,1453575642,2016-01-23 20:00:42,1453575647,5
5698dc492fb0de2600f23240,90759,ORG3402 Organisasjonsatferd og ledelse,1453675005,2016-01-24 23:36:45,1453675157,152
5698dc492fb0de2600f23240,66556,ORG3402 Organisasjonsatferd og ledelse,1453827306,2016-01-26 17:55:06,1453827385,79
5698dc492fb0de2600f23240,32451,ORG3402 Organisasjonsatferd og ledelse,1453924352,2016-01-27 20:52:32,1453924697,345
5698dc492fb0de2600f23240,57619,ORG3402 Organisasjonsatferd og ledelse,1454098423,2016-01-29 21:13:43,1454098594,171
5698dc492fb0de2600f23241,29781,ORG3402 Organisasjonsatferd og ledelse,1453280433,2016-01-20 10:00:33,1453280604,171
5698dc492fb0de2600f23241,81015,ORG3402 Organisasjonsatferd og ledelse,1453288387,2016-01-20 12:13:07,1453288390,3
5698dc492fb0de2600f23241,63118,ORG3402 Organisasjonsatferd og ledelse,1453544407,2016-01-23 11:20:07,1453544433,26
5698dc492fb0de2600f23242,48735,ORG3402 Organisasjonsatferd og ledelse,1453028399,2016-01-17 11:59:59,1453028485,86
5698dc492fb0de2600f23242,83326,ORG3402 Organisasjonsatferd og ledelse,1453054561,2016-01-17 19:16:01,1453054617,56
5698dc492fb0de2600f23242,15414,ORG3402 Organisasjonsatferd og ledelse,1453060320,2016-01-17 20:52:00,1453060321,1
5698dc492fb0de2600f23242,52415,ORG3402 Organisasjonsatferd og ledelse,1453065017,2016-01-17 22:10:17,1453065033,16
5698dc492fb0de2600f23242,68320,ORG3402 Organisasjonsatferd og ledelse,1453190239,2016-01-19 08:57:19,1453190683,444
5698dc492fb0de2600f23242,6143,ORG3402 Organisasjonsatferd og ledelse,1453196749,2016-01-19 10:45:49,1453196821,72
5698dc492fb0de2600f23242,12700,ORG3402 Organisasjonsatferd og ledelse,1453668640,2016-01-24 21:50:40,1453668671,31
5698dc4941a9d72100241088,9057,ORG3402 Organisasjonsatferd og ledelse,1453197622,2016-01-19 11:00:22,1453197661,39
5698dc4941a9d7210024108a,22870,ORG3402 Organisasjonsatferd og ledelse,1452863598,2016-01-15 14:13:18,1452864336,738
5698dc4941a9d7210024108a,43088,ORG3402 Organisasjonsatferd og ledelse,1452869333,2016-01-15 15:48:53,1452869415,82
5698dc4941a9d7210024108a,69949,ORG3402 Organisasjonsatferd og ledelse,1453068111,2016-01-17 23:01:51,1453068537,426
5698dc4941a9d7210024108a,87319,ORG3402 Organisasjonsatferd og ledelse,1453109199,2016-01-18 10:26:39,1453109293,94
5698dc4941a9d7210024108a,32989,ORG3402 Organisasjonsatferd og ledelse,1453131436,2016-01-18 16:37:16,1453131490,54
5698dc4941a9d7210024108a,28558,ORG3402 Organisasjonsatferd og ledelse,1453151924,2016-01-18 22:18:44,1453151924,0
5698dc4941a9d7210024108a,59680,ORG3402 Organisasjonsatferd og ledelse,1453288529,2016-01-20 12:15:29,1453288620,91
5698dc4941a9d7210024108a,52470,ORG3402 Organisasjonsatferd og ledelse,1453710584,2016-01-25 09:29:44,1453710591,7
5698dc4941a9d7210024108a,94910,ORG3402 Organisasjonsatferd og ledelse,1453817406,2016-01-26 15:10:06,1453818467,1061
5698dc4941a9d7210024108a,93037,ORG3402 Organisasjonsatferd og ledelse,1453884764,2016-01-27 09:52:44,1453884792,28
5698dc4941a9d7210024108a,4145,ORG3402 Organisasjonsatferd og ledelse,1453889032,2016-01-27 11:03:52,1453889152,120
5698dc4941a9d7210024108a,1935,ORG3402 Organisasjonsatferd og ledelse,1453927194,2016-01-27 21:39:54,1453927194,0
5698dc4941a9d7210024108a,66408,ORG3402 Organisasjonsatferd og ledelse,1453930291,2016-01-27 22:31:31,1453930291,0
5698dc4941a9d7210024108a,97384,ORG3402 Organisasjonsatferd og ledelse,1454102478,2016-01-29 22:21:18,1454102494,16
5698dc4941a9d7210024108a,78694,ORG3402 Organisasjonsatferd og ledelse,1454170944,2016-01-30 17:22:24,1454170979,35
5698dc4a2fb0de2600f23243,44596,ORG3402 Organisasjonsatferd og ledelse,1453124088,2016-01-18 14:34:48,1453124464,376
5698dc4a2fb0de2600f23243,40317,ORG3402 Organisasjonsatferd og ledelse,1453303822,2016-01-20 16:30:22,1453304231,409
5698dc4a2fb0de2600f23243,29213,ORG3402 Organisasjonsatferd og ledelse,1453305604,2016-01-20 17:00:04,1453305773,169
5698dc4a2fb0de2600f23243,41894,ORG3402 Organisasjonsatferd og ledelse,1453732228,2016-01-25 15:30:28,1453732915,687
5698dc4a2fb0de2600f23243,51969,ORG3402 Organisasjonsatferd og ledelse,1453746104,2016-01-25 19:21:44,1453746107,3
5698dc4a2fb0de2600f23243,13792,ORG3402 Organisasjonsatferd og ledelse,1453893019,2016-01-27 12:10:19,1453893104,85
5698dc4a2fb0de2600f23243,51430,ORG3402 Organisasjonsatferd og ledelse,1454073401,2016-01-29 14:16:41,1454073494,93
5698dc4a2fb0de2600f23246,74194,ORG3402 Organisasjonsatferd og ledelse,1453051452,2016-01-17 18:24:12,1453051579,127
5698dc4a2fb0de2600f23246,29034,ORG3402 Organisasjonsatferd og ledelse,1453216205,2016-01-19 16:10:05,1453216271,66
5698dc4a2fb0de2600f23246,61489,ORG3402 Organisasjonsatferd og ledelse,1453296049,2016-01-20 14:20:49,1453296095,46
5698dc4a2fb0de2600f23246,37887,ORG3402 Organisasjonsatferd og ledelse,1453388988,2016-01-21 16:09:48,1453388997,9
5698dc4a2fb0de2600f23246,54922,ORG3402 Organisasjonsatferd og ledelse,1453472576,2016-01-22 15:22:56,1453472585,9
5698dc4a2fb0de2600f23246,92960,ORG3402 Organisasjonsatferd og ledelse,1453662917,2016-01-24 20:15:17,1453662917,0
5698dc4a2fb0de2600f23246,13026,ORG3402 Organisasjonsatferd og ledelse,1453990303,2016-01-28 15:11:43,1453990339,36
5698dc4a41a9d7210024108d,74247,ORG3402 Organisasjonsatferd og ledelse,1452876271,2016-01-15 17:44:31,1452876514,243
5698dc4a41a9d7210024108f,12196,ORG3402 Organisasjonsatferd og ledelse,1452862682,2016-01-15 13:58:02,1452862802,120
5698dc4a41a9d7210024108f,14014,ORG3402 Organisasjonsatferd og ledelse,1453060345,2016-01-17 20:52:25,1453060382,37
5698dc4a41a9d7210024108f,34533,ORG3402 Organisasjonsatferd og ledelse,1453062016,2016-01-17 21:20:16,1453062025,9
5698dc4a41a9d7210024108f,18123,ORG3402 Organisasjonsatferd og ledelse,1453674843,2016-01-24 23:34:03,1453674867,24
5698dc4b2fb0de2600f2324c,72657,ORG3402 Organisasjonsatferd og ledelse,1453320052,2016-01-20 21:00:52,1453320156,104
5698dc4b41a9d72100241094,92746,ORG3402 Organisasjonsatferd og ledelse,1452909689,2016-01-16 03:01:29,1452909870,181
5698dc4b41a9d72100241094,89372,ORG3402 Organisasjonsatferd og ledelse,1453060333,2016-01-17 20:52:13,1453060737,404
5698dc4b41a9d72100241094,36625,ORG3402 Organisasjonsatferd og ledelse,1453062094,2016-01-17 21:21:34,1453062149,55
5698dc4b41a9d72100241094,20535,ORG3402 Organisasjonsatferd og ledelse,1453668688,2016-01-24 21:51:28,1453668694,6
5698dc4b41a9d72100241094,74492,ORG3402 Organisasjonsatferd og ledelse,1453677875,2016-01-25 00:24:35,1453677905,30
5698dc4b41a9d72100241094,66307,ORG3402 Organisasjonsatferd og ledelse,1453893928,2016-01-27 12:25:28,1453893949,21
5698dc4b41a9d72100241094,33988,ORG3402 Organisasjonsatferd og ledelse,1453900505,2016-01-27 14:15:05,1453900506,1
5698dc4c2fb0de2600f23268,15557,ORG3402 Organisasjonsatferd og ledelse,1452923175,2016-01-16 06:46:15,1452923175,0
5698dc4c2fb0de2600f23268,65745,ORG3402 Organisasjonsatferd og ledelse,1453539010,2016-01-23 09:50:10,1453539804,794
5698dc4c2fb0de2600f23268,18628,ORG3402 Organisasjonsatferd og ledelse,1453925113,2016-01-27 21:05:13,1453925171,58
5698dc4c2fb0de2600f23268,36105,ORG3402 Organisasjonsatferd og ledelse,1453991367,2016-01-28 15:29:27,1453991593,226
5698dc4c41a9d721002410b0,69159,ORG3402 Organisasjonsatferd og ledelse,1452863094,2016-01-15 14:04:54,1452863284,190
5698dc4c41a9d721002410b0,86099,ORG3402 Organisasjonsatferd og ledelse,1452896694,2016-01-15 23:24:54,1452896796,102
5698dc4c41a9d721002410b0,37684,ORG3402 Organisasjonsatferd og ledelse,1452911379,2016-01-16 03:29:39,1452911394,15
5698dc4c41a9d721002410b0,36748,ORG3402 Organisasjonsatferd og ledelse,1453063104,2016-01-17 21:38:24,1453063274,170
5698dc4c41a9d721002410b0,82711,ORG3402 Organisasjonsatferd og ledelse,1453211812,2016-01-19 14:56:52,1453211970,158
5698dc4c41a9d721002410b0,9722,ORG3402 Organisasjonsatferd og ledelse,1453840545,2016-01-26 21:35:45,1453840670,125
5698dc4c41a9d721002410b0,93684,ORG3402 Organisasjonsatferd og ledelse,1453843477,2016-01-26 22:24:37,1453844882,1405
5698dc4c41a9d721002410b0,37481,ORG3402 Organisasjonsatferd og ledelse,1453914625,2016-01-27 18:10:25,1453914625,0
5698dc4c41a9d721002410b0,10303,ORG3402 Organisasjonsatferd og ledelse,1453918950,2016-01-27 19:22:30,1453918995,45
5698dc4d2fb0de2600f2326b,75291,ORG3402 Organisasjonsatferd og ledelse,1453026051,2016-01-17 11:20:51,1453026293,242
5698dc4d2fb0de2600f2326b,41899,ORG3402 Organisasjonsatferd og ledelse,1453072261,2016-01-18 00:11:01,1453072505,244
5698dc4d2fb0de2600f2326b,75721,ORG3402 Organisasjonsatferd og ledelse,1453126714,2016-01-18 15:18:34,1453126715,1
5698dc4d2fb0de2600f2326b,36807,ORG3402 Organisasjonsatferd og ledelse,1453580757,2016-01-23 21:25:57,1453580803,46
5698dc4d2fb0de2600f2326d,28099,ORG3402 Organisasjonsatferd og ledelse,1453884949,2016-01-27 09:55:49,1453885060,111
5698dc4d2fb0de2600f2326d,24235,ORG3402 Organisasjonsatferd og ledelse,1453890244,2016-01-27 11:24:04,1453890248,4
5698dc4d2fb0de2600f23270,45466,ORG3402 Organisasjonsatferd og ledelse,1453067685,2016-01-17 22:54:45,1453067946,261
5698dc4d2fb0de2600f23270,94739,ORG3402 Organisasjonsatferd og ledelse,1454065685,2016-01-29 12:08:05,1454065706,21
5698dc4d2fb0de2600f23273,10863,ORG3402 Organisasjonsatferd og ledelse,1452876574,2016-01-15 17:49:34,1452876627,53
5698dc4d2fb0de2600f23273,89993,ORG3402 Organisasjonsatferd og ledelse,1453881379,2016-01-27 08:56:19,1453881487,108
5698dc4d2fb0de2600f23273,95114,ORG3402 Organisasjonsatferd og ledelse,1454012167,2016-01-28 21:16:07,1454012204,37
5698dc4d41a9d721002410b3,51503,ORG3402 Organisasjonsatferd og ledelse,1452882338,2016-01-15 19:25:38,1452882338,0
5698dc4d41a9d721002410b3,39571,ORG3402 Organisasjonsatferd og ledelse,1453050067,2016-01-17 18:01:07,1453050068,1
5698dc4d41a9d721002410b3,42992,ORG3402 Organisasjonsatferd og ledelse,1453053652,2016-01-17 19:00:52,1453053653,1
5698dc4d41a9d721002410b3,56355,ORG3402 Organisasjonsatferd og ledelse,1453999847,2016-01-28 17:50:47,1454000282,435
5698dc4d41a9d721002410b6,17620,ORG3402 Organisasjonsatferd og ledelse,1453826390,2016-01-26 17:39:50,1453826486,96
5698dc4d41a9d721002410b6,99177,ORG3402 Organisasjonsatferd og ledelse,1453892673,2016-01-27 12:04:33,1453893049,376
5698dc4d41a9d721002410b6,31126,ORG3402 Organisasjonsatferd og ledelse,1453920814,2016-01-27 19:53:34,1453920857,43
5698dc4d41a9d721002410b6,45343,ORG3402 Organisasjonsatferd og ledelse,1454073442,2016-01-29 14:17:22,1454073523,81
5698dc4d41a9d721002410b6,74070,ORG3402 Organisasjonsatferd og ledelse,1454153428,2016-01-30 12:30:28,1454153467,39
5698dc4d41a9d721002410b7,94658,ORG3402 Organisasjonsatferd og ledelse,1453892900,2016-01-27 12:08:20,1453892901,1
5698dc4e2fb0de2600f23276,58422,ORG3402 Organisasjonsatferd og ledelse,1453305664,2016-01-20 17:01:04,1453305762,98
5698dc4e2fb0de2600f23276,50866,ORG3402 Organisasjonsatferd og ledelse,1453811079,2016-01-26 13:24:39,1453811179,100
5698dc4e2fb0de2600f23276,32912,ORG3402 Organisasjonsatferd og ledelse,1453825552,2016-01-26 17:25:52,1453825600,48
5698dc4e2fb0de2600f23277,19971,ORG3402 Organisasjonsatferd og ledelse,1453203181,2016-01-19 12:33:01,1453203483,302
5698dc4e2fb0de2600f23277,69975,ORG3402 Organisasjonsatferd og ledelse,1453885797,2016-01-27 10:09:57,1453886048,251
5698dc4e2fb0de2600f23278,92239,ORG3402 Organisasjonsatferd og ledelse,1454068014,2016-01-29 12:46:54,1454068388,374
5698dc4e41a9d721002410b9,69834,ORG3402 Organisasjonsatferd og ledelse,1452897714,2016-01-15 23:41:54,1452897840,126
5698dc4e41a9d721002410b9,99239,ORG3402 Organisasjonsatferd og ledelse,1452900766,2016-01-16 00:32:46,1452900769,3
5698dc4e41a9d721002410b9,86258,ORG3402 Organisasjonsatferd og ledelse,1453073584,2016-01-18 00:33:04,1453073691,107
5698dc4e41a9d721002410b9,31518,ORG3402 Organisasjonsatferd og ledelse,1453196961,2016-01-19 10:49:21,1453196962,1
5698dc4e41a9d721002410b9,8037,ORG3402 Organisasjonsatferd og ledelse,1453678989,2016-01-25 00:43:09,1453679030,41
5698dc4e41a9d721002410be,94811,ORG3402 Organisasjonsatferd og ledelse,1452875526,2016-01-15 17:32:06,1452875570,44
5698dc4e41a9d721002410be,60196,ORG3402 Organisasjonsatferd og ledelse,1453064385,2016-01-17 21:59:45,1453064424,39
5698dc4e41a9d721002410be,44164,ORG3402 Organisasjonsatferd og ledelse,1453247665,2016-01-20 00:54:25,1453248016,351
5698dc4e41a9d721002410be,93417,ORG3402 Organisasjonsatferd og ledelse,1453892662,2016-01-27 12:04:22,1453893215,553
5698dc4f2fb0de2600f23290,80005,ORG3402 Organisasjonsatferd og ledelse,1453327982,2016-01-20 23:13:02,1453328016,34
5698dc4f2fb0de2600f23293,52799,ORG3402 Organisasjonsatferd og ledelse,1454106718,2016-01-29 23:31:58,1454106738,20
5698dc4f41a9d721002410d9,91616,ORG3402 Organisasjonsatferd og ledelse,1452862419,2016-01-15 13:53:39,1452862432,13
5698dc4f41a9d721002410d9,40005,ORG3402 Organisasjonsatferd og ledelse,1453050137,2016-01-17 18:02:17,1453051337,1200
5698dc4f41a9d721002410d9,80647,ORG3402 Organisasjonsatferd og ledelse,1453831307,2016-01-26 19:01:47,1453831647,340
5698dc502fb0de2600f23297,19154,ORG3402 Organisasjonsatferd og ledelse,1453294898,2016-01-20 14:01:38,1453294996,98
5698dc502fb0de2600f23297,76453,ORG3402 Organisasjonsatferd og ledelse,1453822681,2016-01-26 16:38:01,1453822701,20
5698dc502fb0de2600f23298,8830,ORG3402 Organisasjonsatferd og ledelse,1452862889,2016-01-15 14:01:29,1452862978,89
5698dc502fb0de2600f23298,54000,ORG3402 Organisasjonsatferd og ledelse,1453061187,2016-01-17 21:06:27,1453061213,26
5698dc502fb0de2600f23298,34779,ORG3402 Organisasjonsatferd og ledelse,1453152793,2016-01-18 22:33:13,1453152824,31
5698dc502fb0de2600f23298,87115,ORG3402 Organisasjonsatferd og ledelse,1453700414,2016-01-25 06:40:14,1453700500,86
5698dc5041a9d721002410df,68632,ORG3402 Organisasjonsatferd og ledelse,1453892927,2016-01-27 12:08:47,1453893580,653
5698dc5041a9d721002410df,3062,ORG3402 Organisasjonsatferd og ledelse,1453894817,2016-01-27 12:40:17,1453894818,1
5698dc5041a9d721002410df,17972,ORG3402 Organisasjonsatferd og ledelse,1453896939,2016-01-27 13:15:39,1453896977,38
5698dc5041a9d721002410df,52572,ORG3402 Organisasjonsatferd og ledelse,1453900393,2016-01-27 14:13:13,1453900511,118
5698dc5141a9d721002410e2,36102,ORG3402 Organisasjonsatferd og ledelse,1453124446,2016-01-18 14:40:46,1453125706,1260
5698dc5141a9d721002410e2,67331,ORG3402 Organisasjonsatferd og ledelse,1453308282,2016-01-20 17:44:42,1453308282,0
5698dc5141a9d721002410e2,52740,ORG3402 Organisasjonsatferd og ledelse,1453381134,2016-01-21 13:58:54,1453381171,37
5698dc5141a9d721002410e2,96506,ORG3402 Organisasjonsatferd og ledelse,1453813734,2016-01-26 14:08:54,1453813734,0
5698dc5141a9d721002410e3,66183,ORG3402 Organisasjonsatferd og ledelse,1453467643,2016-01-22 14:00:43,1453467921,278
5698dc5141a9d721002410e4,88603,ORG3402 Organisasjonsatferd og ledelse,1453892325,2016-01-27 11:58:45,1453892876,551
5698dc5141a9d721002410e4,31701,ORG3402 Organisasjonsatferd og ledelse,1453894275,2016-01-27 12:31:15,1453894288,13
5698dc5141a9d721002410e4,62625,ORG3402 Organisasjonsatferd og ledelse,1454006253,2016-01-28 19:37:33,1454006253,0
5698dc5141a9d721002410e4,59845,ORG3402 Organisasjonsatferd og ledelse,1454065932,2016-01-29 12:12:12,1454065943,11
5698dc5141a9d721002410e4,46139,ORG3402 Organisasjonsatferd og ledelse,1454074112,2016-01-29 14:28:32,1454074122,10
5698dc5241a9d72100241100,6492,ORG3402 Organisasjonsatferd og ledelse,1453745484,2016-01-25 19:11:24,1453745523,39
5698dc5241a9d72100241100,17060,ORG3402 Organisasjonsatferd og ledelse,1453899771,2016-01-27 14:02:51,1453899801,30
5698dc5241a9d72100241103,16451,ORG3402 Organisasjonsatferd og ledelse,1452866024,2016-01-15 14:53:44,1452866091,67
5698dc5241a9d72100241103,27439,ORG3402 Organisasjonsatferd og ledelse,1452870448,2016-01-15 16:07:28,1452870448,0
5698dc532fb0de2600f232bf,30610,ORG3402 Organisasjonsatferd og ledelse,1452877797,2016-01-15 18:09:57,1452878780,983
5698dc532fb0de2600f232bf,86106,ORG3402 Organisasjonsatferd og ledelse,1452881556,2016-01-15 19:12:36,1452881786,230
5698dc532fb0de2600f232bf,91686,ORG3402 Organisasjonsatferd og ledelse,1452974798,2016-01-16 21:06:38,1452975135,337
5698dc532fb0de2600f232bf,5329,ORG3402 Organisasjonsatferd og ledelse,1453050333,2016-01-17 18:05:33,1453050354,21
5698dc532fb0de2600f232bf,99514,ORG3402 Organisasjonsatferd og ledelse,1453051954,2016-01-17 18:32:34,1453051996,42
5698dc532fb0de2600f232bf,96393,ORG3402 Organisasjonsatferd og ledelse,1453060600,2016-01-17 20:56:40,1453060663,63
5698dc532fb0de2600f232bf,14186,ORG3402 Organisasjonsatferd og ledelse,1453127316,2016-01-18 15:28:36,1453127325,9
5698dc532fb0de2600f232bf,56555,ORG3402 Organisasjonsatferd og ledelse,1453670713,2016-01-24 22:25:13,1453670905,192
5698dc532fb0de2600f232bf,53484,ORG3402 Organisasjonsatferd og ledelse,1453716575,2016-01-25 11:09:35,1453717036,461
5698dc532fb0de2600f232bf,39068,ORG3402 Organisasjonsatferd og ledelse,1453719175,2016-01-25 11:52:55,1453719205,30
5698dc532fb0de2600f232bf,67572,ORG3402 Organisasjonsatferd og ledelse,1453735610,2016-01-25 16:26:50,1453735611,1
5698dc5341a9d72100241104,24410,ORG3402 Organisasjonsatferd og ledelse,1452879650,2016-01-15 18:40:50,1452879997,347
5698dc5341a9d72100241104,53506,ORG3402 Organisasjonsatferd og ledelse,1452991237,2016-01-17 01:40:37,1452991445,208
5698dc5341a9d72100241104,15868,ORG3402 Organisasjonsatferd og ledelse,1453055062,2016-01-17 19:24:22,1453055367,305
5698dc5341a9d72100241104,8960,ORG3402 Organisasjonsatferd og ledelse,1453137218,2016-01-18 18:13:38,1453137343,125
5698dc5341a9d72100241106,70598,ORG3402 Organisasjonsatferd og ledelse,1452864986,2016-01-15 14:36:26,1452864987,1
5698dc5341a9d72100241106,49957,ORG3402 Organisasjonsatferd og ledelse,1453210089,2016-01-19 14:28:09,1453210131,42
5698dc5341a9d72100241106,17018,ORG3402 Organisasjonsatferd og ledelse,1453214496,2016-01-19 15:41:36,1453214500,4
5698dc5341a9d72100241106,16909,ORG3402 Organisasjonsatferd og ledelse,1453822308,2016-01-26 16:31:48,1453822427,119
5698dc5341a9d72100241106,62007,ORG3402 Organisasjonsatferd og ledelse,1453895750,2016-01-27 12:55:50,1453896043,293
5698dc5341a9d72100241106,74518,ORG3402 Organisasjonsatferd og ledelse,1453900484,2016-01-27 14:14:44,1453900816,332
5698dc542fb0de2600f232c2,29515,ORG3402 Organisasjonsatferd og ledelse,1453212836,2016-01-19 15:13:56,1453212964,128
5698dc542fb0de2600f232c3,48305,ORG3402 Organisasjonsatferd og ledelse,1452866414,2016-01-15 15:00:14,1452866415,1
5698dc542fb0de2600f232c3,52359,ORG3402 Organisasjonsatferd og ledelse,1453148561,2016-01-18 21:22:41,1453148589,28
5698dc542fb0de2600f232c3,72058,ORG3402 Organisasjonsatferd og ledelse,1453755700,2016-01-25 22:01:40,1453755749,49
5698dc542fb0de2600f232c5,4164,ORG3402 Organisasjonsatferd og ledelse,1453525619,2016-01-23 06:06:59,1453525932,313
5698dc542fb0de2600f232c5,46889,ORG3402 Organisasjonsatferd og ledelse,1453663361,2016-01-24 20:22:41,1453663361,0
5698dc542fb0de2600f232c6,37093,ORG3402 Organisasjonsatferd og ledelse,1453316190,2016-01-20 19:56:30,1453316190,0
5698dc542fb0de2600f232c6,2631,ORG3402 Organisasjonsatferd og ledelse,1453683931,2016-01-25 02:05:31,1453683950,19
5698dc542fb0de2600f232c6,1344,ORG3402 Organisasjonsatferd og ledelse,1453909037,2016-01-27 16:37:17,1453909038,1
5698dc542fb0de2600f232c6,28908,ORG3402 Organisasjonsatferd og ledelse,1453978284,2016-01-28 11:51:24,1453978286,2
5698dc542fb0de2600f232c6,29454,ORG3402 Organisasjonsatferd og ledelse,1454014414,2016-01-28 21:53:34,1454014415,1
5698dc542fb0de2600f232c6,99559,ORG3402 Organisasjonsatferd og ledelse,1454096829,2016-01-29 20:47:09,1454096829,0
5698dc542fb0de2600f232c6,48944,ORG3402 Organisasjonsatferd og ledelse,1454123264,2016-01-30 04:07:44,1454123265,1
5698dc542fb0de2600f232c6,55306,ORG3402 Organisasjonsatferd og ledelse,1454163279,2016-01-30 15:14:39,1454163279,0
5698dc542fb0de2600f232c6,46905,ORG3402 Organisasjonsatferd og ledelse,1454248793,2016-01-31 14:59:53,1454248793,0
5698dc542fb0de2600f232c9,92066,ORG3402 Organisasjonsatferd og ledelse,1454074715,2016-01-29 14:38:35,1454074797,82
5698dc542fb0de2600f232c9,76191,ORG3402 Organisasjonsatferd og ledelse,1454076035,2016-01-29 15:00:35,1454076036,1
5698dc542fb0de2600f232cd,86966,ORG3402 Organisasjonsatferd og ledelse,1452862153,2016-01-15 13:49:13,1452862190,37
5698dc542fb0de2600f232cd,62196,ORG3402 Organisasjonsatferd og ledelse,1453050807,2016-01-17 18:13:27,1453050808,1
5698dc542fb0de2600f232cd,68849,ORG3402 Organisasjonsatferd og ledelse,1453071072,2016-01-17 23:51:12,1453071073,1
5698dc542fb0de2600f232cd,37204,ORG3402 Organisasjonsatferd og ledelse,1453134035,2016-01-18 17:20:35,1453134035,0
5698dc542fb0de2600f232cd,68531,ORG3402 Organisasjonsatferd og ledelse,1453384405,2016-01-21 14:53:25,1453384504,99
5698dc542fb0de2600f232cd,1969,ORG3402 Organisasjonsatferd og ledelse,1453672531,2016-01-24 22:55:31,1453672540,9
5698dc5441a9d7210024110a,43113,ORG3402 Organisasjonsatferd og ledelse,1453891374,2016-01-27 11:42:54,1453891669,295
5698dc5441a9d72100241118,68682,ORG3402 Organisasjonsatferd og ledelse,1453892943,2016-01-27 12:09:03,1453892943,0
5698dc5541a9d72100241124,58881,ORG3402 Organisasjonsatferd og ledelse,1452931599,2016-01-16 09:06:39,1452931628,29
5698dc5541a9d72100241124,6401,ORG3402 Organisasjonsatferd og ledelse,1452971471,2016-01-16 20:11:11,1452971489,18
5698dc5541a9d72100241124,6309,ORG3402 Organisasjonsatferd og ledelse,1453060759,2016-01-17 20:59:19,1453060981,222
5698dc5541a9d72100241124,59743,ORG3402 Organisasjonsatferd og ledelse,1453287770,2016-01-20 12:02:50,1453288161,391
5698dc5541a9d72100241124,52296,ORG3402 Organisasjonsatferd og ledelse,1453400687,2016-01-21 19:24:47,1453400687,0
5698dc5541a9d72100241124,67171,ORG3402 Organisasjonsatferd og ledelse,1453889919,2016-01-27 11:18:39,1453889944,25
5698dc5541a9d72100241124,81097,ORG3402 Organisasjonsatferd og ledelse,1453901168,2016-01-27 14:26:08,1453901175,7
5698dc5541a9d72100241124,21953,ORG3402 Organisasjonsatferd og ledelse,1454320583,2016-02-01 10:56:23,1454320922,339
5698dc5541a9d72100241127,80544,ORG3402 Organisasjonsatferd og ledelse,1452868005,2016-01-15 15:26:45,1452868005,0
5698dc5541a9d72100241127,516,ORG3402 Organisasjonsatferd og ledelse,1452870447,2016-01-15 16:07:27,1452870449,2
5698dc5541a9d72100241127,31295,ORG3402 Organisasjonsatferd og ledelse,1452876851,2016-01-15 17:54:11,1452876915,64
5698dc5541a9d72100241127,71904,ORG3402 Organisasjonsatferd og ledelse,1452890238,2016-01-15 21:37:18,1452890241,3
5698dc5541a9d72100241127,85774,ORG3402 Organisasjonsatferd og ledelse,1453037183,2016-01-17 14:26:23,1453037206,23
5698dc5541a9d72100241127,22546,ORG3402 Organisasjonsatferd og ledelse,1453055775,2016-01-17 19:36:15,1453055798,23
5698dc5541a9d72100241127,4628,ORG3402 Organisasjonsatferd og ledelse,1453061542,2016-01-17 21:12:22,1453061614,72
5698dc5541a9d72100241127,56933,ORG3402 Organisasjonsatferd og ledelse,1453450866,2016-01-22 09:21:06,1453450940,74
5698dc5541a9d72100241127,51595,ORG3402 Organisasjonsatferd og ledelse,1453668882,2016-01-24 21:54:42,1453668884,2
5698dc5541a9d72100241127,62187,ORG3402 Organisasjonsatferd og ledelse,1453892762,2016-01-27 12:06:02,1453892885,123
5698dc5541a9d72100241127,69920,ORG3402 Organisasjonsatferd og ledelse,1453896886,2016-01-27 13:14:46,1453897010,124
5698dc5541a9d72100241127,69068,ORG3402 Organisasjonsatferd og ledelse,1453899114,2016-01-27 13:51:54,1453899114,0
5698dc5541a9d72100241127,93236,ORG3402 Organisasjonsatferd og ledelse,1454058457,2016-01-29 10:07:37,1454058523,66
5698dc5541a9d72100241128,73757,ORG3402 Organisasjonsatferd og ledelse,1452862175,2016-01-15 13:49:35,1452862175,0
5698dc562fb0de2600f232ec,13445,ORG3402 Organisasjonsatferd og ledelse,1452892835,2016-01-15 22:20:35,1452893775,940
5698dc562fb0de2600f232ec,30618,ORG3402 Organisasjonsatferd og ledelse,1453074786,2016-01-18 00:53:06,1453074855,69
5698dc562fb0de2600f232ec,56549,ORG3402 Organisasjonsatferd og ledelse,1453311574,2016-01-20 18:39:34,1453311588,14
5698dc562fb0de2600f232ec,24606,ORG3402 Organisasjonsatferd og ledelse,1453674070,2016-01-24 23:21:10,1453674078,8
5698dc562fb0de2600f232ec,37004,ORG3402 Organisasjonsatferd og ledelse,1454065670,2016-01-29 12:07:50,1454066145,475
5698dc572fb0de2600f232ef,14237,ORG3402 Organisasjonsatferd og ledelse,1453905298,2016-01-27 15:34:58,1453906418,1120
5698dc572fb0de2600f232f6,80309,ORG3402 Organisasjonsatferd og ledelse,1453817153,2016-01-26 15:05:53,1453817600,447
5698dc572fb0de2600f232f6,90744,ORG3402 Organisasjonsatferd og ledelse,1453823100,2016-01-26 16:45:00,1453823105,5
5698dc572fb0de2600f232f6,83472,ORG3402 Organisasjonsatferd og ledelse,1454195586,2016-01-31 00:13:06,1454195587,1
5698dc5741a9d7210024112b,89072,ORG3402 Organisasjonsatferd og ledelse,1453125559,2016-01-18 14:59:19,1453125665,106
5698dc5741a9d7210024112b,61284,ORG3402 Organisasjonsatferd og ledelse,1453129169,2016-01-18 15:59:29,1453129169,0
5698dc5741a9d7210024112b,22395,ORG3402 Organisasjonsatferd og ledelse,1453551316,2016-01-23 13:15:16,1453551336,20
5698dc5741a9d7210024112b,73241,ORG3402 Organisasjonsatferd og ledelse,1453553465,2016-01-23 13:51:05,1453553471,6
5698dc5741a9d7210024112b,90199,ORG3402 Organisasjonsatferd og ledelse,1453669184,2016-01-24 21:59:44,1453669185,1
5698dc5741a9d7210024112b,58944,ORG3402 Organisasjonsatferd og ledelse,1453734851,2016-01-25 16:14:11,1453734902,51
5698dc5741a9d7210024112b,71678,ORG3402 Organisasjonsatferd og ledelse,1453892365,2016-01-27 11:59:25,1453893134,769
5698dc5741a9d7210024112b,95969,ORG3402 Organisasjonsatferd og ledelse,1454071259,2016-01-29 13:40:59,1454071267,8
5698dc5741a9d7210024112b,60715,ORG3402 Organisasjonsatferd og ledelse,1454073435,2016-01-29 14:17:15,1454073443,8
5698dc5741a9d7210024112b,60910,ORG3402 Organisasjonsatferd og ledelse,1454181075,2016-01-30 20:11:15,1454181076,1
5698dc5741a9d7210024112c,50378,ORG3402 Organisasjonsatferd og ledelse,1453303545,2016-01-20 16:25:45,1453304863,1318
5698dc5741a9d7210024112d,29296,ORG3402 Organisasjonsatferd og ledelse,1452868513,2016-01-15 15:35:13,1452868514,1
5698dc5741a9d7210024112d,38274,ORG3402 Organisasjonsatferd og ledelse,1452874605,2016-01-15 17:16:45,1452874607,2
5698dc5741a9d7210024112d,78474,ORG3402 Organisasjonsatferd og ledelse,1452977270,2016-01-16 21:47:50,1452977317,47
5698dc5741a9d7210024112d,67655,ORG3402 Organisasjonsatferd og ledelse,1453062577,2016-01-17 21:29:37,1453062611,34
5698dc5741a9d7210024112d,70494,ORG3402 Organisasjonsatferd og ledelse,1453127139,2016-01-18 15:25:39,1453127139,0
5698dc5741a9d7210024112d,78648,ORG3402 Organisasjonsatferd og ledelse,1453206256,2016-01-19 13:24:16,1453206329,73
5698dc5741a9d7210024112d,53879,ORG3402 Organisasjonsatferd og ledelse,1453681422,2016-01-25 01:23:42,1453681427,5
5698dc5741a9d7210024112d,35990,ORG3402 Organisasjonsatferd og ledelse,1454198951,2016-01-31 01:09:11,1454198997,46
5698dc582fb0de2600f2330f,44990,ORG3402 Organisasjonsatferd og ledelse,1453222909,2016-01-19 18:01:49,1453224613,1704
5698dc582fb0de2600f2330f,93902,ORG3402 Organisasjonsatferd og ledelse,1453402046,2016-01-21 19:47:26,1453402057,11
5698dc582fb0de2600f2330f,86186,ORG3402 Organisasjonsatferd og ledelse,1453671549,2016-01-24 22:39:09,1453671622,73
5698dc582fb0de2600f2330f,45881,ORG3402 Organisasjonsatferd og ledelse,1453834373,2016-01-26 19:52:53,1453834376,3
5698dc582fb0de2600f2330f,99804,ORG3402 Organisasjonsatferd og ledelse,1453836349,2016-01-26 20:25:49,1453837178,829
5698dc582fb0de2600f2330f,72718,ORG3402 Organisasjonsatferd og ledelse,1453887470,2016-01-27 10:37:50,1453887470,0
5698dc582fb0de2600f2330f,16724,ORG3402 Organisasjonsatferd og ledelse,1453896898,2016-01-27 13:14:58,1453896922,24
5698dc582fb0de2600f2330f,58113,ORG3402 Organisasjonsatferd og ledelse,1454061425,2016-01-29 10:57:05,1454061602,177
5698dc582fb0de2600f2330f,14860,ORG3402 Organisasjonsatferd og ledelse,1454062808,2016-01-29 11:20:08,1454062808,0
5698dc582fb0de2600f2330f,42293,ORG3402 Organisasjonsatferd og ledelse,1454065444,2016-01-29 12:04:04,1454065445,1
5698dc592fb0de2600f23311,74571,ORG3402 Organisasjonsatferd og ledelse,1452863273,2016-01-15 14:07:53,1452863350,77
5698dc592fb0de2600f23311,15755,ORG3402 Organisasjonsatferd og ledelse,1452867935,2016-01-15 15:25:35,1452867936,1
5698dc592fb0de2600f23311,46216,ORG3402 Organisasjonsatferd og ledelse,1453051265,2016-01-17 18:21:05,1453051265,0
5698dc592fb0de2600f23311,41727,ORG3402 Organisasjonsatferd og ledelse,1453057598,2016-01-17 20:06:38,1453057599,1
5698dc592fb0de2600f23311,53594,ORG3402 Organisasjonsatferd og ledelse,1453220893,2016-01-19 17:28:13,1453221039,146
5698dc592fb0de2600f23311,4094,ORG3402 Organisasjonsatferd og ledelse,1453277698,2016-01-20 09:14:58,1453277698,0
5698dc592fb0de2600f23311,15956,ORG3402 Organisasjonsatferd og ledelse,1453718434,2016-01-25 11:40:34,1453718435,1
5698dc592fb0de2600f23311,83813,ORG3402 Organisasjonsatferd og ledelse,1453723090,2016-01-25 12:58:10,1453723148,58
5698dc592fb0de2600f23311,86964,ORG3402 Organisasjonsatferd og ledelse,1453762081,2016-01-25 23:48:01,1453762081,0
5698dc592fb0de2600f23311,5347,ORG3402 Organisasjonsatferd og ledelse,1453993386,2016-01-28 16:03:06,1453993502,116
5698dc592fb0de2600f23315,45870,ORG3402 Organisasjonsatferd og ledelse,1453064587,2016-01-17 22:03:07,1453064810,223
5698dc592fb0de2600f23315,5456,ORG3402 Organisasjonsatferd og ledelse,1453814400,2016-01-26 14:20:00,1453814463,63
5698dc592fb0de2600f23315,12501,ORG3402 Organisasjonsatferd og ledelse,1453900442,2016-01-27 14:14:02,1453900609,167
5698dc592fb0de2600f23315,76208,ORG3402 Organisasjonsatferd og ledelse,1453937565,2016-01-28 00:32:45,1453937567,2
5698dc592fb0de2600f23315,95057,ORG3402 Organisasjonsatferd og ledelse,1454030740,2016-01-29 02:25:40,1454030790,50
5698dc592fb0de2600f23315,82981,ORG3402 Organisasjonsatferd og ledelse,1454069282,2016-01-29 13:08:02,1454069314,32
5698dc592fb0de2600f23315,28338,ORG3402 Organisasjonsatferd og ledelse,1454156006,2016-01-30 13:13:26,1454156007,1
5698dc5941a9d72100241152,1811,ORG3402 Organisasjonsatferd og ledelse,1454100449,2016-01-29 21:47:29,1454100450,1
5698dc5941a9d72100241153,19528,ORG3402 Organisasjonsatferd og ledelse,1452863303,2016-01-15 14:08:23,1452863369,66
5698dc5941a9d72100241153,53779,ORG3402 Organisasjonsatferd og ledelse,1453031215,2016-01-17 12:46:55,1453031220,5
5698dc5941a9d72100241153,69973,ORG3402 Organisasjonsatferd og ledelse,1453126074,2016-01-18 15:07:54,1453126107,33
5698dc5941a9d72100241153,97825,ORG3402 Organisasjonsatferd og ledelse,1453207208,2016-01-19 13:40:08,1453207450,242
5698dc5941a9d72100241153,9311,ORG3402 Organisasjonsatferd og ledelse,1453634606,2016-01-24 12:23:26,1453634783,177
5698dc5a2fb0de2600f23319,20459,ORG3402 Organisasjonsatferd og ledelse,1453849473,2016-01-27 00:04:33,1453849799,326
5698dc5a2fb0de2600f23319,46859,ORG3402 Organisasjonsatferd og ledelse,1453901584,2016-01-27 14:33:04,1453901701,117
5698dc5a2fb0de2600f23319,6350,ORG3402 Organisasjonsatferd og ledelse,1454065224,2016-01-29 12:00:24,1454065366,142
5698dc5a2fb0de2600f23319,51283,ORG3402 Organisasjonsatferd og ledelse,1454074407,2016-01-29 14:33:27,1454074407,0
5698dc5a2fb0de2600f2331a,96758,ORG3402 Organisasjonsatferd og ledelse,1452884052,2016-01-15 19:54:12,1452884297,245
5698dc5a2fb0de2600f2331a,58546,ORG3402 Organisasjonsatferd og ledelse,1452907015,2016-01-16 02:16:55,1452907421,406
5698dc5a2fb0de2600f2331a,16873,ORG3402 Organisasjonsatferd og ledelse,1453136685,2016-01-18 18:04:45,1453137484,799
5698dc5a2fb0de2600f2331a,33364,ORG3402 Organisasjonsatferd og ledelse,1453140462,2016-01-18 19:07:42,1453140631,169
5698dc5a2fb0de2600f2331a,3077,ORG3402 Organisasjonsatferd og ledelse,1453143990,2016-01-18 20:06:30,1453145466,1476
5698dc5a2fb0de2600f2331a,8137,ORG3402 Organisasjonsatferd og ledelse,1453481180,2016-01-22 17:46:20,1453481415,235
5698dc5a2fb0de2600f2331a,84196,ORG3402 Organisasjonsatferd og ledelse,1453719521,2016-01-25 11:58:41,1453719577,56
5698dc5a2fb0de2600f2331a,71642,ORG3402 Organisasjonsatferd og ledelse,1454250547,2016-01-31 15:29:07,1454250752,205
5698dc5a2fb0de2600f2331b,75378,ORG3402 Organisasjonsatferd og ledelse,1454004785,2016-01-28 19:13:05,1454004893,108
5698dc5a2fb0de2600f2331e,55626,ORG3402 Organisasjonsatferd og ledelse,1453208945,2016-01-19 14:09:05,1453209023,78
5698dc5a2fb0de2600f2331e,36009,ORG3402 Organisasjonsatferd og ledelse,1453910674,2016-01-27 17:04:34,1453910803,129
5698dc5a41a9d72100241157,24230,ORG3402 Organisasjonsatferd og ledelse,1453137760,2016-01-18 18:22:40,1453138225,465
5698dc5a41a9d72100241157,64846,ORG3402 Organisasjonsatferd og ledelse,1453246717,2016-01-20 00:38:37,1453246717,0
5698dc5a41a9d72100241157,61935,ORG3402 Organisasjonsatferd og ledelse,1453333813,2016-01-21 00:50:13,1453333831,18
5698dc5a41a9d72100241157,99561,ORG3402 Organisasjonsatferd og ledelse,1453420629,2016-01-22 00:57:09,1453420630,1
5698dc5a41a9d72100241157,11137,ORG3402 Organisasjonsatferd og ledelse,1453674913,2016-01-24 23:35:13,1453674936,23
5698dc5a41a9d72100241157,49333,ORG3402 Organisasjonsatferd og ledelse,1453850672,2016-01-27 00:24:32,1453850672,0
5698dc5a41a9d72100241157,2764,ORG3402 Organisasjonsatferd og ledelse,1454315923,2016-02-01 09:38:43,1454315923,0
5698dc5a41a9d72100241158,38482,ORG3402 Organisasjonsatferd og ledelse,1452868469,2016-01-15 15:34:29,1452868526,57
5698dc5a41a9d72100241158,90300,ORG3402 Organisasjonsatferd og ledelse,1452869788,2016-01-15 15:56:28,1452869788,0
5698dc5a41a9d72100241159,82040,ORG3402 Organisasjonsatferd og ledelse,1453800330,2016-01-26 10:25:30,1453800440,110
5698dc5a41a9d72100241159,42889,ORG3402 Organisasjonsatferd og ledelse,1453892708,2016-01-27 12:05:08,1453893306,598
5698dc5a41a9d72100241159,94743,ORG3402 Organisasjonsatferd og ledelse,1454065703,2016-01-29 12:08:23,1454065718,15
5698dc5a41a9d7210024116c,57948,ORG3402 Organisasjonsatferd og ledelse,1452867969,2016-01-15 15:26:09,1452867976,7
5698dc5a41a9d7210024116c,77471,ORG3402 Organisasjonsatferd og ledelse,1453066496,2016-01-17 22:34:56,1453066497,1
5698dc5a41a9d7210024116c,99118,ORG3402 Organisasjonsatferd og ledelse,1453915343,2016-01-27 18:22:23,1453915653,310
5698dc5b2fb0de2600f23335,83522,ORG3402 Organisasjonsatferd og ledelse,1453641457,2016-01-24 14:17:37,1453641619,162
5698dc5b41a9d72100241179,63299,ORG3402 Organisasjonsatferd og ledelse,1453288832,2016-01-20 12:20:32,1453288881,49
5698dc5b41a9d72100241179,38090,ORG3402 Organisasjonsatferd og ledelse,1453720599,2016-01-25 12:16:39,1453720719,120
5698dc5c2fb0de2600f23338,26359,ORG3402 Organisasjonsatferd og ledelse,1452872993,2016-01-15 16:49:53,1452873305,312
5698dc5c2fb0de2600f23338,76788,ORG3402 Organisasjonsatferd og ledelse,1453153886,2016-01-18 22:51:26,1453154019,133
5698dc5c2fb0de2600f23338,93722,ORG3402 Organisasjonsatferd og ledelse,1453206812,2016-01-19 13:33:32,1453207238,426
5698dc5c2fb0de2600f23338,64820,ORG3402 Organisasjonsatferd og ledelse,1453883506,2016-01-27 09:31:46,1453883574,68
5698dc5c2fb0de2600f23338,59889,ORG3402 Organisasjonsatferd og ledelse,1453922906,2016-01-27 20:28:26,1453922940,34
5698dc5c2fb0de2600f23339,81616,ORG3402 Organisasjonsatferd og ledelse,1453835237,2016-01-26 20:07:17,1453835297,60
5698dc5d2fb0de2600f23342,93116,ORG3402 Organisasjonsatferd og ledelse,1453097111,2016-01-18 07:05:11,1453097195,84
5698dc5d2fb0de2600f23342,79503,ORG3402 Organisasjonsatferd og ledelse,1453432365,2016-01-22 04:12:45,1453432402,37
5698dc5d2fb0de2600f23342,14141,ORG3402 Organisasjonsatferd og ledelse,1454021619,2016-01-28 23:53:39,1454021619,0
5698dc5d2fb0de2600f23344,13960,ORG3402 Organisasjonsatferd og ledelse,1453999472,2016-01-28 17:44:32,1454001463,1991
5698dc5d41a9d7210024117b,33695,ORG3402 Organisasjonsatferd og ledelse,1452864359,2016-01-15 14:25:59,1452864404,45
5698dc5d41a9d7210024117b,29903,ORG3402 Organisasjonsatferd og ledelse,1453074915,2016-01-18 00:55:15,1453074917,2
5698dc5d41a9d7210024117b,72287,ORG3402 Organisasjonsatferd og ledelse,1453238167,2016-01-19 22:16:07,1453238170,3
5698dc5d41a9d7210024117b,2644,ORG3402 Organisasjonsatferd og ledelse,1453375472,2016-01-21 12:24:32,1453375475,3
5698dc5d41a9d7210024117c,26085,ORG3402 Organisasjonsatferd og ledelse,1453384072,2016-01-21 14:47:52,1453384683,611
5698dc5d41a9d7210024117f,38209,ORG3402 Organisasjonsatferd og ledelse,1453218164,2016-01-19 16:42:44,1453219101,937
5698dc5d41a9d7210024117f,33724,ORG3402 Organisasjonsatferd og ledelse,1453662980,2016-01-24 20:16:20,1453663020,40
5698dc5d41a9d72100241180,6772,ORG3402 Organisasjonsatferd og ledelse,1453026334,2016-01-17 11:25:34,1453026376,42
5698dc5d41a9d72100241180,64788,ORG3402 Organisasjonsatferd og ledelse,1453067892,2016-01-17 22:58:12,1453067904,12
5698dc5d41a9d72100241180,56587,ORG3402 Organisasjonsatferd og ledelse,1453377641,2016-01-21 13:00:41,1453379287,1646
5698dc5d41a9d72100241180,56740,ORG3402 Organisasjonsatferd og ledelse,1454003106,2016-01-28 18:45:06,1454003326,220
5698dc5e2fb0de2600f2335d,26556,ORG3402 Organisasjonsatferd og ledelse,1452885192,2016-01-15 20:13:12,1452885292,100
5698dc5e2fb0de2600f2335d,54075,ORG3402 Organisasjonsatferd og ledelse,1453131162,2016-01-18 16:32:42,1453131486,324
5698dc5e2fb0de2600f2335d,41835,ORG3402 Organisasjonsatferd og ledelse,1453207744,2016-01-19 13:49:04,1453207744,0
5698dc5e2fb0de2600f2335d,98453,ORG3402 Organisasjonsatferd og ledelse,1453209223,2016-01-19 14:13:43,1453209674,451
5698dc5e2fb0de2600f2335d,90773,ORG3402 Organisasjonsatferd og ledelse,1453212355,2016-01-19 15:05:55,1453212367,12
5698dc5e41a9d72100241182,36863,ORG3402 Organisasjonsatferd og ledelse,1453321526,2016-01-20 21:25:26,1453321570,44
5698dc5e41a9d72100241182,18422,ORG3402 Organisasjonsatferd og ledelse,1453739947,2016-01-25 17:39:07,1453739951,4
5698dc5e41a9d72100241185,58818,ORG3402 Organisasjonsatferd og ledelse,1452862243,2016-01-15 13:50:43,1452862264,21
5698dc5e41a9d72100241185,620,ORG3402 Organisasjonsatferd og ledelse,1453657130,2016-01-24 18:38:50,1453657425,295
5698dc5e41a9d72100241185,22451,ORG3402 Organisasjonsatferd og ledelse,1454065839,2016-01-29 12:10:39,1454065924,85
5698dc5f2fb0de2600f23360,79312,ORG3402 Organisasjonsatferd og ledelse,1453188936,2016-01-19 08:35:36,1453189764,828
5698dc5f2fb0de2600f23360,50651,ORG3402 Organisasjonsatferd og ledelse,1453191443,2016-01-19 09:17:23,1453191443,0
5698dc5f2fb0de2600f23360,95025,ORG3402 Organisasjonsatferd og ledelse,1453742158,2016-01-25 18:15:58,1453742216,58
5698dc5f2fb0de2600f23360,22539,ORG3402 Organisasjonsatferd og ledelse,1453825762,2016-01-26 17:29:22,1453825830,68
569ca43ee62ae22300d1ca40,81802,ORG3402 Organisasjonsatferd og ledelse,1453202360,2016-01-19 12:19:20,1453202795,435
569ca43ee62ae22300d1ca40,60212,ORG3402 Organisasjonsatferd og ledelse,1453208179,2016-01-19 13:56:19,1453208224,45
569ca43ee62ae22300d1ca40,75066,ORG3402 Organisasjonsatferd og ledelse,1453285213,2016-01-20 11:20:13,1453286348,1135
569ca43ee62ae22300d1ca40,41,ORG3402 Organisasjonsatferd og ledelse,1453323467,2016-01-20 21:57:47,1453323468,1
569ca43ee62ae22300d1ca40,52502,ORG3402 Organisasjonsatferd og ledelse,1453717083,2016-01-25 11:18:03,1453717127,44
569ca43ee62ae22300d1ca40,57749,ORG3402 Organisasjonsatferd og ledelse,1453718979,2016-01-25 11:49:39,1453718979,0
569ca43ee62ae22300d1ca40,69648,ORG3402 Organisasjonsatferd og ledelse,1454073858,2016-01-29 14:24:18,1454074283,425
569ca43ee62ae22300d1ca40,11748,ORG3402 Organisasjonsatferd og ledelse,1454256512,2016-01-31 17:08:32,1454256562,50
569f7ef4c9741c2500080e46,83905,ORG3402 Organisasjonsatferd og ledelse,1453729240,2016-01-25 14:40:40,1453729467,227
569f7ef4c9741c2500080e46,3623,ORG3402 Organisasjonsatferd og ledelse,1453797175,2016-01-26 09:32:55,1453797175,0
569f7f604d946d2400ad1da5,890,ORG3402 Organisasjonsatferd og ledelse,1453667865,2016-01-24 21:37:45,1453668045,180
569f7f604d946d2400ad1da5,13415,ORG3402 Organisasjonsatferd og ledelse,1453723315,2016-01-25 13:01:55,1453723317,2
569f7f8635827027001cb860,31372,ORG3402 Organisasjonsatferd og ledelse,1453305282,2016-01-20 16:54:42,1453305282,0
569f7f8635827027001cb860,92405,ORG3402 Organisasjonsatferd og ledelse,1453392842,2016-01-21 17:14:02,1453392919,77
569f7f8635827027001cb860,59966,ORG3402 Organisasjonsatferd og ledelse,1453713535,2016-01-25 10:18:55,1453713561,26
569f7f8635827027001cb860,90111,ORG3402 Organisasjonsatferd og ledelse,1453806592,2016-01-26 12:09:52,1453807751,1159
56a6b0275d52c7250022aa27,49555,MRK3480 Forbrukeratferd,1453816254,2016-01-26 14:50:54,1453816319,65
56a6b0275d52c7250022aa27,96156,MRK3480 Forbrukeratferd,1453842959,2016-01-26 22:15:59,1453843007,48
56a6b0275d52c7250022aa27,6647,MRK3480 Forbrukeratferd,1453932133,2016-01-27 23:02:13,1453932227,94
56a6b0275d52c7250022aa27,23832,MRK3480 Forbrukeratferd,1453989561,2016-01-28 14:59:21,1453989943,382
56a6b09c37f619210097cc6a,39366,MRK3480 Forbrukeratferd,1453849878,2016-01-27 00:11:18,1453850196,318
56a8d93229028e260091301a,22768,ORG3402 Organisasjonsatferd og ledelse,1453985787,2016-01-28 13:56:27,1453985849,62
56a8d93229028e260091301a,70636,ORG3402 Organisasjonsatferd og ledelse,1453988745,2016-01-28 14:45:45,1453988746,1
56a8ed7d29028e2600913141,85712,MRK3480 Forbrukeratferd,1453916201,2016-01-27 18:36:41,1453916433,232
