distinct_id,session,space_1,time_begin,time_begin_1,time_end,duration
55d1d40f9997410800eefbd5,45201,nan,1455293188,2016-02-12 17:06:28,1455293415,227
5698d6a82fb0de2600f22585,79662,KLS3551 Kulturledelse,1453202206,2016-01-19 12:16:46,1453202618,412
5698d6a82fb0de2600f22585,82953,KLS3551 Kulturledelse,1453204994,2016-01-19 13:03:14,1453205971,977
5698d6a82fb0de2600f22585,15284,KLS3551 Kulturledelse,1454084815,2016-01-29 17:26:55,1454084835,20
5698d6a82fb0de2600f22585,42894,KLS3551 Kulturledelse,1454286382,2016-02-01 01:26:22,1454286383,1
5698d6a82fb0de2600f22585,1519,KLS3551 Kulturledelse,1454290835,2016-02-01 02:40:35,1454290967,132
5698d6a82fb0de2600f22585,37245,KLS3551 Kulturledelse,1454381902,2016-02-02 03:58:22,1454381919,17
5698d6a82fb0de2600f22585,34981,KLS3551 Kulturledelse,1454412617,2016-02-02 12:30:17,1454412621,4
5698d6a82fb0de2600f22585,90539,KLS3551 Kulturledelse,1454416114,2016-02-02 13:28:34,1454416921,807
5698d6a82fb0de2600f22586,95516,KLS3551 Kulturledelse,1453120924,2016-01-18 13:42:04,1453125977,5053
5698d6a82fb0de2600f22586,42979,KLS3551 Kulturledelse,1453133537,2016-01-18 17:12:17,1453133638,101
5698d6a82fb0de2600f22586,97787,KLS3551 Kulturledelse,1453151952,2016-01-18 22:19:12,1453151995,43
5698d6a82fb0de2600f22586,49839,KLS3551 Kulturledelse,1453196252,2016-01-19 10:37:32,1453196283,31
5698d6a82fb0de2600f22586,24686,KLS3551 Kulturledelse,1453204350,2016-01-19 12:52:30,1453205952,1602
5698d6a82fb0de2600f22586,76,KLS3551 Kulturledelse,1453209709,2016-01-19 14:21:49,1453209710,1
5698d6a82fb0de2600f22586,92079,KLS3551 Kulturledelse,1453215946,2016-01-19 16:05:46,1453216125,179
5698d6a82fb0de2600f22586,61281,KLS3551 Kulturledelse,1453228410,2016-01-19 19:33:30,1453228595,185
5698d6a82fb0de2600f22586,10040,KLS3551 Kulturledelse,1453305306,2016-01-20 16:55:06,1453305306,0
5698d6a82fb0de2600f22586,84918,KLS3551 Kulturledelse,1453730758,2016-01-25 15:05:58,1453730758,0
5698d6a82fb0de2600f22586,60905,KLS3551 Kulturledelse,1453806356,2016-01-26 12:05:56,1453806356,0
5698d6a82fb0de2600f22586,89101,KLS3551 Kulturledelse,1453815740,2016-01-26 14:42:20,1453815754,14
5698d6a82fb0de2600f22586,78496,KLS3551 Kulturledelse,1453828227,2016-01-26 18:10:27,1453828227,0
5698d6a82fb0de2600f22586,94743,KLS3551 Kulturledelse,1454065069,2016-01-29 11:57:49,1454065250,181
5698d6a82fb0de2600f22586,31417,KLS3551 Kulturledelse,1454336318,2016-02-01 15:18:38,1454336319,1
5698d6a82fb0de2600f22586,80693,KLS3551 Kulturledelse,1454404378,2016-02-02 10:12:58,1454404985,607
5698d6a82fb0de2600f22586,95941,KLS3551 Kulturledelse,1454406389,2016-02-02 10:46:29,1454406391,2
5698d6a82fb0de2600f22586,2502,KLS3551 Kulturledelse,1454416653,2016-02-02 13:37:33,1454417676,1023
5698d6a82fb0de2600f22586,83234,KLS3551 Kulturledelse,1454502525,2016-02-03 13:28:45,1454502607,82
5698d6a82fb0de2600f22586,16329,KLS3551 Kulturledelse,1454504318,2016-02-03 13:58:38,1454504318,0
5698d6a82fb0de2600f22586,91992,KLS3551 Kulturledelse,1455050736,2016-02-09 21:45:36,1455050736,0
5698d6a82fb0de2600f22587,74672,KLS3551 Kulturledelse,1453771059,2016-01-26 02:17:39,1453771271,212
5698d6a82fb0de2600f22587,76764,KLS3551 Kulturledelse,1453906485,2016-01-27 15:54:45,1453906485,0
5698d6a82fb0de2600f22587,86156,KLS3551 Kulturledelse,1454341524,2016-02-01 16:45:24,1454341524,0
5698d6a82fb0de2600f22587,92721,KLS3551 Kulturledelse,1454410800,2016-02-02 12:00:00,1454410800,0
5698d6a82fb0de2600f22587,40137,KLS3551 Kulturledelse,1454415215,2016-02-02 13:13:35,1454415321,106
5698d6a82fb0de2600f22587,43247,KLS3551 Kulturledelse,1454890813,2016-02-08 01:20:13,1454890835,22
5698d6a82fb0de2600f22587,55024,KLS3551 Kulturledelse,1454892174,2016-02-08 01:42:54,1454892177,3
5698d6a82fb0de2600f22589,47706,KLS3551 Kulturledelse,1452961762,2016-01-16 17:29:22,1452961882,120
5698d6a82fb0de2600f22589,40977,KLS3551 Kulturledelse,1453060483,2016-01-17 20:54:43,1453060483,0
5698d6a82fb0de2600f22589,95290,KLS3551 Kulturledelse,1453201963,2016-01-19 12:12:43,1453203144,1181
5698d6a82fb0de2600f22589,63328,KLS3551 Kulturledelse,1453484893,2016-01-22 18:48:13,1453484894,1
5698d6a82fb0de2600f22589,62225,KLS3551 Kulturledelse,1453560456,2016-01-23 15:47:36,1453560456,0
5698d6a82fb0de2600f22589,75726,KLS3551 Kulturledelse,1453826945,2016-01-26 17:49:05,1453826971,26
5698d6a82fb0de2600f22589,41426,KLS3551 Kulturledelse,1453832675,2016-01-26 19:24:35,1453832684,9
5698d6a82fb0de2600f22589,14672,KLS3551 Kulturledelse,1454420930,2016-02-02 14:48:50,1454421417,487
5698d6a82fb0de2600f22589,29656,KLS3551 Kulturledelse,1454440105,2016-02-02 20:08:25,1454440289,184
5698d6a82fb0de2600f22589,68084,KLS3551 Kulturledelse,1454452106,2016-02-02 23:28:26,1454452107,1
5698d6a82fb0de2600f22589,35773,KLS3551 Kulturledelse,1454768177,2016-02-06 15:16:17,1454768180,3
5698d6a82fb0de2600f22589,78874,KLS3551 Kulturledelse,1454927935,2016-02-08 11:38:55,1454927935,0
5698d6a841a9d721002400f3,54283,KLS3551 Kulturledelse,1453204985,2016-01-19 13:03:05,1453205486,501
5698d6a841a9d721002400f3,31190,KLS3551 Kulturledelse,1453209534,2016-01-19 14:18:54,1453209538,4
5698d6a841a9d721002400f3,50736,KLS3551 Kulturledelse,1453722680,2016-01-25 12:51:20,1453722761,81
5698d6a841a9d721002400f3,21022,KLS3551 Kulturledelse,1453981000,2016-01-28 12:36:40,1453981456,456
5698d6a841a9d721002400f3,84721,KLS3551 Kulturledelse,1453985743,2016-01-28 13:55:43,1453985743,0
5698d6a841a9d721002400f3,62839,KLS3551 Kulturledelse,1454405351,2016-02-02 10:29:11,1454405351,0
5698d6a841a9d721002400f3,5255,KLS3551 Kulturledelse,1454446473,2016-02-02 21:54:33,1454447315,842
5698d6a841a9d721002400f3,44572,KLS3551 Kulturledelse,1454503076,2016-02-03 13:37:56,1454503077,1
5698d6a841a9d721002400f4,84791,KLS3551 Kulturledelse,1453204948,2016-01-19 13:02:28,1453206005,1057
5698d6a841a9d721002400f4,27447,KLS3551 Kulturledelse,1453318432,2016-01-20 20:33:52,1453318434,2
5698d6a841a9d721002400f4,27543,KLS3551 Kulturledelse,1454448704,2016-02-02 22:31:44,1454448765,61
5698d6a841a9d721002400f4,32593,KLS3551 Kulturledelse,1454452038,2016-02-02 23:27:18,1454452070,32
5698d6a841a9d721002400f4,65797,KLS3551 Kulturledelse,1454498849,2016-02-03 12:27:29,1454498850,1
5698d6a841a9d721002400f5,85511,KLS3551 Kulturledelse,1453114339,2016-01-18 11:52:19,1453114821,482
5698d6a841a9d721002400f5,23471,KLS3551 Kulturledelse,1453118131,2016-01-18 12:55:31,1453118253,122
5698d6a841a9d721002400f5,68630,KLS3551 Kulturledelse,1453155106,2016-01-18 23:11:46,1453156494,1388
5698d6a841a9d721002400f5,83583,KLS3551 Kulturledelse,1453238676,2016-01-19 22:24:36,1453239067,391
5698d6a841a9d721002400f5,10249,KLS3551 Kulturledelse,1453333415,2016-01-21 00:43:35,1453333418,3
5698d6a841a9d721002400f5,35134,KLS3551 Kulturledelse,1453730138,2016-01-25 14:55:38,1453730147,9
5698d6a841a9d721002400f5,54950,KLS3551 Kulturledelse,1453737993,2016-01-25 17:06:33,1453738603,610
5698d6a841a9d721002400f5,72858,KLS3551 Kulturledelse,1453740768,2016-01-25 17:52:48,1453740768,0
5698d6a841a9d721002400f5,47971,KLS3551 Kulturledelse,1454192740,2016-01-30 23:25:40,1454192742,2
5698d6a841a9d721002400f5,895,KLS3551 Kulturledelse,1454348958,2016-02-01 18:49:18,1454349091,133
5698d6a841a9d721002400f5,59903,KLS3551 Kulturledelse,1454357532,2016-02-01 21:12:12,1454357615,83
5698d6a841a9d721002400f5,39206,KLS3551 Kulturledelse,1454408286,2016-02-02 11:18:06,1454408431,145
5698d6a841a9d721002400f5,61649,KLS3551 Kulturledelse,1454415199,2016-02-02 13:13:19,1454415271,72
5698d6a841a9d721002400f6,31667,KLS3551 Kulturledelse,1453205114,2016-01-19 13:05:14,1453205115,1
5698d6a841a9d721002400f6,59866,KLS3551 Kulturledelse,1454415453,2016-02-02 13:17:33,1454415454,1
5698d6a841a9d721002400f6,20621,KLS3551 Kulturledelse,1454420467,2016-02-02 14:41:07,1454420469,2
5698d6a92fb0de2600f2258c,3168,KLS3551 Kulturledelse,1453155823,2016-01-18 23:23:43,1453155916,93
5698d6a92fb0de2600f2258c,86533,KLS3551 Kulturledelse,1453199414,2016-01-19 11:30:14,1453199438,24
5698d6a92fb0de2600f2258c,74159,KLS3551 Kulturledelse,1453202217,2016-01-19 12:16:57,1453203018,801
5698d6a92fb0de2600f2258c,41667,KLS3551 Kulturledelse,1453205262,2016-01-19 13:07:42,1453205262,0
5698d6a92fb0de2600f2258c,39581,KLS3551 Kulturledelse,1453649590,2016-01-24 16:33:10,1453649750,160
5698d6a92fb0de2600f2258c,93928,KLS3551 Kulturledelse,1453678012,2016-01-25 00:26:52,1453678033,21
5698d6a92fb0de2600f2258c,96608,KLS3551 Kulturledelse,1453708871,2016-01-25 09:01:11,1453708912,41
5698d6a92fb0de2600f2258c,7337,KLS3551 Kulturledelse,1453806034,2016-01-26 12:00:34,1453806074,40
5698d6a92fb0de2600f2258c,68930,KLS3551 Kulturledelse,1453808313,2016-01-26 12:38:33,1453808482,169
5698d6a92fb0de2600f2258c,36909,KLS3551 Kulturledelse,1454420535,2016-02-02 14:42:15,1454421312,777
5698d6a92fb0de2600f2258c,26042,KLS3551 Kulturledelse,1454436962,2016-02-02 19:16:02,1454436967,5
5698d6a92fb0de2600f2258c,56345,KLS3551 Kulturledelse,1454447664,2016-02-02 22:14:24,1454447676,12
5698d6a92fb0de2600f2258c,56654,KLS3551 Kulturledelse,1454527530,2016-02-03 20:25:30,1454527658,128
5698d6a92fb0de2600f2258c,3604,KLS3551 Kulturledelse,1454683684,2016-02-05 15:48:04,1454684210,526
5698d6a92fb0de2600f2258c,98406,KLS3551 Kulturledelse,1455008307,2016-02-09 09:58:27,1455008335,28
5698d6a92fb0de2600f2258c,53379,KLS3551 Kulturledelse,1455014408,2016-02-09 11:40:08,1455014410,2
5698d6a92fb0de2600f2258c,80163,KLS3551 Kulturledelse,1455019480,2016-02-09 13:04:40,1455019499,19
5698d6a941a9d721002400f8,91174,KLS3551 Kulturledelse,1454321136,2016-02-01 11:05:36,1454321137,1
5698d6a941a9d721002400f8,26524,KLS3551 Kulturledelse,1454324036,2016-02-01 11:53:56,1454324353,317
5698d6aa2fb0de2600f22590,91251,KLS3551 Kulturledelse,1453200478,2016-01-19 11:47:58,1453200836,358
5698d6aa2fb0de2600f22590,9556,KLS3551 Kulturledelse,1453204606,2016-01-19 12:56:46,1453205978,1372
5698d6aa2fb0de2600f22590,4109,KLS3551 Kulturledelse,1453805357,2016-01-26 11:49:17,1453806402,1045
5698d6aa2fb0de2600f22590,29115,KLS3551 Kulturledelse,1453813556,2016-01-26 14:05:56,1453813559,3
5698d6aa2fb0de2600f22590,16334,KLS3551 Kulturledelse,1453814794,2016-01-26 14:26:34,1453814800,6
5698d6aa2fb0de2600f22590,82493,KLS3551 Kulturledelse,1454404354,2016-02-02 10:12:34,1454405373,1019
5698d6aa2fb0de2600f22590,71507,KLS3551 Kulturledelse,1454411078,2016-02-02 12:04:38,1454411244,166
5698d6aa2fb0de2600f22590,34334,KLS3551 Kulturledelse,1454413437,2016-02-02 12:43:57,1454413971,534
5698d6aa2fb0de2600f22590,83980,KLS3551 Kulturledelse,1454418631,2016-02-02 14:10:31,1454418638,7
5698d6aa2fb0de2600f22591,86253,KLS3551 Kulturledelse,1452860699,2016-01-15 13:24:59,1452860877,178
5698d6aa2fb0de2600f22591,77282,KLS3551 Kulturledelse,1453124208,2016-01-18 14:36:48,1453124278,70
5698d6aa2fb0de2600f22591,36242,KLS3551 Kulturledelse,1453127850,2016-01-18 15:37:30,1453128162,312
5698d6aa2fb0de2600f22591,86907,KLS3551 Kulturledelse,1453138778,2016-01-18 18:39:38,1453138781,3
5698d6aa2fb0de2600f22591,37914,KLS3551 Kulturledelse,1453298089,2016-01-20 14:54:49,1453298447,358
5698d6aa2fb0de2600f22591,59349,KLS3551 Kulturledelse,1453301611,2016-01-20 15:53:31,1453301612,1
5698d6aa2fb0de2600f22591,63172,KLS3551 Kulturledelse,1453979421,2016-01-28 12:10:21,1453979528,107
5698d6aa2fb0de2600f22591,70080,KLS3551 Kulturledelse,1453981389,2016-01-28 12:43:09,1453983473,2084
5698d6aa2fb0de2600f22591,38912,KLS3551 Kulturledelse,1454320545,2016-02-01 10:55:45,1454320545,0
5698d6aa2fb0de2600f22591,13673,KLS3551 Kulturledelse,1454323126,2016-02-01 11:38:46,1454323128,2
5698d6aa2fb0de2600f22591,82076,KLS3551 Kulturledelse,1454369249,2016-02-02 00:27:29,1454369325,76
5698d6aa2fb0de2600f22591,80125,KLS3551 Kulturledelse,1454416046,2016-02-02 13:27:26,1454416358,312
5698d6aa2fb0de2600f22591,55270,KLS3551 Kulturledelse,1455021502,2016-02-09 13:38:22,1455021555,53
5698d6aa2fb0de2600f22591,99775,KLS3551 Kulturledelse,1455022820,2016-02-09 14:00:20,1455022823,3
5698d6aa2fb0de2600f22592,13717,KLS3551 Kulturledelse,1452957103,2016-01-16 16:11:43,1452957229,126
5698d6aa2fb0de2600f22592,25717,KLS3551 Kulturledelse,1453063520,2016-01-17 21:45:20,1453063541,21
5698d6aa2fb0de2600f22592,55221,KLS3551 Kulturledelse,1453201762,2016-01-19 12:09:22,1453201792,30
5698d6aa2fb0de2600f22592,99576,KLS3551 Kulturledelse,1453205142,2016-01-19 13:05:42,1453207238,2096
5698d6aa2fb0de2600f22592,70070,KLS3551 Kulturledelse,1453221836,2016-01-19 17:43:56,1453221861,25
5698d6aa2fb0de2600f22592,35392,KLS3551 Kulturledelse,1453239418,2016-01-19 22:36:58,1453239426,8
5698d6aa2fb0de2600f22592,9739,MRK3480 Forbrukeratferd,1453293852,2016-01-20 13:44:12,1453293887,35
5698d6aa2fb0de2600f22592,74446,KLS3551 Kulturledelse,1453647626,2016-01-24 16:00:26,1453647877,251
5698d6aa2fb0de2600f22592,48912,KLS3551 Kulturledelse,1453708568,2016-01-25 08:56:08,1453708981,413
5698d6aa2fb0de2600f22592,73543,MRK3480 Forbrukeratferd,1453726054,2016-01-25 13:47:34,1453726078,24
5698d6aa2fb0de2600f22592,69964,KLS3551 Kulturledelse,1453809868,2016-01-26 13:04:28,1453809980,112
5698d6aa2fb0de2600f22592,1468,MRK3480 Forbrukeratferd,1453813671,2016-01-26 14:07:51,1453813812,141
5698d6aa2fb0de2600f22592,19750,KLS3551 Kulturledelse,1453826856,2016-01-26 17:47:36,1453827752,896
5698d6aa2fb0de2600f22592,4920,KLS3551 Kulturledelse,1453833290,2016-01-26 19:34:50,1453833293,3
5698d6aa2fb0de2600f22592,80380,KLS3551 Kulturledelse,1453895754,2016-01-27 12:55:54,1453896193,439
5698d6aa2fb0de2600f22592,71213,KLS3551 Kulturledelse,1453902268,2016-01-27 14:44:28,1453902268,0
5698d6aa2fb0de2600f22592,74652,KLS3551 Kulturledelse,1454411678,2016-02-02 12:14:38,1454412202,524
5698d6aa2fb0de2600f22592,74037,KLS3551 Kulturledelse,1454413750,2016-02-02 12:49:10,1454413812,62
5698d6aa2fb0de2600f22592,98249,KLS3551 Kulturledelse,1454434042,2016-02-02 18:27:22,1454435643,1601
5698d6aa2fb0de2600f22592,4725,KLS3551 Kulturledelse,1454453414,2016-02-02 23:50:14,1454453443,29
5698d6aa2fb0de2600f22592,62060,KLS3551 Kulturledelse,1454601102,2016-02-04 16:51:42,1454601160,58
5698d6aa2fb0de2600f22592,76919,MRK3480 Forbrukeratferd,1454976439,2016-02-09 01:07:19,1454976459,20
5698d6aa2fb0de2600f22592,2681,KLS3551 Kulturledelse,1455019937,2016-02-09 13:12:17,1455019947,10
5698d6aa2fb0de2600f22592,32860,KLS3551 Kulturledelse,1455102883,2016-02-10 12:14:43,1455102896,13
5698d6aa2fb0de2600f22592,54730,KLS3551 Kulturledelse,1455122831,2016-02-10 17:47:11,1455122848,17
5698d6aa2fb0de2600f22594,80339,KLS3551 Kulturledelse,1453711077,2016-01-25 09:37:57,1453711169,92
5698d6aa2fb0de2600f22594,13110,KLS3551 Kulturledelse,1453725731,2016-01-25 13:42:11,1453725738,7
5698d6aa2fb0de2600f22594,55627,KLS3551 Kulturledelse,1453728154,2016-01-25 14:22:34,1453728724,570
5698d6aa2fb0de2600f22594,92252,KLS3551 Kulturledelse,1453807445,2016-01-26 12:24:05,1453807445,0
5698d6aa2fb0de2600f22594,64477,KLS3551 Kulturledelse,1454400091,2016-02-02 09:01:31,1454400091,0
5698d6aa2fb0de2600f22594,271,KLS3551 Kulturledelse,1454921232,2016-02-08 09:47:12,1454921289,57
5698d6aa2fb0de2600f22594,4047,KLS3551 Kulturledelse,1455019990,2016-02-09 13:13:10,1455019991,1
5698d6aa2fb0de2600f22594,34352,KLS3551 Kulturledelse,1455104453,2016-02-10 12:40:53,1455104470,17
5698d6aa2fb0de2600f22598,52495,KLS3551 Kulturledelse,1453193775,2016-01-19 09:56:15,1453193956,181
5698d6aa2fb0de2600f22598,31720,KLS3551 Kulturledelse,1453198157,2016-01-19 11:09:17,1453198218,61
5698d6aa2fb0de2600f22598,70154,KLS3551 Kulturledelse,1453205037,2016-01-19 13:03:57,1453205966,929
5698d6aa2fb0de2600f22598,41354,KLS3551 Kulturledelse,1453210555,2016-01-19 14:35:55,1453210605,50
5698d6aa2fb0de2600f22598,3067,KLS3551 Kulturledelse,1453212642,2016-01-19 15:10:42,1453212661,19
5698d6aa2fb0de2600f22598,21624,KLS3551 Kulturledelse,1453214666,2016-01-19 15:44:26,1453214666,0
5698d6aa2fb0de2600f22598,29675,KLS3551 Kulturledelse,1453220869,2016-01-19 17:27:49,1453220869,0
5698d6aa2fb0de2600f22598,25175,KLS3551 Kulturledelse,1453303008,2016-01-20 16:16:48,1453303008,0
5698d6aa2fb0de2600f22598,27966,KLS3551 Kulturledelse,1453381922,2016-01-21 14:12:02,1453381922,0
5698d6aa2fb0de2600f22598,96392,KLS3551 Kulturledelse,1453674598,2016-01-24 23:29:58,1453674610,12
5698d6aa2fb0de2600f22598,18899,KLS3551 Kulturledelse,1453764620,2016-01-26 00:30:20,1453764621,1
5698d6aa2fb0de2600f22598,17208,KLS3551 Kulturledelse,1453795827,2016-01-26 09:10:27,1453795865,38
5698d6aa2fb0de2600f22598,82777,KLS3551 Kulturledelse,1453799801,2016-01-26 10:16:41,1453799892,91
5698d6aa2fb0de2600f22598,17944,KLS3551 Kulturledelse,1453808777,2016-01-26 12:46:17,1453808777,0
5698d6aa2fb0de2600f22598,36912,KLS3551 Kulturledelse,1453822319,2016-01-26 16:31:59,1453822322,3
5698d6aa2fb0de2600f22598,56304,KLS3551 Kulturledelse,1453825250,2016-01-26 17:20:50,1453825393,143
5698d6aa2fb0de2600f22598,58041,KLS3551 Kulturledelse,1453828792,2016-01-26 18:19:52,1453828806,14
5698d6aa2fb0de2600f22598,57198,KLS3551 Kulturledelse,1453830230,2016-01-26 18:43:50,1453830239,9
5698d6aa2fb0de2600f22598,39937,KLS3551 Kulturledelse,1453833630,2016-01-26 19:40:30,1453833648,18
5698d6aa2fb0de2600f22598,6013,KLS3551 Kulturledelse,1453839041,2016-01-26 21:10:41,1453839043,2
5698d6aa2fb0de2600f22598,57415,KLS3551 Kulturledelse,1453926685,2016-01-27 21:31:25,1453926685,0
5698d6aa2fb0de2600f22598,67198,KLS3551 Kulturledelse,1453979732,2016-01-28 12:15:32,1453979732,0
5698d6aa2fb0de2600f22598,12767,KLS3551 Kulturledelse,1453983768,2016-01-28 13:22:48,1453985262,1494
5698d6aa2fb0de2600f22598,65365,KLS3551 Kulturledelse,1453991972,2016-01-28 15:39:32,1453991985,13
5698d6aa2fb0de2600f22598,39084,KLS3551 Kulturledelse,1453997148,2016-01-28 17:05:48,1453997161,13
5698d6aa2fb0de2600f22598,70608,KLS3551 Kulturledelse,1454257399,2016-01-31 17:23:19,1454257399,0
5698d6aa2fb0de2600f22598,88555,KLS3551 Kulturledelse,1454320176,2016-02-01 10:49:36,1454320197,21
5698d6aa2fb0de2600f22598,91271,KLS3551 Kulturledelse,1454324359,2016-02-01 11:59:19,1454324369,10
5698d6aa2fb0de2600f22598,64417,KLS3551 Kulturledelse,1454326511,2016-02-01 12:35:11,1454326513,2
5698d6aa2fb0de2600f22598,68441,KLS3551 Kulturledelse,1454336784,2016-02-01 15:26:24,1454337914,1130
5698d6aa2fb0de2600f22598,7850,KLS3551 Kulturledelse,1454340056,2016-02-01 16:20:56,1454340252,196
5698d6aa2fb0de2600f22598,544,KLS3551 Kulturledelse,1454341476,2016-02-01 16:44:36,1454341478,2
5698d6aa2fb0de2600f22598,77047,KLS3551 Kulturledelse,1454359781,2016-02-01 21:49:41,1454359782,1
5698d6aa2fb0de2600f22598,15452,KLS3551 Kulturledelse,1454400392,2016-02-02 09:06:32,1454400392,0
5698d6aa2fb0de2600f22598,57324,KLS3551 Kulturledelse,1454402882,2016-02-02 09:48:02,1454403053,171
5698d6aa2fb0de2600f22598,15233,KLS3551 Kulturledelse,1454418428,2016-02-02 14:07:08,1454418432,4
5698d6aa2fb0de2600f22598,9402,KLS3551 Kulturledelse,1454420420,2016-02-02 14:40:20,1454420426,6
5698d6aa2fb0de2600f22598,27298,KLS3551 Kulturledelse,1454861487,2016-02-07 17:11:27,1454861572,85
5698d6aa2fb0de2600f22598,23005,KLS3551 Kulturledelse,1454942599,2016-02-08 15:43:19,1454942684,85
5698d6aa2fb0de2600f22598,36847,KLS3551 Kulturledelse,1455016262,2016-02-09 12:11:02,1455016263,1
5698d6aa2fb0de2600f22598,6106,KLS3551 Kulturledelse,1455030210,2016-02-09 16:03:30,1455030214,4
5698d6aa2fb0de2600f22598,4795,KLS3551 Kulturledelse,1455112507,2016-02-10 14:55:07,1455112508,1
5698d6aa41a9d721002400ff,93485,KLS3551 Kulturledelse,1453202203,2016-01-19 12:16:43,1453202257,54
5698d6aa41a9d721002400ff,49758,KLS3551 Kulturledelse,1453204774,2016-01-19 12:59:34,1453204778,4
5698d6aa41a9d721002400ff,62869,KLS3551 Kulturledelse,1453206202,2016-01-19 13:23:22,1453206207,5
5698d6aa41a9d72100240100,32416,KLS3551 Kulturledelse,1453206076,2016-01-19 13:21:16,1453206176,100
5698d6aa41a9d72100240100,25369,KLS3551 Kulturledelse,1453835522,2016-01-26 20:12:02,1453836946,1424
5698d6aa41a9d72100240100,27554,KLS3551 Kulturledelse,1453892784,2016-01-27 12:06:24,1453892795,11
5698d6aa41a9d72100240100,14978,KLS3551 Kulturledelse,1454165378,2016-01-30 15:49:38,1454165885,507
5698d6aa41a9d72100240100,40459,KLS3551 Kulturledelse,1454365924,2016-02-01 23:32:04,1454365925,1
5698d6aa41a9d72100240100,49606,KLS3551 Kulturledelse,1454369373,2016-02-02 00:29:33,1454369379,6
5698d6aa41a9d72100240100,72314,KLS3551 Kulturledelse,1454410257,2016-02-02 11:50:57,1454411391,1134
5698d6aa41a9d72100240101,82406,KLS3551 Kulturledelse,1453126431,2016-01-18 15:13:51,1453126627,196
5698d6aa41a9d72100240101,96060,KLS3551 Kulturledelse,1453204942,2016-01-19 13:02:22,1453205016,74
5698d6aa41a9d72100240101,86647,KLS3551 Kulturledelse,1453368714,2016-01-21 10:31:54,1453368803,89
5698d6aa41a9d72100240101,77649,KLS3551 Kulturledelse,1453459360,2016-01-22 11:42:40,1453459361,1
5698d6aa41a9d72100240101,55499,KLS3551 Kulturledelse,1453723745,2016-01-25 13:09:05,1453724401,656
5698d6aa41a9d72100240101,3699,KLS3551 Kulturledelse,1454379775,2016-02-02 03:22:55,1454379820,45
5698d6aa41a9d72100240101,63246,KLS3551 Kulturledelse,1454411325,2016-02-02 12:08:45,1454411333,8
5698d6aa41a9d72100240101,18377,KLS3551 Kulturledelse,1454415215,2016-02-02 13:13:35,1454415398,183
5698d6aa41a9d72100240101,86025,KLS3551 Kulturledelse,1454504667,2016-02-03 14:04:27,1454504667,0
5698d6aa41a9d72100240102,81400,KLS3551 Kulturledelse,1453151400,2016-01-18 22:10:00,1453151479,79
5698d6aa41a9d72100240102,69088,KLS3551 Kulturledelse,1453209404,2016-01-19 14:16:44,1453209505,101
5698d6aa41a9d72100240102,3162,KLS3551 Kulturledelse,1453806794,2016-01-26 12:13:14,1453807014,220
5698d6aa41a9d72100240102,73579,KLS3551 Kulturledelse,1453812079,2016-01-26 13:41:19,1453812123,44
5698d6aa41a9d72100240102,1977,KLS3551 Kulturledelse,1453814137,2016-01-26 14:15:37,1453814859,722
5698d6aa41a9d72100240102,92298,KLS3551 Kulturledelse,1453822876,2016-01-26 16:41:16,1453822899,23
5698d6aa41a9d72100240102,33519,KLS3551 Kulturledelse,1454362665,2016-02-01 22:37:45,1454363676,1011
5698d6aa41a9d72100240102,4898,KLS3551 Kulturledelse,1454366916,2016-02-01 23:48:36,1454367007,91
5698d6aa41a9d72100240102,68534,KLS3551 Kulturledelse,1454415134,2016-02-02 13:12:14,1454415134,0
5698d6aa41a9d72100240102,85804,KLS3551 Kulturledelse,1454417147,2016-02-02 13:45:47,1454417171,24
5698d6aa41a9d72100240102,78449,KLS3551 Kulturledelse,1454419592,2016-02-02 14:26:32,1454419592,0
5698d6aa41a9d72100240102,6180,KLS3551 Kulturledelse,1454519652,2016-02-03 18:14:12,1454521287,1635
5698d6aa41a9d72100240102,4722,KLS3551 Kulturledelse,1454604205,2016-02-04 17:43:25,1454604237,32
5698d6aa41a9d72100240102,22977,KLS3551 Kulturledelse,1454627305,2016-02-05 00:08:25,1454627705,400
5698d6aa41a9d72100240105,67589,KLS3551 Kulturledelse,1453198803,2016-01-19 11:20:03,1453199610,807
5698d6aa41a9d72100240105,75905,KLS3551 Kulturledelse,1453201322,2016-01-19 12:02:02,1453201367,45
5698d6aa41a9d72100240105,65639,KLS3551 Kulturledelse,1453307108,2016-01-20 17:25:08,1453307108,0
5698d6aa41a9d72100240105,15501,KLS3551 Kulturledelse,1453428003,2016-01-22 03:00:03,1453428004,1
5698d6aa41a9d72100240105,99291,KLS3551 Kulturledelse,1453983271,2016-01-28 13:14:31,1453983539,268
5698d6aa41a9d72100240105,99976,KLS3551 Kulturledelse,1454407989,2016-02-02 11:13:09,1454408123,134
5698d6aa41a9d72100240105,12473,KLS3551 Kulturledelse,1454508028,2016-02-03 15:00:28,1454508028,0
5698d6ab2fb0de2600f225ad,98018,KLS3551 Kulturledelse,1452872070,2016-01-15 16:34:30,1452872182,112
5698d6ab2fb0de2600f225ad,16957,KLS3551 Kulturledelse,1452873403,2016-01-15 16:56:43,1452873403,0
5698d6ab2fb0de2600f225ad,85726,KLS3551 Kulturledelse,1453109900,2016-01-18 10:38:20,1453109925,25
5698d6ab2fb0de2600f225ad,72767,KLS3551 Kulturledelse,1453113473,2016-01-18 11:37:53,1453113482,9
5698d6ab2fb0de2600f225ad,77546,KLS3551 Kulturledelse,1453124971,2016-01-18 14:49:31,1453125264,293
5698d6ab2fb0de2600f225ad,19372,KLS3551 Kulturledelse,1453126759,2016-01-18 15:19:19,1453126865,106
5698d6ab2fb0de2600f225ad,60950,KLS3551 Kulturledelse,1453203627,2016-01-19 12:40:27,1453203647,20
5698d6ab2fb0de2600f225ad,75640,KLS3551 Kulturledelse,1453545970,2016-01-23 11:46:10,1453545989,19
5698d6ab2fb0de2600f225ad,26993,KLS3551 Kulturledelse,1453810242,2016-01-26 13:10:42,1453810598,356
5698d6ab2fb0de2600f225ad,23185,KLS3551 Kulturledelse,1454406277,2016-02-02 10:44:37,1454406281,4
5698d6ab2fb0de2600f225ad,353,KLS3551 Kulturledelse,1454411319,2016-02-02 12:08:39,1454411363,44
5698d6ab2fb0de2600f225ad,99548,KLS3551 Kulturledelse,1454414236,2016-02-02 12:57:16,1454414245,9
5698d6ab2fb0de2600f225ad,14099,KLS3551 Kulturledelse,1454976178,2016-02-09 01:02:58,1454976197,19
5698d6ab2fb0de2600f225b0,39932,KLS3551 Kulturledelse,1452865227,2016-01-15 14:40:27,1452865294,67
5698d6ab2fb0de2600f225b0,89720,KLS3551 Kulturledelse,1453204719,2016-01-19 12:58:39,1453205456,737
5698d6ab2fb0de2600f225b0,96619,KLS3551 Kulturledelse,1453210231,2016-01-19 14:30:31,1453210231,0
5698d6ab2fb0de2600f225b0,66108,KLS3551 Kulturledelse,1453226322,2016-01-19 18:58:42,1453226351,29
5698d6ab2fb0de2600f225b0,9495,KLS3551 Kulturledelse,1453819209,2016-01-26 15:40:09,1453819543,334
5698d6ab2fb0de2600f225b0,95648,KLS3551 Kulturledelse,1453821228,2016-01-26 16:13:48,1453821233,5
5698d6ab2fb0de2600f225b0,93586,KLS3551 Kulturledelse,1453823293,2016-01-26 16:48:13,1453823293,0
5698d6ab2fb0de2600f225b0,26537,KLS3551 Kulturledelse,1453824881,2016-01-26 17:14:41,1453824885,4
5698d6ab2fb0de2600f225b0,23289,KLS3551 Kulturledelse,1454894517,2016-02-08 02:21:57,1454894560,43
5698d6ab2fb0de2600f225b0,21011,KLS3551 Kulturledelse,1455097689,2016-02-10 10:48:09,1455097689,0
5698d6ab2fb0de2600f225b1,76569,KLS3551 Kulturledelse,1452862292,2016-01-15 13:51:32,1452862479,187
5698d6ab2fb0de2600f225b1,25951,KLS3551 Kulturledelse,1453047893,2016-01-17 17:24:53,1453048504,611
5698d6ab2fb0de2600f225b1,52179,KLS3551 Kulturledelse,1453130986,2016-01-18 16:29:46,1453130990,4
5698d6ab2fb0de2600f225b1,61526,KLS3551 Kulturledelse,1453205024,2016-01-19 13:03:44,1453205895,871
5698d6ab2fb0de2600f225b1,96030,KLS3551 Kulturledelse,1453209130,2016-01-19 14:12:10,1453209234,104
5698d6ab2fb0de2600f225b1,70085,KLS3551 Kulturledelse,1453671842,2016-01-24 22:44:02,1453672948,1106
5698d6ab2fb0de2600f225b1,69881,KLS3551 Kulturledelse,1453674381,2016-01-24 23:26:21,1453674435,54
5698d6ab2fb0de2600f225b1,91354,KLS3551 Kulturledelse,1453806112,2016-01-26 12:01:52,1453806185,73
5698d6ab2fb0de2600f225b1,46276,KLS3551 Kulturledelse,1453811048,2016-01-26 13:24:08,1453811052,4
5698d6ab2fb0de2600f225b1,60487,KLS3551 Kulturledelse,1453827488,2016-01-26 17:58:08,1453827488,0
5698d6ab2fb0de2600f225b1,90199,KLS3551 Kulturledelse,1453895620,2016-01-27 12:53:40,1453895635,15
5698d6ab2fb0de2600f225b1,28209,KLS3551 Kulturledelse,1453899369,2016-01-27 13:56:09,1453899963,594
5698d6ab2fb0de2600f225b1,66477,KLS3551 Kulturledelse,1453912259,2016-01-27 17:30:59,1453912259,0
5698d6ab2fb0de2600f225b1,79242,KLS3551 Kulturledelse,1454081477,2016-01-29 16:31:17,1454081560,83
5698d6ab2fb0de2600f225b1,179,KLS3551 Kulturledelse,1454341780,2016-02-01 16:49:40,1454341815,35
5698d6ab2fb0de2600f225b1,8255,KLS3551 Kulturledelse,1454403311,2016-02-02 09:55:11,1454403446,135
5698d6ab2fb0de2600f225b1,78548,KLS3551 Kulturledelse,1454411201,2016-02-02 12:06:41,1454411375,174
5698d6ab2fb0de2600f225b1,77477,KLS3551 Kulturledelse,1454415978,2016-02-02 13:26:18,1454416944,966
5698d6ab2fb0de2600f225b1,3436,KLS3551 Kulturledelse,1454422787,2016-02-02 15:19:47,1454422829,42
5698d6ab2fb0de2600f225b1,55420,KLS3551 Kulturledelse,1454792528,2016-02-06 22:02:08,1454792577,49
5698d6ab2fb0de2600f225b1,81413,KLS3551 Kulturledelse,1454920828,2016-02-08 09:40:28,1454921069,241
5698d6ab2fb0de2600f225b1,43909,KLS3551 Kulturledelse,1454941424,2016-02-08 15:23:44,1454942499,1075
5698d6ab2fb0de2600f225b1,61963,KLS3551 Kulturledelse,1455112511,2016-02-10 14:55:11,1455112514,3
5698d6ab2fb0de2600f225b1,11827,KLS3551 Kulturledelse,1455282134,2016-02-12 14:02:14,1455282142,8
5698d6ab2fb0de2600f225b1,60643,KLS3551 Kulturledelse,1455361578,2016-02-13 12:06:18,1455361594,16
5698d6ab41a9d7210024011b,63126,KLS3551 Kulturledelse,1453201464,2016-01-19 12:04:24,1453202497,1033
5698d6ab41a9d7210024011b,37667,KLS3551 Kulturledelse,1453203872,2016-01-19 12:44:32,1453206203,2331
5698d6ab41a9d7210024011b,97094,KLS3551 Kulturledelse,1453211641,2016-01-19 14:54:01,1453211641,0
5698d6ab41a9d7210024011b,98832,KLS3551 Kulturledelse,1453810907,2016-01-26 13:21:47,1453810981,74
5698d6ab41a9d7210024011b,85678,KLS3551 Kulturledelse,1454067127,2016-01-29 12:32:07,1454068140,1013
5698d6ab41a9d7210024011b,36256,KLS3551 Kulturledelse,1454070977,2016-01-29 13:36:17,1454070992,15
5698d6ab41a9d7210024011b,78069,KLS3551 Kulturledelse,1454072754,2016-01-29 14:05:54,1454073057,303
5698d6ab41a9d7210024011b,47242,KLS3551 Kulturledelse,1454336897,2016-02-01 15:28:17,1454337114,217
5698d6ab41a9d7210024011b,90295,KLS3551 Kulturledelse,1454537755,2016-02-03 23:15:55,1454539083,1328
5698d6ab41a9d7210024011d,93034,KLS3551 Kulturledelse,1453658967,2016-01-24 19:09:27,1453659351,384
5698d6ab41a9d7210024011d,97126,KLS3551 Kulturledelse,1453746337,2016-01-25 19:25:37,1453746348,11
5698d6ab41a9d7210024011d,16962,KLS3551 Kulturledelse,1453764015,2016-01-26 00:20:15,1453764020,5
5698d6ab41a9d7210024011d,16449,KLS3551 Kulturledelse,1453804565,2016-01-26 11:36:05,1453804576,11
5698d6ab41a9d7210024011d,8934,KLS3551 Kulturledelse,1453806209,2016-01-26 12:03:29,1453806220,11
5698d6ab41a9d7210024011d,58976,KLS3551 Kulturledelse,1453808027,2016-01-26 12:33:47,1453808800,773
5698d6ab41a9d7210024011d,67383,KLS3551 Kulturledelse,1453813534,2016-01-26 14:05:34,1453813634,100
5698d6ab41a9d7210024011d,12257,KLS3551 Kulturledelse,1454336149,2016-02-01 15:15:49,1454336158,9
5698d6ab41a9d7210024011d,77355,KLS3551 Kulturledelse,1454337576,2016-02-01 15:39:36,1454337580,4
5698d6ab41a9d7210024011d,60191,KLS3551 Kulturledelse,1454340052,2016-02-01 16:20:52,1454340053,1
5698d6ab41a9d7210024011d,21885,KLS3551 Kulturledelse,1454361504,2016-02-01 22:18:24,1454361504,0
5698d6ab41a9d7210024011d,23606,KLS3551 Kulturledelse,1454409089,2016-02-02 11:31:29,1454409523,434
5698d6ab41a9d7210024011d,30806,KLS3551 Kulturledelse,1454414653,2016-02-02 13:04:13,1454415390,737
5698d6ab41a9d7210024011d,45258,KLS3551 Kulturledelse,1454417565,2016-02-02 13:52:45,1454417593,28
5698d6ab41a9d7210024011d,7130,KLS3551 Kulturledelse,1454419894,2016-02-02 14:31:34,1454420187,293
5698d6ab41a9d7210024011d,29808,KLS3551 Kulturledelse,1455030216,2016-02-09 16:03:36,1455030217,1
5698d6ab41a9d7210024011d,78384,KLS3551 Kulturledelse,1455031466,2016-02-09 16:24:26,1455031467,1
5698d6ac2fb0de2600f225b2,60691,KLS3551 Kulturledelse,1454269182,2016-01-31 20:39:42,1454269246,64
5698d6ac2fb0de2600f225b2,76657,KLS3551 Kulturledelse,1455192428,2016-02-11 13:07:08,1455193123,695
5698d6ac2fb0de2600f225b3,62804,KLS3551 Kulturledelse,1453113326,2016-01-18 11:35:26,1453113551,225
5698d6ac2fb0de2600f225b3,60451,KLS3551 Kulturledelse,1453125030,2016-01-18 14:50:30,1453125042,12
5698d6ac2fb0de2600f225b3,69250,KLS3551 Kulturledelse,1453134937,2016-01-18 17:35:37,1453135065,128
5698d6ac2fb0de2600f225b3,28491,KLS3551 Kulturledelse,1454317894,2016-02-01 10:11:34,1454318904,1010
5698d6ac2fb0de2600f225b3,35870,KLS3551 Kulturledelse,1454320612,2016-02-01 10:56:52,1454320612,0
5698d6ac2fb0de2600f225b3,19771,KLS3551 Kulturledelse,1454325346,2016-02-01 12:15:46,1454325346,0
5698d6ac2fb0de2600f225b3,51654,KLS3551 Kulturledelse,1454328031,2016-02-01 13:00:31,1454328031,0
5698d6ac2fb0de2600f225b3,89547,KLS3551 Kulturledelse,1454349986,2016-02-01 19:06:26,1454350124,138
5698d6ac2fb0de2600f225b3,17462,KLS3551 Kulturledelse,1454351784,2016-02-01 19:36:24,1454351808,24
5698d6ac2fb0de2600f225b3,45332,KLS3551 Kulturledelse,1454361446,2016-02-01 22:17:26,1454361501,55
5698d6ac2fb0de2600f225b3,37801,KLS3551 Kulturledelse,1454590607,2016-02-04 13:56:47,1454590617,10
5698d6ac2fb0de2600f225b3,21476,KLS3551 Kulturledelse,1454971960,2016-02-08 23:52:40,1454972063,103
5698d6ac2fb0de2600f225b3,64853,KLS3551 Kulturledelse,1455099588,2016-02-10 11:19:48,1455099611,23
5698d6ac2fb0de2600f225b3,37188,KLS3551 Kulturledelse,1455284217,2016-02-12 14:36:57,1455284389,172
5698d6ac2fb0de2600f225b5,38428,KLS3551 Kulturledelse,1454078128,2016-01-29 15:35:28,1454078292,164
5698d6ac2fb0de2600f225b5,81285,KLS3551 Kulturledelse,1454313694,2016-02-01 09:01:34,1454313698,4
5698d6ac2fb0de2600f225b5,54087,KLS3551 Kulturledelse,1454323688,2016-02-01 11:48:08,1454324183,495
5698d6ac2fb0de2600f225b5,15333,KLS3551 Kulturledelse,1454409290,2016-02-02 11:34:50,1454409299,9
5698d6ac2fb0de2600f225b7,11981,KLS3551 Kulturledelse,1453114038,2016-01-18 11:47:18,1453114305,267
5698d6ac2fb0de2600f225b7,5076,KLS3551 Kulturledelse,1453466957,2016-01-22 13:49:17,1453467336,379
5698d6ac2fb0de2600f225b7,78679,KLS3551 Kulturledelse,1453828225,2016-01-26 18:10:25,1453828327,102
5698d6ac2fb0de2600f225b7,70668,KLS3551 Kulturledelse,1453832647,2016-01-26 19:24:07,1453832648,1
5698d6ac2fb0de2600f225b7,85401,KLS3551 Kulturledelse,1453848344,2016-01-26 23:45:44,1453848665,321
5698d6ac2fb0de2600f225b7,10574,KLS3551 Kulturledelse,1453878332,2016-01-27 08:05:32,1453878365,33
5698d6ac2fb0de2600f225b7,95152,KLS3551 Kulturledelse,1454063520,2016-01-29 11:32:00,1454063745,225
5698d6ac2fb0de2600f225b7,41609,KLS3551 Kulturledelse,1454065061,2016-01-29 11:57:41,1454065263,202
5698d6ac2fb0de2600f225b7,87863,KLS3551 Kulturledelse,1454404400,2016-02-02 10:13:20,1454405000,600
5698d6ac2fb0de2600f225b7,21754,KLS3551 Kulturledelse,1454416658,2016-02-02 13:37:38,1454417824,1166
5698d6ac2fb0de2600f225bc,98523,KLS3551 Kulturledelse,1452864790,2016-01-15 14:33:10,1452864856,66
5698d6ac2fb0de2600f225bc,20149,KLS3551 Kulturledelse,1452986686,2016-01-17 00:24:46,1452986689,3
5698d6ac2fb0de2600f225bc,1487,KLS3551 Kulturledelse,1453066819,2016-01-17 22:40:19,1453066820,1
5698d6ac2fb0de2600f225bc,24921,KLS3551 Kulturledelse,1453159961,2016-01-19 00:32:41,1453159984,23
5698d6ac2fb0de2600f225bc,84385,KLS3551 Kulturledelse,1453826395,2016-01-26 17:39:55,1453826517,122
5698d6ac2fb0de2600f225bc,58186,KLS3551 Kulturledelse,1454366643,2016-02-01 23:44:03,1454366652,9
5698d6ac2fb0de2600f225bc,37647,KLS3551 Kulturledelse,1454372022,2016-02-02 01:13:42,1454374256,2234
5698d6ac2fb0de2600f225bc,59027,KLS3551 Kulturledelse,1454377101,2016-02-02 02:38:21,1454377863,762
5698d6ac2fb0de2600f225bc,46312,KLS3551 Kulturledelse,1454410789,2016-02-02 11:59:49,1454411346,557
5698d6ac2fb0de2600f225bc,32295,KLS3551 Kulturledelse,1454412907,2016-02-02 12:35:07,1454412945,38
5698d6ac2fb0de2600f225bc,58951,KLS3551 Kulturledelse,1454415065,2016-02-02 13:11:05,1454415093,28
5698d6ac2fb0de2600f225bc,17908,KLS3551 Kulturledelse,1454419200,2016-02-02 14:20:00,1454419293,93
5698d6ac2fb0de2600f225bc,61162,KLS3551 Kulturledelse,1454432773,2016-02-02 18:06:13,1454432888,115
5698d6ac2fb0de2600f225bc,37630,KLS3551 Kulturledelse,1454679871,2016-02-05 14:44:31,1454679875,4
5698d6ac2fb0de2600f225bc,66560,KLS3551 Kulturledelse,1454681109,2016-02-05 15:05:09,1454681111,2
5698d6ac2fb0de2600f225bc,38790,KLS3551 Kulturledelse,1454933147,2016-02-08 13:05:47,1454933152,5
5698d6ac2fb0de2600f225bc,12167,KLS3551 Kulturledelse,1455020004,2016-02-09 13:13:24,1455020005,1
5698d6ac2fb0de2600f225bc,44749,KLS3551 Kulturledelse,1455039152,2016-02-09 18:32:32,1455039152,0
5698d6ac2fb0de2600f225bc,4870,KLS3551 Kulturledelse,1455192501,2016-02-11 13:08:21,1455193592,1091
5698d6ac2fb0de2600f225bc,44938,KLS3551 Kulturledelse,1455396510,2016-02-13 21:48:30,1455396511,1
5698d6ac41a9d7210024011e,70349,KLS3551 Kulturledelse,1453204999,2016-01-19 13:03:19,1453206004,1005
5698d6ac41a9d7210024011e,72327,KLS3551 Kulturledelse,1453802741,2016-01-26 11:05:41,1453802787,46
5698d6ac41a9d7210024011e,11730,KLS3551 Kulturledelse,1453982537,2016-01-28 13:02:17,1453982560,23
5698d6ac41a9d7210024011e,70577,KLS3551 Kulturledelse,1453986840,2016-01-28 14:14:00,1453987642,802
5698d6ac41a9d7210024011e,88181,KLS3551 Kulturledelse,1454274824,2016-01-31 22:13:44,1454274824,0
5698d6ac41a9d7210024011e,47164,KLS3551 Kulturledelse,1454331645,2016-02-01 14:00:45,1454331648,3
5698d6ac41a9d7210024011e,77421,KLS3551 Kulturledelse,1454362675,2016-02-01 22:37:55,1454362675,0
5698d6ac41a9d7210024011e,18204,KLS3551 Kulturledelse,1454422752,2016-02-02 15:19:12,1454422754,2
5698d6ac41a9d7210024011e,40605,KLS3551 Kulturledelse,1454448441,2016-02-02 22:27:21,1454448516,75
5698d6ac41a9d7210024011e,51744,KLS3551 Kulturledelse,1454943919,2016-02-08 16:05:19,1454943920,1
5698d6ac41a9d7210024011e,56805,KLS3551 Kulturledelse,1455023475,2016-02-09 14:11:15,1455023475,0
5698d6ac41a9d72100240120,84333,KLS3551 Kulturledelse,1453200083,2016-01-19 11:41:23,1453201568,1485
5698d6ac41a9d72100240120,58448,KLS3551 Kulturledelse,1453204636,2016-01-19 12:57:16,1453205868,1232
5698d6ac41a9d72100240120,22566,KLS3551 Kulturledelse,1453207595,2016-01-19 13:46:35,1453208598,1003
5698d6ac41a9d72100240120,23742,KLS3551 Kulturledelse,1453804141,2016-01-26 11:29:01,1453804226,85
5698d6ac41a9d72100240120,1795,KLS3551 Kulturledelse,1453903243,2016-01-27 15:00:43,1453903243,0
5698d6ac41a9d72100240120,61113,KLS3551 Kulturledelse,1453906451,2016-01-27 15:54:11,1453906456,5
5698d6ac41a9d72100240120,92810,KLS3551 Kulturledelse,1454341401,2016-02-01 16:43:21,1454341542,141
5698d6ac41a9d72100240120,25651,KLS3551 Kulturledelse,1454363353,2016-02-01 22:49:13,1454364423,1070
5698d6ac41a9d72100240120,1474,KLS3551 Kulturledelse,1454366410,2016-02-01 23:40:10,1454366418,8
5698d6ac41a9d72100240120,36134,KLS3551 Kulturledelse,1454410621,2016-02-02 11:57:01,1454410623,2
5698d6ac41a9d72100240120,70120,KLS3551 Kulturledelse,1454411835,2016-02-02 12:17:15,1454411835,0
5698d6ac41a9d72100240120,62020,KLS3551 Kulturledelse,1454415229,2016-02-02 13:13:49,1454415246,17
5698d6ac41a9d72100240120,9318,KLS3551 Kulturledelse,1455018069,2016-02-09 12:41:09,1455018086,17
5698d6ac41a9d72100240121,53431,KLS3551 Kulturledelse,1453108390,2016-01-18 10:13:10,1453109371,981
5698d6ac41a9d72100240121,83317,nan,1453114720,2016-01-18 11:58:40,1453114844,124
5698d6ac41a9d72100240121,21598,KLS3551 Kulturledelse,1453134141,2016-01-18 17:22:21,1453134346,205
5698d6ac41a9d72100240121,25975,KLS3551 Kulturledelse,1453204337,2016-01-19 12:52:17,1453205865,1528
5698d6ac41a9d72100240121,5115,KLS3551 Kulturledelse,1453386264,2016-01-21 15:24:24,1453386264,0
5698d6ac41a9d72100240121,89695,KLS3551 Kulturledelse,1453740120,2016-01-25 17:42:00,1453740120,0
5698d6ac41a9d72100240121,86971,KLS3551 Kulturledelse,1453819114,2016-01-26 15:38:34,1453819907,793
5698d6ac41a9d72100240121,10459,KLS3551 Kulturledelse,1453823195,2016-01-26 16:46:35,1453823200,5
5698d6ac41a9d72100240121,83199,KLS3551 Kulturledelse,1453825999,2016-01-26 17:33:19,1453826025,26
5698d6ac41a9d72100240121,92825,KLS3551 Kulturledelse,1453899640,2016-01-27 14:00:40,1453899640,0
5698d6ac41a9d72100240121,37015,KLS3551 Kulturledelse,1453903165,2016-01-27 14:59:25,1453905255,2090
5698d6ac41a9d72100240121,62841,KLS3551 Kulturledelse,1453912230,2016-01-27 17:30:30,1453913206,976
5698d6ac41a9d72100240121,39621,KLS3551 Kulturledelse,1453991628,2016-01-28 15:33:48,1453991628,0
5698d6ac41a9d72100240121,86218,KLS3551 Kulturledelse,1454163969,2016-01-30 15:26:09,1454163969,0
5698d6ac41a9d72100240121,89905,KLS3551 Kulturledelse,1454255479,2016-01-31 16:51:19,1454255479,0
5698d6ac41a9d72100240121,54969,KLS3551 Kulturledelse,1454258568,2016-01-31 17:42:48,1454258569,1
5698d6ac41a9d72100240121,85988,KLS3551 Kulturledelse,1454313929,2016-02-01 09:05:29,1454313929,0
5698d6ac41a9d72100240121,22869,KLS3551 Kulturledelse,1454320563,2016-02-01 10:56:03,1454320563,0
5698d6ac41a9d72100240121,2287,KLS3551 Kulturledelse,1454336455,2016-02-01 15:20:55,1454336455,0
5698d6ac41a9d72100240121,27888,KLS3551 Kulturledelse,1454349772,2016-02-01 19:02:52,1454350152,380
5698d6ac41a9d72100240121,80295,KLS3551 Kulturledelse,1454359046,2016-02-01 21:37:26,1454359047,1
5698d6ac41a9d72100240121,31273,KLS3551 Kulturledelse,1454407125,2016-02-02 10:58:45,1454407126,1
5698d6ac41a9d72100240121,30738,KLS3551 Kulturledelse,1454412630,2016-02-02 12:30:30,1454412630,0
5698d6ac41a9d72100240121,63151,KLS3551 Kulturledelse,1454415078,2016-02-02 13:11:18,1454415114,36
5698d6ac41a9d72100240121,89444,KLS3551 Kulturledelse,1454424355,2016-02-02 15:45:55,1454424355,0
5698d6ac41a9d72100240121,59660,KLS3551 Kulturledelse,1454668584,2016-02-05 11:36:24,1454668584,0
5698d6ac41a9d72100240122,45686,KLS3551 Kulturledelse,1454076949,2016-01-29 15:15:49,1454077148,199
5698d6ac41a9d72100240123,18703,KLS3551 Kulturledelse,1453149251,2016-01-18 21:34:11,1453149713,462
5698d6ac41a9d72100240123,56681,KLS3551 Kulturledelse,1453194202,2016-01-19 10:03:22,1453194207,5
5698d6ac41a9d72100240123,68108,KLS3551 Kulturledelse,1453205932,2016-01-19 13:18:52,1453205983,51
5698d6ac41a9d72100240123,78462,KLS3551 Kulturledelse,1453493184,2016-01-22 21:06:24,1453493185,1
5698d6ac41a9d72100240123,9689,KLS3551 Kulturledelse,1453722161,2016-01-25 12:42:41,1453722767,606
5698d6ac41a9d72100240123,88633,KLS3551 Kulturledelse,1453816881,2016-01-26 15:01:21,1453816895,14
5698d6ac41a9d72100240123,74567,KLS3551 Kulturledelse,1454328977,2016-02-01 13:16:17,1454329098,121
5698d6ac41a9d72100240123,16661,KLS3551 Kulturledelse,1454349509,2016-02-01 18:58:29,1454350068,559
5698d6ac41a9d72100240123,39358,KLS3551 Kulturledelse,1454504948,2016-02-03 14:09:08,1454504959,11
5698d6ac41a9d72100240123,12529,KLS3551 Kulturledelse,1455019187,2016-02-09 12:59:47,1455019293,106
5698d6ac41a9d72100240123,244,KLS3551 Kulturledelse,1455453278,2016-02-14 13:34:38,1455453278,0
5698d6ac41a9d72100240129,71755,KLS3551 Kulturledelse,1452889608,2016-01-15 21:26:48,1452890367,759
5698d6ac41a9d72100240129,14645,KLS3551 Kulturledelse,1453223136,2016-01-19 18:05:36,1453223531,395
5698d6ac41a9d72100240129,90215,KLS3551 Kulturledelse,1453238287,2016-01-19 22:18:07,1453238288,1
5698d6ac41a9d72100240129,13980,KLS3551 Kulturledelse,1453817412,2016-01-26 15:10:12,1453817507,95
5698d6ac41a9d72100240129,5759,KLS3551 Kulturledelse,1453919306,2016-01-27 19:28:26,1453921034,1728
5698d6ac41a9d72100240129,78501,KLS3551 Kulturledelse,1454277705,2016-01-31 23:01:45,1454277782,77
5698d6ac41a9d72100240129,17093,KLS3551 Kulturledelse,1454340977,2016-02-01 16:36:17,1454340999,22
5698d6ac41a9d72100240129,88551,KLS3551 Kulturledelse,1454367126,2016-02-01 23:52:06,1454367222,96
5698d6ac41a9d72100240129,38801,KLS3551 Kulturledelse,1454370695,2016-02-02 00:51:35,1454370709,14
5698d6ac41a9d72100240129,56090,KLS3551 Kulturledelse,1454435625,2016-02-02 18:53:45,1454435870,245
5698d6ac41a9d72100240129,68913,KLS3551 Kulturledelse,1454886670,2016-02-08 00:11:10,1454886683,13
5698da4341a9d7210024068e,34362,MRK3480 Forbrukeratferd,1453118905,2016-01-18 13:08:25,1453119431,526
5698da4341a9d7210024068e,50633,MRK3480 Forbrukeratferd,1453391293,2016-01-21 16:48:13,1453391302,9
5698da4341a9d7210024068e,6337,MRK3480 Forbrukeratferd,1453393235,2016-01-21 17:20:35,1453393277,42
5698da4341a9d7210024068e,22604,MRK3480 Forbrukeratferd,1453811281,2016-01-26 13:28:01,1453811464,183
5698da4341a9d7210024068e,42803,MRK3480 Forbrukeratferd,1453925726,2016-01-27 21:15:26,1453925727,1
5698da4341a9d7210024068e,46395,MRK3480 Forbrukeratferd,1454613662,2016-02-04 20:21:02,1454613665,3
5698da4341a9d7210024068e,41958,MRK3480 Forbrukeratferd,1454673630,2016-02-05 13:00:30,1454674663,1033
5698da4341a9d7210024068e,10729,MRK3480 Forbrukeratferd,1454677167,2016-02-05 13:59:27,1454677637,470
5698da452fb0de2600f22972,77277,MRK3480 Forbrukeratferd,1453898104,2016-01-27 13:35:04,1453899681,1577
5698da452fb0de2600f22972,4874,MRK3480 Forbrukeratferd,1455111874,2016-02-10 14:44:34,1455112076,202
5698da452fb0de2600f22973,47054,MRK3480 Forbrukeratferd,1453048890,2016-01-17 17:41:30,1453050620,1730
5698da452fb0de2600f22973,51302,MRK3480 Forbrukeratferd,1453052206,2016-01-17 18:36:46,1453052250,44
5698da452fb0de2600f22973,71168,MRK3480 Forbrukeratferd,1454013444,2016-01-28 21:37:24,1454013664,220
5698da452fb0de2600f22973,33395,MRK3480 Forbrukeratferd,1455129774,2016-02-10 19:42:54,1455129780,6
5698da452fb0de2600f22974,54083,MRK3480 Forbrukeratferd,1453333416,2016-01-21 00:43:36,1453333632,216
5698da452fb0de2600f22974,61660,MRK3480 Forbrukeratferd,1453804617,2016-01-26 11:36:57,1453805434,817
5698da452fb0de2600f22974,83395,MRK3480 Forbrukeratferd,1454675156,2016-02-05 13:25:56,1454675297,141
5698da452fb0de2600f22974,68375,MRK3480 Forbrukeratferd,1455217538,2016-02-11 20:05:38,1455217657,119
5698da452fb0de2600f22976,90352,MRK3480 Forbrukeratferd,1453114166,2016-01-18 11:49:26,1453114205,39
5698da452fb0de2600f22976,99158,MRK3480 Forbrukeratferd,1453366600,2016-01-21 09:56:40,1453366743,143
5698da452fb0de2600f22976,84095,MRK3480 Forbrukeratferd,1453377880,2016-01-21 13:04:40,1453378345,465
5698da452fb0de2600f22976,60436,MRK3480 Forbrukeratferd,1453383152,2016-01-21 14:32:32,1453383177,25
5698da452fb0de2600f22976,14967,MRK3480 Forbrukeratferd,1453389046,2016-01-21 16:10:46,1453389181,135
5698da452fb0de2600f22976,472,MRK3480 Forbrukeratferd,1453468357,2016-01-22 14:12:37,1453468440,83
5698da452fb0de2600f22976,61488,MRK3480 Forbrukeratferd,1453715011,2016-01-25 10:43:31,1453715026,15
5698da452fb0de2600f22976,78468,MRK3480 Forbrukeratferd,1453718949,2016-01-25 11:49:09,1453718957,8
5698da452fb0de2600f22976,69110,MRK3480 Forbrukeratferd,1453720783,2016-01-25 12:19:43,1453720795,12
5698da452fb0de2600f22976,36799,MRK3480 Forbrukeratferd,1453724164,2016-01-25 13:16:04,1453724183,19
5698da452fb0de2600f22976,65242,MRK3480 Forbrukeratferd,1453816685,2016-01-26 14:58:05,1453816686,1
5698da452fb0de2600f22976,35323,MRK3480 Forbrukeratferd,1453929667,2016-01-27 22:21:07,1453929755,88
5698da452fb0de2600f22976,98400,MRK3480 Forbrukeratferd,1453979907,2016-01-28 12:18:27,1453979920,13
5698da452fb0de2600f22976,57540,MRK3480 Forbrukeratferd,1453987106,2016-01-28 14:18:26,1453987136,30
5698da452fb0de2600f22976,55677,MRK3480 Forbrukeratferd,1454060991,2016-01-29 10:49:51,1454061016,25
5698da452fb0de2600f22976,92009,MRK3480 Forbrukeratferd,1454324718,2016-02-01 12:05:18,1454324777,59
5698da452fb0de2600f22976,87083,MRK3480 Forbrukeratferd,1454326995,2016-02-01 12:43:15,1454327091,96
5698da452fb0de2600f22976,92623,MRK3480 Forbrukeratferd,1454329329,2016-02-01 13:22:09,1454329399,70
5698da452fb0de2600f22976,20499,MRK3480 Forbrukeratferd,1454578262,2016-02-04 10:31:02,1454578263,1
5698da452fb0de2600f22976,31241,MRK3480 Forbrukeratferd,1454668994,2016-02-05 11:43:14,1454669628,634
5698da452fb0de2600f22976,49202,MRK3480 Forbrukeratferd,1454670913,2016-02-05 12:15:13,1454670991,78
5698da452fb0de2600f22976,28271,MRK3480 Forbrukeratferd,1454856558,2016-02-07 15:49:18,1454856559,1
5698da452fb0de2600f22976,73634,MRK3480 Forbrukeratferd,1455043901,2016-02-09 19:51:41,1455043908,7
5698da452fb0de2600f22976,69160,MRK3480 Forbrukeratferd,1455049835,2016-02-09 21:30:35,1455049850,15
5698da452fb0de2600f22976,1183,MRK3480 Forbrukeratferd,1455102189,2016-02-10 12:03:09,1455102203,14
5698da452fb0de2600f22976,98364,MRK3480 Forbrukeratferd,1455179625,2016-02-11 09:33:45,1455179635,10
5698da452fb0de2600f22976,15865,MRK3480 Forbrukeratferd,1455456717,2016-02-14 14:31:57,1455456717,0
5698da452fb0de2600f22977,39824,MRK3480 Forbrukeratferd,1453056592,2016-01-17 19:49:52,1453056592,0
5698da452fb0de2600f22977,1266,MRK3480 Forbrukeratferd,1453060345,2016-01-17 20:52:25,1453060345,0
5698da452fb0de2600f22977,84040,MRK3480 Forbrukeratferd,1453283941,2016-01-20 10:59:01,1453283983,42
5698da452fb0de2600f22977,64010,MRK3480 Forbrukeratferd,1453826203,2016-01-26 17:36:43,1453826633,430
5698da452fb0de2600f22977,57002,MRK3480 Forbrukeratferd,1454273237,2016-01-31 21:47:17,1454273237,0
5698da452fb0de2600f22977,28967,MRK3480 Forbrukeratferd,1455133241,2016-02-10 20:40:41,1455133241,0
5698da452fb0de2600f22978,67794,MRK3480 Forbrukeratferd,1452899366,2016-01-16 00:09:26,1452899548,182
5698da452fb0de2600f22978,32405,MRK3480 Forbrukeratferd,1453158575,2016-01-19 00:09:35,1453158644,69
5698da452fb0de2600f22978,30830,MRK3480 Forbrukeratferd,1453507086,2016-01-23 00:58:06,1453507086,0
5698da452fb0de2600f22978,45442,MRK3480 Forbrukeratferd,1453795663,2016-01-26 09:07:43,1453795685,22
5698da452fb0de2600f22978,15661,MRK3480 Forbrukeratferd,1453799967,2016-01-26 10:19:27,1453800508,541
5698da452fb0de2600f22978,64522,MRK3480 Forbrukeratferd,1453926878,2016-01-27 21:34:38,1453927064,186
5698da452fb0de2600f22978,60786,MRK3480 Forbrukeratferd,1453995827,2016-01-28 16:43:47,1453996210,383
5698da452fb0de2600f22978,45137,MRK3480 Forbrukeratferd,1454462756,2016-02-03 02:25:56,1454462812,56
5698da452fb0de2600f22978,13930,MRK3480 Forbrukeratferd,1454866949,2016-02-07 18:42:29,1454866957,8
5698da452fb0de2600f22978,45243,MRK3480 Forbrukeratferd,1454975953,2016-02-09 00:59:13,1454975967,14
5698da452fb0de2600f22978,2438,MRK3480 Forbrukeratferd,1455146105,2016-02-11 00:15:05,1455146105,0
5698da452fb0de2600f22978,79589,MRK3480 Forbrukeratferd,1455147323,2016-02-11 00:35:23,1455147326,3
5698da452fb0de2600f22979,99804,MRK3480 Forbrukeratferd,1453040841,2016-01-17 15:27:21,1453040921,80
5698da452fb0de2600f22979,66026,MRK3480 Forbrukeratferd,1453462236,2016-01-22 12:30:36,1453462462,226
5698da452fb0de2600f22979,24035,MRK3480 Forbrukeratferd,1453805085,2016-01-26 11:44:45,1453805416,331
5698da452fb0de2600f22979,59476,MRK3480 Forbrukeratferd,1454670005,2016-02-05 12:00:05,1454670935,930
5698da452fb0de2600f22979,9050,MRK3480 Forbrukeratferd,1454716832,2016-02-06 01:00:32,1454716832,0
5698da452fb0de2600f22979,51969,MRK3480 Forbrukeratferd,1455275047,2016-02-12 12:04:07,1455275099,52
5698da452fb0de2600f22979,15580,MRK3480 Forbrukeratferd,1455282105,2016-02-12 14:01:45,1455282116,11
5698da452fb0de2600f2297b,54611,MRK3480 Forbrukeratferd,1453291144,2016-01-20 12:59:04,1453291144,0
5698da452fb0de2600f2297b,45044,MRK3480 Forbrukeratferd,1453819951,2016-01-26 15:52:31,1453820117,166
5698da452fb0de2600f2297b,91685,MRK3480 Forbrukeratferd,1453931637,2016-01-27 22:53:57,1453931750,113
5698da452fb0de2600f2297b,46534,MRK3480 Forbrukeratferd,1455402432,2016-02-13 23:27:12,1455402465,33
5698da4541a9d72100240690,60610,MRK3480 Forbrukeratferd,1453664908,2016-01-24 20:48:28,1453665064,156
5698da4541a9d72100240690,49346,MRK3480 Forbrukeratferd,1453715295,2016-01-25 10:48:15,1453715297,2
5698da4541a9d72100240690,9223,MRK3480 Forbrukeratferd,1453970703,2016-01-28 09:45:03,1453970791,88
5698da4541a9d72100240690,28505,MRK3480 Forbrukeratferd,1455274471,2016-02-12 11:54:31,1455274471,0
5698da4541a9d72100240690,99772,MRK3480 Forbrukeratferd,1455280007,2016-02-12 13:26:47,1455280033,26
5698da4541a9d72100240691,58465,MRK3480 Forbrukeratferd,1452948279,2016-01-16 13:44:39,1452948846,567
5698da4541a9d72100240691,19334,MRK3480 Forbrukeratferd,1453124038,2016-01-18 14:33:58,1453124039,1
5698da4541a9d72100240691,94591,MRK3480 Forbrukeratferd,1453188044,2016-01-19 08:20:44,1453188046,2
5698da4541a9d72100240691,16400,MRK3480 Forbrukeratferd,1453328309,2016-01-20 23:18:29,1453328786,477
5698da4541a9d72100240691,24719,MRK3480 Forbrukeratferd,1453371533,2016-01-21 11:18:53,1453371535,2
5698da4541a9d72100240691,42425,MRK3480 Forbrukeratferd,1453383733,2016-01-21 14:42:13,1453383733,0
5698da4541a9d72100240691,93980,MRK3480 Forbrukeratferd,1453386015,2016-01-21 15:20:15,1453386015,0
5698da4541a9d72100240691,88796,MRK3480 Forbrukeratferd,1453455935,2016-01-22 10:45:35,1453456632,697
5698da4541a9d72100240691,55484,MRK3480 Forbrukeratferd,1453490323,2016-01-22 20:18:43,1453490327,4
5698da4541a9d72100240691,45252,MRK3480 Forbrukeratferd,1453547914,2016-01-23 12:18:34,1453547929,15
5698da4541a9d72100240691,70716,MRK3480 Forbrukeratferd,1453592149,2016-01-24 00:35:49,1453592151,2
5698da4541a9d72100240691,4097,MRK3480 Forbrukeratferd,1453889086,2016-01-27 11:04:46,1453889088,2
5698da4541a9d72100240691,59910,MRK3480 Forbrukeratferd,1453892924,2016-01-27 12:08:44,1453892924,0
5698da4541a9d72100240691,76074,MRK3480 Forbrukeratferd,1453919899,2016-01-27 19:38:19,1453920196,297
5698da4541a9d72100240691,11061,MRK3480 Forbrukeratferd,1453931876,2016-01-27 22:57:56,1453931878,2
5698da4541a9d72100240691,49254,MRK3480 Forbrukeratferd,1454493154,2016-02-03 10:52:34,1454493164,10
5698da4541a9d72100240691,64686,MRK3480 Forbrukeratferd,1454586073,2016-02-04 12:41:13,1454586168,95
5698da4541a9d72100240691,32387,MRK3480 Forbrukeratferd,1455028564,2016-02-09 15:36:04,1455028683,119
5698da4541a9d72100240691,19575,MRK3480 Forbrukeratferd,1455263678,2016-02-12 08:54:38,1455264849,1171
5698da4541a9d72100240692,1254,MRK3480 Forbrukeratferd,1453131377,2016-01-18 16:36:17,1453131467,90
5698da4541a9d72100240692,59302,MRK3480 Forbrukeratferd,1453979760,2016-01-28 12:16:00,1453979807,47
5698da4541a9d72100240692,40899,MRK3480 Forbrukeratferd,1454000136,2016-01-28 17:55:36,1454000157,21
5698da4541a9d72100240692,36667,MRK3480 Forbrukeratferd,1454011645,2016-01-28 21:07:25,1454011756,111
5698da4541a9d72100240692,20026,MRK3480 Forbrukeratferd,1454071284,2016-01-29 13:41:24,1454071386,102
5698da4541a9d72100240692,56892,MRK3480 Forbrukeratferd,1454437543,2016-02-02 19:25:43,1454438275,732
5698da4541a9d72100240693,15222,MRK3480 Forbrukeratferd,1452861669,2016-01-15 13:41:09,1452861740,71
5698da4541a9d72100240693,71262,MRK3480 Forbrukeratferd,1452872697,2016-01-15 16:44:57,1452872709,12
5698da4541a9d72100240693,22143,MRK3480 Forbrukeratferd,1453067162,2016-01-17 22:46:02,1453067413,251
5698da4541a9d72100240693,96461,MRK3480 Forbrukeratferd,1453125704,2016-01-18 15:01:44,1453125762,58
5698da4541a9d72100240693,93303,MRK3480 Forbrukeratferd,1453138358,2016-01-18 18:32:38,1453138358,0
5698da4541a9d72100240693,72429,MRK3480 Forbrukeratferd,1453375807,2016-01-21 12:30:07,1453375889,82
5698da4541a9d72100240693,30081,MRK3480 Forbrukeratferd,1453653915,2016-01-24 17:45:15,1453655894,1979
5698da4541a9d72100240693,35791,MRK3480 Forbrukeratferd,1453674185,2016-01-24 23:23:05,1453674186,1
5698da4541a9d72100240693,20950,MRK3480 Forbrukeratferd,1453727389,2016-01-25 14:09:49,1453727402,13
5698da4541a9d72100240693,27327,MRK3480 Forbrukeratferd,1453809230,2016-01-26 12:53:50,1453809247,17
5698da4541a9d72100240693,55917,MRK3480 Forbrukeratferd,1453911389,2016-01-27 17:16:29,1453912223,834
5698da4541a9d72100240693,12942,MRK3480 Forbrukeratferd,1453931772,2016-01-27 22:56:12,1453931772,0
5698da4541a9d72100240693,71451,MRK3480 Forbrukeratferd,1454670151,2016-02-05 12:02:31,1454670287,136
5698da4541a9d72100240693,41607,MRK3480 Forbrukeratferd,1454965114,2016-02-08 21:58:34,1454965319,205
5698da4541a9d72100240693,17800,MRK3480 Forbrukeratferd,1455032686,2016-02-09 16:44:46,1455032734,48
5698da4541a9d72100240693,11851,MRK3480 Forbrukeratferd,1455034907,2016-02-09 17:21:47,1455034934,27
5698da4541a9d72100240694,17326,MRK3480 Forbrukeratferd,1453813605,2016-01-26 14:06:45,1453813817,212
5698da4541a9d72100240694,91668,MRK3480 Forbrukeratferd,1453818074,2016-01-26 15:21:14,1453818143,69
5698da4541a9d72100240694,59060,MRK3480 Forbrukeratferd,1454444720,2016-02-02 21:25:20,1454445164,444
5698da4541a9d72100240694,89490,MRK3480 Forbrukeratferd,1455315886,2016-02-12 23:24:46,1455316065,179
5698da4541a9d72100240695,27255,MRK3480 Forbrukeratferd,1452955397,2016-01-16 15:43:17,1452955491,94
5698da4541a9d72100240695,99734,MRK3480 Forbrukeratferd,1453125168,2016-01-18 14:52:48,1453125168,0
5698da4541a9d72100240695,2554,MRK3480 Forbrukeratferd,1453148782,2016-01-18 21:26:22,1453148785,3
5698da4541a9d72100240695,36291,MRK3480 Forbrukeratferd,1453980144,2016-01-28 12:22:24,1453980170,26
5698da4541a9d72100240695,84128,MRK3480 Forbrukeratferd,1453987017,2016-01-28 14:16:57,1453987035,18
5698da4541a9d72100240695,95477,MRK3480 Forbrukeratferd,1453990332,2016-01-28 15:12:12,1453990332,0
5698da4541a9d72100240695,97198,MRK3480 Forbrukeratferd,1454326971,2016-02-01 12:42:51,1454326972,1
5698da4541a9d72100240695,50967,MRK3480 Forbrukeratferd,1455107556,2016-02-10 13:32:36,1455107556,0
5698da4541a9d72100240695,18820,MRK3480 Forbrukeratferd,1455275048,2016-02-12 12:04:08,1455275048,0
5698da4541a9d72100240695,47705,MRK3480 Forbrukeratferd,1455282329,2016-02-12 14:05:29,1455282330,1
5698da4541a9d72100240696,32704,MRK3480 Forbrukeratferd,1453827028,2016-01-26 17:50:28,1453827028,0
5698da4641a9d72100240698,74857,MRK3480 Forbrukeratferd,1453142517,2016-01-18 19:41:57,1453142541,24
5698da4641a9d72100240698,56380,MRK3480 Forbrukeratferd,1453723374,2016-01-25 13:02:54,1453723428,54
5698da4641a9d72100240698,8715,MRK3480 Forbrukeratferd,1453909637,2016-01-27 16:47:17,1453909756,119
5698da4641a9d72100240698,18687,MRK3480 Forbrukeratferd,1455139194,2016-02-10 22:19:54,1455139731,537
5698da4641a9d721002406a9,62629,MRK3480 Forbrukeratferd,1453129044,2016-01-18 15:57:24,1453129044,0
5698da4641a9d721002406a9,29702,MRK3480 Forbrukeratferd,1453132043,2016-01-18 16:47:23,1453132043,0
5698da4641a9d721002406a9,37362,MRK3480 Forbrukeratferd,1453376848,2016-01-21 12:47:28,1453376894,46
5698da4641a9d721002406a9,8101,MRK3480 Forbrukeratferd,1453724975,2016-01-25 13:29:35,1453725015,40
5698da4641a9d721002406a9,20397,MRK3480 Forbrukeratferd,1453753228,2016-01-25 21:20:28,1453753276,48
5698da4641a9d721002406a9,52728,MRK3480 Forbrukeratferd,1453811730,2016-01-26 13:35:30,1453811731,1
5698da4641a9d721002406a9,90889,MRK3480 Forbrukeratferd,1453923333,2016-01-27 20:35:33,1453923334,1
5698da4641a9d721002406a9,49860,MRK3480 Forbrukeratferd,1454610837,2016-02-04 19:33:57,1454611068,231
5698da472fb0de2600f2299a,93813,MRK3480 Forbrukeratferd,1452861603,2016-01-15 13:40:03,1452861648,45
5698da472fb0de2600f2299a,4833,MRK3480 Forbrukeratferd,1453374372,2016-01-21 12:06:12,1453374402,30
5698da472fb0de2600f2299a,796,MRK3480 Forbrukeratferd,1453376526,2016-01-21 12:42:06,1453376552,26
5698da472fb0de2600f2299a,21337,MRK3480 Forbrukeratferd,1453813880,2016-01-26 14:11:20,1453813967,87
5698da472fb0de2600f2299a,23188,MRK3480 Forbrukeratferd,1453893625,2016-01-27 12:20:25,1453893704,79
5698da472fb0de2600f2299a,25483,MRK3480 Forbrukeratferd,1453896295,2016-01-27 13:04:55,1453896318,23
5698da472fb0de2600f2299a,60812,MRK3480 Forbrukeratferd,1454770378,2016-02-06 15:52:58,1454770549,171
5698da472fb0de2600f2299a,63571,MRK3480 Forbrukeratferd,1454943666,2016-02-08 16:01:06,1454943667,1
5698da472fb0de2600f2299a,20082,MRK3480 Forbrukeratferd,1455283035,2016-02-12 14:17:15,1455283048,13
5698da472fb0de2600f2299b,54923,MRK3480 Forbrukeratferd,1453446773,2016-01-22 08:12:53,1453446818,45
5698da472fb0de2600f2299b,99698,MRK3480 Forbrukeratferd,1453980719,2016-01-28 12:31:59,1453980891,172
5698da472fb0de2600f2299b,36740,MRK3480 Forbrukeratferd,1453984441,2016-01-28 13:34:01,1453984493,52
5698da472fb0de2600f2299b,94437,MRK3480 Forbrukeratferd,1455239990,2016-02-12 02:19:50,1455239990,0
5698da472fb0de2600f2299c,24449,MRK3480 Forbrukeratferd,1453377811,2016-01-21 13:03:31,1453377812,1
5698da472fb0de2600f2299c,20363,MRK3480 Forbrukeratferd,1455275143,2016-02-12 12:05:43,1455275157,14
5698da4741a9d721002406b6,21874,MRK3480 Forbrukeratferd,1453378207,2016-01-21 13:10:07,1453378261,54
5698da4741a9d721002406b6,77996,MRK3480 Forbrukeratferd,1454089268,2016-01-29 18:41:08,1454089332,64
5698da4741a9d721002406b6,29746,MRK3480 Forbrukeratferd,1454097434,2016-01-29 20:57:14,1454097580,146
5698da4741a9d721002406b6,5535,MRK3480 Forbrukeratferd,1454578363,2016-02-04 10:32:43,1454578365,2
5698da482fb0de2600f229a3,48234,MRK3480 Forbrukeratferd,1454025268,2016-01-29 00:54:28,1454025435,167
5698da482fb0de2600f229a3,83415,MRK3480 Forbrukeratferd,1455128802,2016-02-10 19:26:42,1455128802,0
5698da482fb0de2600f229a3,9887,MRK3480 Forbrukeratferd,1455178823,2016-02-11 09:20:23,1455178858,35
5698da482fb0de2600f229a3,58697,MRK3480 Forbrukeratferd,1455422135,2016-02-14 04:55:35,1455422135,0
5698da482fb0de2600f229a4,44663,MRK3480 Forbrukeratferd,1454000526,2016-01-28 18:02:06,1454000634,108
5698da4841a9d721002406be,8052,MRK3480 Forbrukeratferd,1453375595,2016-01-21 12:26:35,1453375842,247
5698da4841a9d721002406be,11540,MRK3480 Forbrukeratferd,1453377729,2016-01-21 13:02:09,1453378174,445
5698da4841a9d721002406be,19685,MRK3480 Forbrukeratferd,1453381018,2016-01-21 13:56:58,1453381021,3
5698da4841a9d721002406be,53292,MRK3480 Forbrukeratferd,1453979830,2016-01-28 12:17:10,1453979891,61
5698da4841a9d721002406be,3711,MRK3480 Forbrukeratferd,1453986679,2016-01-28 14:11:19,1453987270,591
5698da4841a9d721002406be,9844,MRK3480 Forbrukeratferd,1454190344,2016-01-30 22:45:44,1454190492,148
5698da4841a9d721002406be,81027,MRK3480 Forbrukeratferd,1454255890,2016-01-31 16:58:10,1454256284,394
5698da4841a9d721002406be,16384,MRK3480 Forbrukeratferd,1454968288,2016-02-08 22:51:28,1454968307,19
5698da4841a9d721002406bf,98012,MRK3480 Forbrukeratferd,1453043971,2016-01-17 16:19:31,1453043990,19
5698da4841a9d721002406bf,33699,MRK3480 Forbrukeratferd,1453374556,2016-01-21 12:09:16,1453375399,843
5698da4841a9d721002406bf,68584,MRK3480 Forbrukeratferd,1453378214,2016-01-21 13:10:14,1453378430,216
5698da4841a9d721002406bf,96093,MRK3480 Forbrukeratferd,1453979854,2016-01-28 12:17:34,1453979966,112
5698da4841a9d721002406bf,16789,MRK3480 Forbrukeratferd,1453983099,2016-01-28 13:11:39,1453983111,12
5698da4841a9d721002406bf,79945,MRK3480 Forbrukeratferd,1454775559,2016-02-06 17:19:19,1454775655,96
5698da4841a9d721002406bf,42406,MRK3480 Forbrukeratferd,1455232485,2016-02-12 00:14:45,1455232489,4
5698da4841a9d721002406bf,29916,MRK3480 Forbrukeratferd,1455288241,2016-02-12 15:44:01,1455288561,320
5698da492fb0de2600f229a5,58457,MRK3480 Forbrukeratferd,1453374831,2016-01-21 12:13:51,1453374831,0
5698da492fb0de2600f229a5,99351,MRK3480 Forbrukeratferd,1453376554,2016-01-21 12:42:34,1453378032,1478
5698da492fb0de2600f229a5,27663,MRK3480 Forbrukeratferd,1453380139,2016-01-21 13:42:19,1453380143,4
5698da492fb0de2600f229a5,93104,MRK3480 Forbrukeratferd,1453979039,2016-01-28 12:03:59,1453979921,882
5698da492fb0de2600f229a5,9231,MRK3480 Forbrukeratferd,1454024802,2016-01-29 00:46:42,1454026889,2087
5698da492fb0de2600f229a5,60732,MRK3480 Forbrukeratferd,1454669754,2016-02-05 11:55:54,1454669915,161
5698da492fb0de2600f229a5,42498,MRK3480 Forbrukeratferd,1455231668,2016-02-12 00:01:08,1455231734,66
5698da492fb0de2600f229a6,13542,MRK3480 Forbrukeratferd,1453141300,2016-01-18 19:21:40,1453141710,410
5698da492fb0de2600f229a6,8383,MRK3480 Forbrukeratferd,1453212680,2016-01-19 15:11:20,1453212722,42
5698da492fb0de2600f229a6,28450,MRK3480 Forbrukeratferd,1453370944,2016-01-21 11:09:04,1453371107,163
5698da492fb0de2600f229a6,73580,MRK3480 Forbrukeratferd,1453979104,2016-01-28 12:05:04,1453979181,77
5698da492fb0de2600f229a6,72177,MRK3480 Forbrukeratferd,1453993490,2016-01-28 16:04:50,1453994477,987
5698da492fb0de2600f229a6,32584,MRK3480 Forbrukeratferd,1453996733,2016-01-28 16:58:53,1453996737,4
5698da492fb0de2600f229a6,11692,MRK3480 Forbrukeratferd,1454012310,2016-01-28 21:18:30,1454012311,1
5698da492fb0de2600f229a6,98387,MRK3480 Forbrukeratferd,1454428682,2016-02-02 16:58:02,1454428682,0
5698da492fb0de2600f229a6,18809,MRK3480 Forbrukeratferd,1454430090,2016-02-02 17:21:30,1454430090,0
5698da492fb0de2600f229a6,56675,MRK3480 Forbrukeratferd,1454616393,2016-02-04 21:06:33,1454616478,85
5698da492fb0de2600f229a6,39586,MRK3480 Forbrukeratferd,1454672289,2016-02-05 12:38:09,1454672321,32
5698da492fb0de2600f229a6,16480,MRK3480 Forbrukeratferd,1454675285,2016-02-05 13:28:05,1454675651,366
5698da492fb0de2600f229a7,89515,MRK3480 Forbrukeratferd,1453209043,2016-01-19 14:10:43,1453209161,118
5698da492fb0de2600f229a7,87037,MRK3480 Forbrukeratferd,1453372711,2016-01-21 11:38:31,1453372810,99
5698da492fb0de2600f229a7,86290,MRK3480 Forbrukeratferd,1453720238,2016-01-25 12:10:38,1453720273,35
5698da492fb0de2600f229a7,49473,MRK3480 Forbrukeratferd,1453725162,2016-01-25 13:32:42,1453725164,2
5698da492fb0de2600f229a7,15264,MRK3480 Forbrukeratferd,1453802285,2016-01-26 10:58:05,1453802285,0
5698da492fb0de2600f229a7,55870,MRK3480 Forbrukeratferd,1453999497,2016-01-28 17:44:57,1453999667,170
5698da492fb0de2600f229a7,95962,MRK3480 Forbrukeratferd,1454355949,2016-02-01 20:45:49,1454355987,38
5698da492fb0de2600f229a7,49356,MRK3480 Forbrukeratferd,1454695543,2016-02-05 19:05:43,1454695623,80
5698da492fb0de2600f229a7,55045,MRK3480 Forbrukeratferd,1455268161,2016-02-12 10:09:21,1455269021,860
5698da492fb0de2600f229a7,50448,MRK3480 Forbrukeratferd,1455274262,2016-02-12 11:51:02,1455274294,32
5698da492fb0de2600f229a7,98733,MRK3480 Forbrukeratferd,1455281371,2016-02-12 13:49:31,1455281375,4
5698da492fb0de2600f229a8,50030,MRK3480 Forbrukeratferd,1453146873,2016-01-18 20:54:33,1453147387,514
5698da492fb0de2600f229a8,82871,MRK3480 Forbrukeratferd,1453306897,2016-01-20 17:21:37,1453306908,11
5698da492fb0de2600f229a9,727,MRK3480 Forbrukeratferd,1452905131,2016-01-16 01:45:31,1452905323,192
5698da492fb0de2600f229a9,58981,MRK3480 Forbrukeratferd,1453123511,2016-01-18 14:25:11,1453124103,592
5698da492fb0de2600f229a9,21364,MRK3480 Forbrukeratferd,1453682053,2016-01-25 01:34:13,1453682261,208
5698da492fb0de2600f229a9,35986,MRK3480 Forbrukeratferd,1454492200,2016-02-03 10:36:40,1454492201,1
5698da492fb0de2600f229a9,63550,MRK3480 Forbrukeratferd,1454493567,2016-02-03 10:59:27,1454493568,1
5698da4941a9d721002406c1,98894,MRK3480 Forbrukeratferd,1453374012,2016-01-21 12:00:12,1453374144,132
5698da4941a9d721002406c1,8041,MRK3480 Forbrukeratferd,1453747062,2016-01-25 19:37:42,1453747073,11
5698da4941a9d721002406c1,84076,MRK3480 Forbrukeratferd,1453818227,2016-01-26 15:23:47,1453818374,147
5698da4941a9d721002406c1,40119,MRK3480 Forbrukeratferd,1453892776,2016-01-27 12:06:16,1453892824,48
5698da4941a9d721002406c1,90020,MRK3480 Forbrukeratferd,1453978512,2016-01-28 11:55:12,1453978632,120
5698da4941a9d721002406c2,15060,MRK3480 Forbrukeratferd,1452865107,2016-01-15 14:38:27,1452865141,34
5698da4941a9d721002406c2,96398,MRK3480 Forbrukeratferd,1452867367,2016-01-15 15:16:07,1452867570,203
5698da4941a9d721002406c2,52376,MRK3480 Forbrukeratferd,1452872644,2016-01-15 16:44:04,1452873553,909
5698da4941a9d721002406c2,65186,MRK3480 Forbrukeratferd,1453334412,2016-01-21 01:00:12,1453334548,136
5698da4941a9d721002406c2,98604,MRK3480 Forbrukeratferd,1453340352,2016-01-21 02:39:12,1453341038,686
5698da4941a9d721002406c2,26899,MRK3480 Forbrukeratferd,1453675570,2016-01-24 23:46:10,1453675575,5
5698da4941a9d721002406c2,61090,MRK3480 Forbrukeratferd,1453948497,2016-01-28 03:34:57,1453948923,426
5698da4941a9d721002406c2,73891,MRK3480 Forbrukeratferd,1454600993,2016-02-04 16:49:53,1454600994,1
5698da4941a9d721002406c2,23644,MRK3480 Forbrukeratferd,1455116583,2016-02-10 16:03:03,1455116812,229
5698da4941a9d721002406c2,71905,MRK3480 Forbrukeratferd,1455129860,2016-02-10 19:44:20,1455129977,117
5698da4941a9d721002406c2,5852,MRK3480 Forbrukeratferd,1455137472,2016-02-10 21:51:12,1455137472,0
5698da4941a9d721002406c2,73081,MRK3480 Forbrukeratferd,1455222270,2016-02-11 21:24:30,1455222572,302
5698da4941a9d721002406c2,35713,MRK3480 Forbrukeratferd,1455302451,2016-02-12 19:40:51,1455302491,40
5698da4941a9d721002406c3,24054,MRK3480 Forbrukeratferd,1452861687,2016-01-15 13:41:27,1452861989,302
5698da4941a9d721002406c3,58805,MRK3480 Forbrukeratferd,1452872721,2016-01-15 16:45:21,1452872754,33
5698da4941a9d721002406c3,80245,MRK3480 Forbrukeratferd,1452882839,2016-01-15 19:33:59,1452884995,2156
5698da4941a9d721002406c3,91404,MRK3480 Forbrukeratferd,1452983025,2016-01-16 23:23:45,1452983027,2
5698da4941a9d721002406c3,58548,MRK3480 Forbrukeratferd,1453054317,2016-01-17 19:11:57,1453054317,0
5698da4941a9d721002406c3,79921,MRK3480 Forbrukeratferd,1453061153,2016-01-17 21:05:53,1453061178,25
5698da4941a9d721002406c3,93511,MRK3480 Forbrukeratferd,1453119015,2016-01-18 13:10:15,1453119015,0
5698da4941a9d721002406c3,215,MRK3480 Forbrukeratferd,1453374333,2016-01-21 12:05:33,1453374506,173
5698da4941a9d721002406c3,47359,MRK3480 Forbrukeratferd,1453377695,2016-01-21 13:01:35,1453378434,739
5698da4941a9d721002406c3,60660,MRK3480 Forbrukeratferd,1453730663,2016-01-25 15:04:23,1453730669,6
5698da4941a9d721002406c3,82845,MRK3480 Forbrukeratferd,1453979139,2016-01-28 12:05:39,1453979208,69
5698da4941a9d721002406c3,99080,MRK3480 Forbrukeratferd,1453997797,2016-01-28 17:16:37,1454000870,3073
5698da4941a9d721002406c3,57795,MRK3480 Forbrukeratferd,1454858776,2016-02-07 16:26:16,1454859016,240
5698da4941a9d721002406c4,12259,MRK3480 Forbrukeratferd,1453980100,2016-01-28 12:21:40,1453980438,338
5698da4941a9d721002406c4,44937,MRK3480 Forbrukeratferd,1453985999,2016-01-28 13:59:59,1453986079,80
5698da4941a9d721002406c4,57419,MRK3480 Forbrukeratferd,1454011334,2016-01-28 21:02:14,1454011353,19
5698da4941a9d721002406c4,92420,ORG3402 Organisasjonsatferd og ledelse,1454334849,2016-02-01 14:54:09,1454335023,174
5698da4941a9d721002406c4,92094,MRK3480 Forbrukeratferd,1454415568,2016-02-02 13:19:28,1454415916,348
5698da4941a9d721002406c4,60126,ORG3402 Organisasjonsatferd og ledelse,1454498494,2016-02-03 12:21:34,1454498575,81
5698da4941a9d721002406c4,76139,ORG3402 Organisasjonsatferd og ledelse,1454504978,2016-02-03 14:09:38,1454505137,159
5698da4941a9d721002406c4,1177,ORG3402 Organisasjonsatferd og ledelse,1454625980,2016-02-04 23:46:20,1454625980,0
5698da4941a9d721002406c4,17499,MRK3480 Forbrukeratferd,1454675735,2016-02-05 13:35:35,1454676317,582
5698da4941a9d721002406c4,42132,MRK3480 Forbrukeratferd,1454679409,2016-02-05 14:36:49,1454679409,0
5698da4941a9d721002406c4,52724,ORG3402 Organisasjonsatferd og ledelse,1455102360,2016-02-10 12:06:00,1455102381,21
5698da4941a9d721002406c4,72067,ORG3402 Organisasjonsatferd og ledelse,1455104353,2016-02-10 12:39:13,1455104353,0
5698da4941a9d721002406c4,18487,ORG3402 Organisasjonsatferd og ledelse,1455106101,2016-02-10 13:08:21,1455106190,89
5698da4941a9d721002406c4,79519,ORG3402 Organisasjonsatferd og ledelse,1455110134,2016-02-10 14:15:34,1455110135,1
5698da4941a9d721002406c4,29284,ORG3402 Organisasjonsatferd og ledelse,1455188889,2016-02-11 12:08:09,1455188889,0
5698da4941a9d721002406c4,10067,MRK3480 Forbrukeratferd,1455190893,2016-02-11 12:41:33,1455191681,788
5698da4941a9d721002406c4,9305,MRK3480 Forbrukeratferd,1455193158,2016-02-11 13:19:18,1455193514,356
5698da4941a9d721002406c4,81815,MRK3480 Forbrukeratferd,1455274951,2016-02-12 12:02:31,1455275234,283
5698da4a2fb0de2600f229c2,92585,MRK3480 Forbrukeratferd,1453160891,2016-01-19 00:48:11,1453160960,69
5698da4a2fb0de2600f229c2,72614,MRK3480 Forbrukeratferd,1453645262,2016-01-24 15:21:02,1453645268,6
5698da4a41a9d721002406de,83215,MRK3480 Forbrukeratferd,1453761183,2016-01-25 23:33:03,1453761219,36
5698da4a41a9d721002406de,16835,MRK3480 Forbrukeratferd,1453763239,2016-01-26 00:07:19,1453764396,1157
5698da4a41a9d721002406de,23839,MRK3480 Forbrukeratferd,1453816292,2016-01-26 14:51:32,1453816610,318
5698da4a41a9d721002406de,97102,MRK3480 Forbrukeratferd,1453818577,2016-01-26 15:29:37,1453818577,0
5698da4b2fb0de2600f229c4,75465,MRK3480 Forbrukeratferd,1452867018,2016-01-15 15:10:18,1452867026,8
5698da4b2fb0de2600f229c4,96646,MRK3480 Forbrukeratferd,1452872269,2016-01-15 16:37:49,1452872269,0
5698da4b2fb0de2600f229c4,73606,MRK3480 Forbrukeratferd,1453809701,2016-01-26 13:01:41,1453809702,1
5698da4b2fb0de2600f229c4,93318,MRK3480 Forbrukeratferd,1453912184,2016-01-27 17:29:44,1453912185,1
5698da4b2fb0de2600f229c4,15335,MRK3480 Forbrukeratferd,1454612906,2016-02-04 20:08:26,1454613093,187
5698da4b2fb0de2600f229c5,16493,MRK3480 Forbrukeratferd,1453376866,2016-01-21 12:47:46,1453377803,937
5698da4b2fb0de2600f229c5,33409,MRK3480 Forbrukeratferd,1453604587,2016-01-24 04:03:07,1453604588,1
5698da4b2fb0de2600f229c6,91834,MRK3480 Forbrukeratferd,1453375613,2016-01-21 12:26:53,1453375710,97
5698da4b2fb0de2600f229c6,51460,MRK3480 Forbrukeratferd,1453378143,2016-01-21 13:09:03,1453378769,626
5698da4b2fb0de2600f229c6,31920,MRK3480 Forbrukeratferd,1453979892,2016-01-28 12:18:12,1453979925,33
5698da4b2fb0de2600f229c6,8770,MRK3480 Forbrukeratferd,1455130794,2016-02-10 19:59:54,1455130850,56
5698da4b2fb0de2600f229c8,41409,MRK3480 Forbrukeratferd,1453135500,2016-01-18 17:45:00,1453136044,544
5698da4b2fb0de2600f229c8,52471,MRK3480 Forbrukeratferd,1453292756,2016-01-20 13:25:56,1453295004,2248
5698da4b2fb0de2600f229c8,65880,MRK3480 Forbrukeratferd,1453296647,2016-01-20 14:30:47,1453296666,19
5698da4b2fb0de2600f229c8,35593,MRK3480 Forbrukeratferd,1453297889,2016-01-20 14:51:29,1453297895,6
5698da4b2fb0de2600f229c8,53197,MRK3480 Forbrukeratferd,1453300790,2016-01-20 15:39:50,1453300833,43
5698da4b2fb0de2600f229c8,72323,MRK3480 Forbrukeratferd,1453304109,2016-01-20 16:35:09,1453304130,21
5698da4b2fb0de2600f229c8,75456,MRK3480 Forbrukeratferd,1453308083,2016-01-20 17:41:23,1453308099,16
5698da4b2fb0de2600f229c8,12552,MRK3480 Forbrukeratferd,1455221293,2016-02-11 21:08:13,1455221656,363
5698da4b2fb0de2600f229c9,57393,MRK3480 Forbrukeratferd,1453377075,2016-01-21 12:51:15,1453378004,929
5698da4b2fb0de2600f229c9,28138,MRK3480 Forbrukeratferd,1454518147,2016-02-03 17:49:07,1454520452,2305
5698da4b2fb0de2600f229c9,67783,MRK3480 Forbrukeratferd,1455192780,2016-02-11 13:13:00,1455192781,1
5698da4b2fb0de2600f229c9,55029,MRK3480 Forbrukeratferd,1455303466,2016-02-12 19:57:46,1455303468,2
5698da4b41a9d721002406e0,85556,MRK3480 Forbrukeratferd,1453072736,2016-01-18 00:18:56,1453073200,464
5698da4b41a9d721002406e0,66449,MRK3480 Forbrukeratferd,1453843166,2016-01-26 22:19:26,1453844448,1282
5698da4b41a9d721002406e1,40815,MRK3480 Forbrukeratferd,1455198520,2016-02-11 14:48:40,1455199995,1475
5698da4b41a9d721002406e2,53452,MRK3480 Forbrukeratferd,1453376891,2016-01-21 12:48:11,1453376965,74
5698da4b41a9d721002406e2,33131,MRK3480 Forbrukeratferd,1453387214,2016-01-21 15:40:14,1453388165,951
5698da4b41a9d721002406e2,2918,MRK3480 Forbrukeratferd,1453804993,2016-01-26 11:43:13,1453805118,125
5698da4b41a9d721002406e2,29857,MRK3480 Forbrukeratferd,1453968712,2016-01-28 09:11:52,1453968713,1
5698da4b41a9d721002406e2,37335,MRK3480 Forbrukeratferd,1453988926,2016-01-28 14:48:46,1453989340,414
5698da4b41a9d721002406e2,42337,MRK3480 Forbrukeratferd,1455271152,2016-02-12 10:59:12,1455271403,251
5698da4b41a9d721002406e2,97492,MRK3480 Forbrukeratferd,1455289074,2016-02-12 15:57:54,1455289134,60
5698da4b41a9d721002406e2,88447,MRK3480 Forbrukeratferd,1455292442,2016-02-12 16:54:02,1455292510,68
5698da4b41a9d721002406e2,31930,MRK3480 Forbrukeratferd,1455298718,2016-02-12 18:38:38,1455298735,17
5698da4b41a9d721002406e2,52645,MRK3480 Forbrukeratferd,1455300365,2016-02-12 19:06:05,1455300371,6
5698da4c2fb0de2600f229cb,25395,MRK3480 Forbrukeratferd,1453119408,2016-01-18 13:16:48,1453119525,117
5698da4c2fb0de2600f229cb,443,MRK3480 Forbrukeratferd,1453125546,2016-01-18 14:59:06,1453125604,58
5698da4c2fb0de2600f229cb,1923,MRK3480 Forbrukeratferd,1453151736,2016-01-18 22:15:36,1453152294,558
5698da4c2fb0de2600f229cb,22694,MRK3480 Forbrukeratferd,1453201650,2016-01-19 12:07:30,1453201650,0
5698da4c2fb0de2600f229cb,37039,MRK3480 Forbrukeratferd,1453203004,2016-01-19 12:30:04,1453203157,153
5698da4c2fb0de2600f229cb,54265,MRK3480 Forbrukeratferd,1453224613,2016-01-19 18:30:13,1453224614,1
5698da4c2fb0de2600f229cb,67576,MRK3480 Forbrukeratferd,1453297832,2016-01-20 14:50:32,1453297832,0
5698da4c2fb0de2600f229cb,10597,MRK3480 Forbrukeratferd,1453674591,2016-01-24 23:29:51,1453674678,87
5698da4c2fb0de2600f229cb,33503,MRK3480 Forbrukeratferd,1453728323,2016-01-25 14:25:23,1453728343,20
5698da4c2fb0de2600f229cb,55325,MRK3480 Forbrukeratferd,1453805763,2016-01-26 11:56:03,1453810513,4750
5698da4c2fb0de2600f229cb,84623,MRK3480 Forbrukeratferd,1453812638,2016-01-26 13:50:38,1453812638,0
5698da4c2fb0de2600f229cb,12790,MRK3480 Forbrukeratferd,1453977260,2016-01-28 11:34:20,1453977415,155
5698da4c2fb0de2600f229cb,92355,MRK3480 Forbrukeratferd,1454584873,2016-02-04 12:21:13,1454584873,0
5698da4c2fb0de2600f229cb,79786,MRK3480 Forbrukeratferd,1454592444,2016-02-04 14:27:24,1454592444,0
5698da4c2fb0de2600f229cb,8234,MRK3480 Forbrukeratferd,1455117912,2016-02-10 16:25:12,1455118072,160
5698da4c2fb0de2600f229cb,30222,MRK3480 Forbrukeratferd,1455119718,2016-02-10 16:55:18,1455120047,329
5698da4c2fb0de2600f229cb,81458,MRK3480 Forbrukeratferd,1455122171,2016-02-10 17:36:11,1455122176,5
5698da4c2fb0de2600f229cc,46183,MRK3480 Forbrukeratferd,1453927148,2016-01-27 21:39:08,1453927316,168
5698da4c2fb0de2600f229cc,49468,MRK3480 Forbrukeratferd,1453990385,2016-01-28 15:13:05,1453990410,25
5698da4c2fb0de2600f229cc,88297,MRK3480 Forbrukeratferd,1453993401,2016-01-28 16:03:21,1453993495,94
5698da4c2fb0de2600f229ce,92158,MRK3480 Forbrukeratferd,1453071400,2016-01-17 23:56:40,1453071465,65
5698da4c2fb0de2600f229ce,28652,MRK3480 Forbrukeratferd,1453289862,2016-01-20 12:37:42,1453290242,380
5698da4c2fb0de2600f229ce,13132,MRK3480 Forbrukeratferd,1453719088,2016-01-25 11:51:28,1453719101,13
5698da4c2fb0de2600f229ce,13488,MRK3480 Forbrukeratferd,1453916234,2016-01-27 18:37:14,1453916250,16
5698da4c2fb0de2600f229ce,73991,MRK3480 Forbrukeratferd,1453938265,2016-01-28 00:44:25,1453938265,0
5698da4c2fb0de2600f229ce,46801,MRK3480 Forbrukeratferd,1453980355,2016-01-28 12:25:55,1453980542,187
5698da4c2fb0de2600f229ce,12734,MRK3480 Forbrukeratferd,1454670933,2016-02-05 12:15:33,1454670934,1
5698da4c2fb0de2600f229ce,27190,MRK3480 Forbrukeratferd,1455274562,2016-02-12 11:56:02,1455275432,870
5698da4c2fb0de2600f229ce,60717,MRK3480 Forbrukeratferd,1455283550,2016-02-12 14:25:50,1455283571,21
5698da4c2fb0de2600f229d2,99844,MRK3480 Forbrukeratferd,1453224207,2016-01-19 18:23:27,1453224233,26
5698da4c2fb0de2600f229d2,20336,MRK3480 Forbrukeratferd,1453745117,2016-01-25 19:05:17,1453745594,477
5698da4c2fb0de2600f229d2,5131,MRK3480 Forbrukeratferd,1453937028,2016-01-28 00:23:48,1453937789,761
5698da4c2fb0de2600f229d2,98284,MRK3480 Forbrukeratferd,1453973273,2016-01-28 10:27:53,1453973384,111
5698da4c2fb0de2600f229d2,33598,MRK3480 Forbrukeratferd,1453995732,2016-01-28 16:42:12,1453995744,12
5698da4c2fb0de2600f229d2,88144,MRK3480 Forbrukeratferd,1455216285,2016-02-11 19:44:45,1455216313,28
5698da4c41a9d721002406e4,98535,MRK3480 Forbrukeratferd,1453147574,2016-01-18 21:06:14,1453147637,63
5698da4c41a9d721002406e4,33649,MRK3480 Forbrukeratferd,1453148872,2016-01-18 21:27:52,1453148872,0
5698da4c41a9d721002406e4,1247,MRK3480 Forbrukeratferd,1453151512,2016-01-18 22:11:52,1453151515,3
5698da4c41a9d721002406e4,22304,MRK3480 Forbrukeratferd,1453159442,2016-01-19 00:24:02,1453159507,65
5698da4c41a9d721002406e4,68086,MRK3480 Forbrukeratferd,1453231257,2016-01-19 20:20:57,1453231279,22
5698da4c41a9d721002406e4,38133,MRK3480 Forbrukeratferd,1453239192,2016-01-19 22:33:12,1453239204,12
5698da4c41a9d721002406e4,71419,MRK3480 Forbrukeratferd,1453244201,2016-01-19 23:56:41,1453244202,1
5698da4c41a9d721002406e4,74982,MRK3480 Forbrukeratferd,1453720663,2016-01-25 12:17:43,1453720708,45
5698da4c41a9d721002406e6,40365,MRK3480 Forbrukeratferd,1453155651,2016-01-18 23:20:51,1453155752,101
5698da4c41a9d721002406e6,66780,MRK3480 Forbrukeratferd,1453223583,2016-01-19 18:13:03,1453223685,102
5698da4c41a9d721002406e6,79376,MRK3480 Forbrukeratferd,1453309977,2016-01-20 18:12:57,1453309990,13
5698da4c41a9d721002406e6,8122,MRK3480 Forbrukeratferd,1453325203,2016-01-20 22:26:43,1453325208,5
5698da4c41a9d721002406e6,33383,MRK3480 Forbrukeratferd,1453374760,2016-01-21 12:12:40,1453374761,1
5698da4c41a9d721002406e6,36594,MRK3480 Forbrukeratferd,1453382085,2016-01-21 14:14:45,1453382085,0
5698da4c41a9d721002406e6,3236,MRK3480 Forbrukeratferd,1453395523,2016-01-21 17:58:43,1453395605,82
5698da4c41a9d721002406e7,3438,MRK3480 Forbrukeratferd,1453378186,2016-01-21 13:09:46,1453378436,250
5698da4c41a9d721002406ea,79301,MRK3480 Forbrukeratferd,1453389293,2016-01-21 16:14:53,1453389779,486
5698da4c41a9d721002406ec,69386,MRK3480 Forbrukeratferd,1452868943,2016-01-15 15:42:23,1452869071,128
5698da4c41a9d721002406ec,90470,MRK3480 Forbrukeratferd,1452874431,2016-01-15 17:13:51,1452874460,29
5698da4c41a9d721002406ec,2395,MRK3480 Forbrukeratferd,1452880275,2016-01-15 18:51:15,1452880743,468
5698da4c41a9d721002406ec,17181,MRK3480 Forbrukeratferd,1453118981,2016-01-18 13:09:41,1453118987,6
5698da4c41a9d721002406ec,47032,MRK3480 Forbrukeratferd,1453195058,2016-01-19 10:17:38,1453195965,907
5698da4c41a9d721002406ec,37088,MRK3480 Forbrukeratferd,1453378588,2016-01-21 13:16:28,1453378607,19
5698da4c41a9d721002406ec,56700,MRK3480 Forbrukeratferd,1453386080,2016-01-21 15:21:20,1453386118,38
5698da4c41a9d721002406ec,42357,nan,1453639193,2016-01-24 13:39:53,1453639194,1
5698da4c41a9d721002406ec,26577,MRK3480 Forbrukeratferd,1453678715,2016-01-25 00:38:35,1453678737,22
5698da4c41a9d721002406ec,64724,MRK3480 Forbrukeratferd,1453716460,2016-01-25 11:07:40,1453716522,62
5698da4c41a9d721002406ec,86962,MRK3480 Forbrukeratferd,1453978873,2016-01-28 12:01:13,1453979791,918
5698da4c41a9d721002406ec,84607,MRK3480 Forbrukeratferd,1454255766,2016-01-31 16:56:06,1454255970,204
5698da4c41a9d721002406ec,58615,MRK3480 Forbrukeratferd,1454272486,2016-01-31 21:34:46,1454272501,15
5698da4c41a9d721002406ec,95838,MRK3480 Forbrukeratferd,1454494455,2016-02-03 11:14:15,1454494565,110
5698da4c41a9d721002406ec,90324,MRK3480 Forbrukeratferd,1455116475,2016-02-10 16:01:15,1455116554,79
5698da4c41a9d721002406ec,75757,MRK3480 Forbrukeratferd,1455443979,2016-02-14 10:59:39,1455444039,60
5698da4d41a9d72100240706,87597,MRK3480 Forbrukeratferd,1453378375,2016-01-21 13:12:55,1453378393,18
5698da4d41a9d72100240706,78750,MRK3480 Forbrukeratferd,1453384820,2016-01-21 15:00:20,1453384825,5
5698da4d41a9d72100240706,30102,MRK3480 Forbrukeratferd,1453389005,2016-01-21 16:10:05,1453389120,115
5698da4e2fb0de2600f229ea,32160,MRK3480 Forbrukeratferd,1453213584,2016-01-19 15:26:24,1453213948,364
5698da4e2fb0de2600f229ea,69486,MRK3480 Forbrukeratferd,1453914279,2016-01-27 18:04:39,1453914482,203
5698da4e2fb0de2600f229ea,63704,MRK3480 Forbrukeratferd,1453917711,2016-01-27 19:01:51,1453917711,0
5698da4e2fb0de2600f229ea,83323,MRK3480 Forbrukeratferd,1453979357,2016-01-28 12:09:17,1453979375,18
5698da4e2fb0de2600f229ea,85701,MRK3480 Forbrukeratferd,1453980617,2016-01-28 12:30:17,1453980689,72
5698da4e2fb0de2600f229ea,92887,MRK3480 Forbrukeratferd,1454497788,2016-02-03 12:09:48,1454497789,1
5698da4e2fb0de2600f229ea,97438,MRK3480 Forbrukeratferd,1454879808,2016-02-07 22:16:48,1454880034,226
5698da4e2fb0de2600f229ea,41774,MRK3480 Forbrukeratferd,1454881387,2016-02-07 22:43:07,1454881396,9
5698da4e2fb0de2600f229eb,20889,MRK3480 Forbrukeratferd,1453304393,2016-01-20 16:39:53,1453304642,249
5698da4e2fb0de2600f229eb,30689,MRK3480 Forbrukeratferd,1453311972,2016-01-20 18:46:12,1453311982,10
5698da4e2fb0de2600f229eb,84058,MRK3480 Forbrukeratferd,1453321983,2016-01-20 21:33:03,1453321985,2
5698da4e2fb0de2600f229eb,49087,MRK3480 Forbrukeratferd,1453838292,2016-01-26 20:58:12,1453838508,216
5698da4e2fb0de2600f229eb,71605,MRK3480 Forbrukeratferd,1454072301,2016-01-29 13:58:21,1454072324,23
5698da4e2fb0de2600f229eb,80415,MRK3480 Forbrukeratferd,1454075813,2016-01-29 14:56:53,1454076755,942
5698da4e2fb0de2600f229eb,63999,MRK3480 Forbrukeratferd,1454602386,2016-02-04 17:13:06,1454602419,33
5698da4e2fb0de2600f229eb,71193,MRK3480 Forbrukeratferd,1454672138,2016-02-05 12:35:38,1454672213,75
5698da4e2fb0de2600f229eb,17821,MRK3480 Forbrukeratferd,1454675905,2016-02-05 13:38:25,1454675961,56
5698da4e2fb0de2600f229eb,90228,MRK3480 Forbrukeratferd,1454878846,2016-02-07 22:00:46,1454878881,35
5698da4e2fb0de2600f229ec,25714,MRK3480 Forbrukeratferd,1453219473,2016-01-19 17:04:33,1453219503,30
5698da4e2fb0de2600f229ec,52918,MRK3480 Forbrukeratferd,1453980115,2016-01-28 12:21:55,1453980295,180
5698da4e2fb0de2600f229ec,21962,MRK3480 Forbrukeratferd,1454345361,2016-02-01 17:49:21,1454345388,27
5698da4e41a9d72100240707,36091,MRK3480 Forbrukeratferd,1452913830,2016-01-16 04:10:30,1452913837,7
5698da4e41a9d72100240707,97833,MRK3480 Forbrukeratferd,1453151829,2016-01-18 22:17:09,1453151915,86
5698da4e41a9d72100240707,97873,MRK3480 Forbrukeratferd,1453259992,2016-01-20 04:19:52,1453260232,240
5698da4e41a9d72100240707,59663,MRK3480 Forbrukeratferd,1453333505,2016-01-21 00:45:05,1453333870,365
5698da4e41a9d72100240707,32995,MRK3480 Forbrukeratferd,1453680606,2016-01-25 01:10:06,1453680608,2
5698da4e41a9d72100240707,78095,MRK3480 Forbrukeratferd,1453765261,2016-01-26 00:41:01,1453765263,2
5698da4e41a9d72100240707,45050,MRK3480 Forbrukeratferd,1453810378,2016-01-26 13:12:58,1453810378,0
5698da4e41a9d72100240707,95503,MRK3480 Forbrukeratferd,1453911397,2016-01-27 17:16:37,1453911398,1
5698da4e41a9d72100240707,8925,MRK3480 Forbrukeratferd,1453941116,2016-01-28 01:31:56,1453941161,45
5698da4e41a9d72100240707,46915,MRK3480 Forbrukeratferd,1453953017,2016-01-28 04:50:17,1453954252,1235
5698da4e41a9d72100240707,3501,MRK3480 Forbrukeratferd,1454614540,2016-02-04 20:35:40,1454614582,42
5698da4e41a9d72100240707,79363,MRK3480 Forbrukeratferd,1454631293,2016-02-05 01:14:53,1454632068,775
5698da4e41a9d72100240708,39870,MRK3480 Forbrukeratferd,1452862649,2016-01-15 13:57:29,1452862714,65
5698da4e41a9d72100240708,31346,MRK3480 Forbrukeratferd,1453132827,2016-01-18 17:00:27,1453132869,42
5698da4e41a9d72100240708,23733,MRK3480 Forbrukeratferd,1453228156,2016-01-19 19:29:16,1453228230,74
5698da4e41a9d72100240708,75735,MRK3480 Forbrukeratferd,1453322840,2016-01-20 21:47:20,1453323293,453
5698da4e41a9d72100240708,46617,MRK3480 Forbrukeratferd,1453331065,2016-01-21 00:04:25,1453331305,240
5698da4e41a9d72100240708,64289,MRK3480 Forbrukeratferd,1453370355,2016-01-21 10:59:15,1453370564,209
5698da4e41a9d72100240708,23922,MRK3480 Forbrukeratferd,1453374331,2016-01-21 12:05:31,1453374331,0
5698da4e41a9d72100240708,81580,MRK3480 Forbrukeratferd,1453375820,2016-01-21 12:30:20,1453376029,209
5698da4e41a9d72100240708,91671,MRK3480 Forbrukeratferd,1453381300,2016-01-21 14:01:40,1453381301,1
5698da4e41a9d72100240708,2981,MRK3480 Forbrukeratferd,1453397651,2016-01-21 18:34:11,1453397663,12
5698da4e41a9d72100240708,6402,MRK3480 Forbrukeratferd,1453575138,2016-01-23 19:52:18,1453575179,41
5698da4e41a9d72100240708,72413,MRK3480 Forbrukeratferd,1453577751,2016-01-23 20:35:51,1453577752,1
5698da4e41a9d72100240708,70787,MRK3480 Forbrukeratferd,1453637581,2016-01-24 13:13:01,1453637599,18
5698da4e41a9d72100240708,24674,MRK3480 Forbrukeratferd,1453675578,2016-01-24 23:46:18,1453676577,999
5698da4e41a9d72100240708,61931,MRK3480 Forbrukeratferd,1453725019,2016-01-25 13:30:19,1453725025,6
5698da4e41a9d72100240708,74179,MRK3480 Forbrukeratferd,1453754946,2016-01-25 21:49:06,1453754947,1
5698da4e41a9d72100240708,76923,MRK3480 Forbrukeratferd,1453914098,2016-01-27 18:01:38,1453914137,39
5698da4e41a9d72100240708,23860,MRK3480 Forbrukeratferd,1453978679,2016-01-28 11:57:59,1453978765,86
5698da4e41a9d72100240708,74958,MRK3480 Forbrukeratferd,1453980645,2016-01-28 12:30:45,1453981475,830
5698da4e41a9d72100240708,12003,MRK3480 Forbrukeratferd,1453987635,2016-01-28 14:27:15,1453987647,12
5698da4e41a9d72100240708,87422,MRK3480 Forbrukeratferd,1454343564,2016-02-01 17:19:24,1454343601,37
5698da4e41a9d72100240708,89848,MRK3480 Forbrukeratferd,1454596162,2016-02-04 15:29:22,1454596162,0
5698da4e41a9d72100240708,35144,MRK3480 Forbrukeratferd,1454665583,2016-02-05 10:46:23,1454665586,3
5698da4e41a9d72100240708,80668,MRK3480 Forbrukeratferd,1454679208,2016-02-05 14:33:28,1454679227,19
5698da4e41a9d72100240708,20144,MRK3480 Forbrukeratferd,1454864212,2016-02-07 17:56:52,1454864232,20
5698da4e41a9d72100240708,29542,MRK3480 Forbrukeratferd,1454934796,2016-02-08 13:33:16,1454934810,14
5698da4e41a9d72100240708,3149,ORG3402 Organisasjonsatferd og ledelse,1454940825,2016-02-08 15:13:45,1454940852,27
5698da4e41a9d72100240708,61846,MRK3480 Forbrukeratferd,1455105238,2016-02-10 12:53:58,1455105284,46
5698da4e41a9d72100240708,96975,ORG3402 Organisasjonsatferd og ledelse,1455205363,2016-02-11 16:42:43,1455205363,0
5698da4e41a9d72100240708,75302,MRK3480 Forbrukeratferd,1455272333,2016-02-12 11:18:53,1455272632,299
5698da4e41a9d72100240708,26757,MRK3480 Forbrukeratferd,1455361678,2016-02-13 12:07:58,1455363158,1480
5698da4e41a9d72100240708,44643,MRK3480 Forbrukeratferd,1455366321,2016-02-13 13:25:21,1455366327,6
5698da4e41a9d72100240708,98427,MRK3480 Forbrukeratferd,1455383926,2016-02-13 18:18:46,1455383944,18
5698da4e41a9d72100240709,46721,MRK3480 Forbrukeratferd,1452864483,2016-01-15 14:28:03,1452864483,0
5698da4e41a9d72100240709,50834,MRK3480 Forbrukeratferd,1453288096,2016-01-20 12:08:16,1453288117,21
5698da4e41a9d72100240709,42051,MRK3480 Forbrukeratferd,1453724644,2016-01-25 13:24:04,1453724651,7
5698da4e41a9d72100240709,83162,MRK3480 Forbrukeratferd,1453726300,2016-01-25 13:51:40,1453726332,32
5698da4e41a9d72100240709,16981,MRK3480 Forbrukeratferd,1453895315,2016-01-27 12:48:35,1453895489,174
5698da4e41a9d72100240709,3389,MRK3480 Forbrukeratferd,1453982984,2016-01-28 13:09:44,1453983035,51
5698da4e41a9d72100240709,20286,MRK3480 Forbrukeratferd,1454402802,2016-02-02 09:46:42,1454402836,34
5698da4e41a9d72100240709,46695,MRK3480 Forbrukeratferd,1454670530,2016-02-05 12:08:50,1454670656,126
5698da4e41a9d72100240709,86355,MRK3480 Forbrukeratferd,1455274645,2016-02-12 11:57:25,1455275016,371
5698da4e41a9d72100240709,64867,MRK3480 Forbrukeratferd,1455278545,2016-02-12 13:02:25,1455278545,0
5698da4e41a9d72100240709,92672,MRK3480 Forbrukeratferd,1455281711,2016-02-12 13:55:11,1455281711,0
5698da4f2fb0de2600f229f7,81497,MRK3480 Forbrukeratferd,1453139351,2016-01-18 18:49:11,1453139502,151
5698da4f2fb0de2600f229f7,94557,MRK3480 Forbrukeratferd,1453213645,2016-01-19 15:27:25,1453213885,240
5698da4f2fb0de2600f229f7,70562,MRK3480 Forbrukeratferd,1453386180,2016-01-21 15:23:00,1453387009,829
5698da4f2fb0de2600f229f7,89787,MRK3480 Forbrukeratferd,1453388830,2016-01-21 16:07:10,1453389420,590
5698da4f2fb0de2600f229f7,45498,MRK3480 Forbrukeratferd,1453391761,2016-01-21 16:56:01,1453392366,605
5698da4f2fb0de2600f229f7,47305,MRK3480 Forbrukeratferd,1453942499,2016-01-28 01:54:59,1453942692,193
5698da4f2fb0de2600f229f7,38837,MRK3480 Forbrukeratferd,1454008073,2016-01-28 20:07:53,1454008998,925
5698da4f2fb0de2600f229f7,39585,MRK3480 Forbrukeratferd,1454010927,2016-01-28 20:55:27,1454010928,1
5698da4f2fb0de2600f229f7,46573,MRK3480 Forbrukeratferd,1454448385,2016-02-02 22:26:25,1454448429,44
5698da4f2fb0de2600f229f7,86935,MRK3480 Forbrukeratferd,1454540130,2016-02-03 23:55:30,1454540130,0
5698da4f2fb0de2600f229f7,79298,MRK3480 Forbrukeratferd,1454684846,2016-02-05 16:07:26,1454684867,21
5698da4f2fb0de2600f229f7,30341,MRK3480 Forbrukeratferd,1455202366,2016-02-11 15:52:46,1455203520,1154
5698da4f2fb0de2600f229f8,17324,MRK3480 Forbrukeratferd,1453215890,2016-01-19 16:04:50,1453216084,194
5698da4f2fb0de2600f229f9,52697,MRK3480 Forbrukeratferd,1453379131,2016-01-21 13:25:31,1453379353,222
5698da4f2fb0de2600f229f9,30384,MRK3480 Forbrukeratferd,1453918665,2016-01-27 19:17:45,1453918874,209
5698da4f2fb0de2600f229f9,79834,MRK3480 Forbrukeratferd,1454413737,2016-02-02 12:48:57,1454413758,21
5698da4f2fb0de2600f229f9,62430,MRK3480 Forbrukeratferd,1454511321,2016-02-03 15:55:21,1454511841,520
5698da4f2fb0de2600f229f9,46080,MRK3480 Forbrukeratferd,1454669709,2016-02-05 11:55:09,1454669828,119
5698da4f2fb0de2600f229fa,89731,MRK3480 Forbrukeratferd,1452877338,2016-01-15 18:02:18,1452877553,215
5698da4f2fb0de2600f229fa,49475,MRK3480 Forbrukeratferd,1452887956,2016-01-15 20:59:16,1452888828,872
5698da4f2fb0de2600f229fa,61999,MRK3480 Forbrukeratferd,1452957417,2016-01-16 16:16:57,1452958604,1187
5698da4f2fb0de2600f229fa,91028,MRK3480 Forbrukeratferd,1453151616,2016-01-18 22:13:36,1453151869,253
5698da4f2fb0de2600f229fa,35020,MRK3480 Forbrukeratferd,1453327938,2016-01-20 23:12:18,1453328064,126
5698da4f2fb0de2600f229fa,85158,MRK3480 Forbrukeratferd,1453375934,2016-01-21 12:32:14,1453376075,141
5698da4f2fb0de2600f229fa,68793,MRK3480 Forbrukeratferd,1453405362,2016-01-21 20:42:42,1453405368,6
5698da4f2fb0de2600f229fa,13102,MRK3480 Forbrukeratferd,1453676980,2016-01-25 00:09:40,1453677398,418
5698da4f2fb0de2600f229fa,13841,MRK3480 Forbrukeratferd,1453728078,2016-01-25 14:21:18,1453728085,7
5698da4f2fb0de2600f229fa,52322,MRK3480 Forbrukeratferd,1454020986,2016-01-28 23:43:06,1454021034,48
5698da4f2fb0de2600f229fa,38297,MRK3480 Forbrukeratferd,1454025188,2016-01-29 00:53:08,1454025189,1
5698da4f2fb0de2600f229fa,37299,MRK3480 Forbrukeratferd,1454511178,2016-02-03 15:52:58,1454511473,295
5698da4f2fb0de2600f229fa,44041,MRK3480 Forbrukeratferd,1454608883,2016-02-04 19:01:23,1454608884,1
5698da4f2fb0de2600f229fa,74106,MRK3480 Forbrukeratferd,1454618255,2016-02-04 21:37:35,1454618255,0
5698da4f2fb0de2600f229fa,15689,MRK3480 Forbrukeratferd,1454670219,2016-02-05 12:03:39,1454670290,71
5698da4f2fb0de2600f229fa,64266,MRK3480 Forbrukeratferd,1454977903,2016-02-09 01:31:43,1454977941,38
5698da4f2fb0de2600f229fa,91743,MRK3480 Forbrukeratferd,1455011724,2016-02-09 10:55:24,1455011724,0
5698da4f2fb0de2600f229fa,59840,MRK3480 Forbrukeratferd,1455274760,2016-02-12 11:59:20,1455274810,50
5698da4f2fb0de2600f229fb,44169,MRK3480 Forbrukeratferd,1453978185,2016-01-28 11:49:45,1453979251,1066
5698da4f2fb0de2600f229fb,94302,MRK3480 Forbrukeratferd,1453981033,2016-01-28 12:37:13,1453982325,1292
5698da4f2fb0de2600f229fb,75979,MRK3480 Forbrukeratferd,1453988423,2016-01-28 14:40:23,1453988441,18
5698da4f41a9d7210024070f,53221,MRK3480 Forbrukeratferd,1453374544,2016-01-21 12:09:04,1453374545,1
5698da4f41a9d7210024070f,72144,MRK3480 Forbrukeratferd,1453376831,2016-01-21 12:47:11,1453378576,1745
5698da4f41a9d7210024070f,60507,MRK3480 Forbrukeratferd,1453983184,2016-01-28 13:13:04,1453983274,90
5698da4f41a9d7210024070f,32338,MRK3480 Forbrukeratferd,1454015082,2016-01-28 22:04:42,1454015236,154
5698da4f41a9d7210024070f,95744,MRK3480 Forbrukeratferd,1454176287,2016-01-30 18:51:27,1454176377,90
5698da4f41a9d7210024070f,19774,MRK3480 Forbrukeratferd,1454342568,2016-02-01 17:02:48,1454342568,0
5698da4f41a9d7210024070f,86637,MRK3480 Forbrukeratferd,1454497508,2016-02-03 12:05:08,1454497508,0
5698da4f41a9d7210024070f,6374,MRK3480 Forbrukeratferd,1454535574,2016-02-03 22:39:34,1454535574,0
5698da4f41a9d7210024070f,52894,MRK3480 Forbrukeratferd,1454670310,2016-02-05 12:05:10,1454670331,21
5698da4f41a9d7210024070f,37008,MRK3480 Forbrukeratferd,1454671787,2016-02-05 12:29:47,1454671787,0
5698da4f41a9d7210024070f,86556,MRK3480 Forbrukeratferd,1454863488,2016-02-07 17:44:48,1454863943,455
5698da4f41a9d7210024070f,93612,MRK3480 Forbrukeratferd,1455103809,2016-02-10 12:30:09,1455103810,1
5698da4f41a9d7210024070f,71517,MRK3480 Forbrukeratferd,1455453261,2016-02-14 13:34:21,1455454411,1150
5698da4f41a9d7210024070f,38638,MRK3480 Forbrukeratferd,1455486516,2016-02-14 22:48:36,1455486516,0
5698da4f41a9d72100240710,76708,MRK3480 Forbrukeratferd,1453061975,2016-01-17 21:19:35,1453062166,191
5698da4f41a9d72100240710,7553,MRK3480 Forbrukeratferd,1453165141,2016-01-19 01:59:01,1453165238,97
5698da4f41a9d72100240710,63994,MRK3480 Forbrukeratferd,1453911902,2016-01-27 17:25:02,1453911935,33
5698da4f41a9d72100240710,55727,MRK3480 Forbrukeratferd,1453983203,2016-01-28 13:13:23,1453983234,31
5698da5041a9d72100240714,39862,MRK3480 Forbrukeratferd,1453893648,2016-01-27 12:20:48,1453893785,137
5698da5041a9d72100240714,9411,MRK3480 Forbrukeratferd,1453897738,2016-01-27 13:28:58,1453898813,1075
5698da5041a9d72100240714,25032,MRK3480 Forbrukeratferd,1453903525,2016-01-27 15:05:25,1453903527,2
5698da5041a9d72100240714,95132,MRK3480 Forbrukeratferd,1453979112,2016-01-28 12:05:12,1453979251,139
5698da5041a9d72100240714,76035,MRK3480 Forbrukeratferd,1454515392,2016-02-03 17:03:12,1454515526,134
5698da5041a9d72100240714,63662,MRK3480 Forbrukeratferd,1454930448,2016-02-08 12:20:48,1454930530,82
5698da5041a9d72100240716,23253,MRK3480 Forbrukeratferd,1454492202,2016-02-03 10:36:42,1454493101,899
5698da5041a9d72100240717,67796,MRK3480 Forbrukeratferd,1453378194,2016-01-21 13:09:54,1453378713,519
5698da5041a9d72100240717,27951,MRK3480 Forbrukeratferd,1453473311,2016-01-22 15:35:11,1453473664,353
5698da5041a9d72100240717,61412,MRK3480 Forbrukeratferd,1453565727,2016-01-23 17:15:27,1453565728,1
5698da5041a9d72100240717,7669,MRK3480 Forbrukeratferd,1453986988,2016-01-28 14:16:28,1453987001,13
5698da5041a9d72100240717,37733,MRK3480 Forbrukeratferd,1454205325,2016-01-31 02:55:25,1454205540,215
5698da5041a9d72100240717,35733,MRK3480 Forbrukeratferd,1455280348,2016-02-12 13:32:28,1455280352,4
5698da5041a9d72100240717,11468,MRK3480 Forbrukeratferd,1455286327,2016-02-12 15:12:07,1455286327,0
5698da5041a9d72100240717,44280,MRK3480 Forbrukeratferd,1455288282,2016-02-12 15:44:42,1455289934,1652
5698da512fb0de2600f22a12,20442,MRK3480 Forbrukeratferd,1454066250,2016-01-29 12:17:30,1454067490,1240
5698da512fb0de2600f22a12,42173,MRK3480 Forbrukeratferd,1455235141,2016-02-12 00:59:01,1455235146,5
5698da512fb0de2600f22a13,67,MRK3480 Forbrukeratferd,1452862742,2016-01-15 13:59:02,1452863139,397
5698da512fb0de2600f22a13,99233,MRK3480 Forbrukeratferd,1452905296,2016-01-16 01:48:16,1452905327,31
5698da512fb0de2600f22a13,82746,MRK3480 Forbrukeratferd,1452963998,2016-01-16 18:06:38,1452964223,225
5698da512fb0de2600f22a13,34109,MRK3480 Forbrukeratferd,1452987807,2016-01-17 00:43:27,1452987932,125
5698da512fb0de2600f22a13,53275,MRK3480 Forbrukeratferd,1453032890,2016-01-17 13:14:50,1453032913,23
5698da512fb0de2600f22a13,42692,MRK3480 Forbrukeratferd,1453125633,2016-01-18 15:00:33,1453125662,29
5698da512fb0de2600f22a13,87456,MRK3480 Forbrukeratferd,1453675916,2016-01-24 23:51:56,1453676253,337
5698da512fb0de2600f22a13,98701,MRK3480 Forbrukeratferd,1453736318,2016-01-25 16:38:38,1453736319,1
5698da512fb0de2600f22a13,34755,MRK3480 Forbrukeratferd,1453807072,2016-01-26 12:17:52,1453807075,3
5698da512fb0de2600f22a13,49772,MRK3480 Forbrukeratferd,1453977806,2016-01-28 11:43:26,1453977866,60
5698da5141a9d7210024072e,64628,MRK3480 Forbrukeratferd,1453757102,2016-01-25 22:25:02,1453757161,59
5698da5141a9d7210024072e,17013,MRK3480 Forbrukeratferd,1454099150,2016-01-29 21:25:50,1454100066,916
5698da5141a9d7210024072f,29500,MRK3480 Forbrukeratferd,1455213338,2016-02-11 18:55:38,1455213427,89
5698da522fb0de2600f22a17,45915,MRK3480 Forbrukeratferd,1453379997,2016-01-21 13:39:57,1453379997,0
5698da522fb0de2600f22a17,66115,MRK3480 Forbrukeratferd,1453713970,2016-01-25 10:26:10,1453714016,46
5698da522fb0de2600f22a19,54305,MRK3480 Forbrukeratferd,1453120575,2016-01-18 13:36:15,1453120808,233
5698da522fb0de2600f22a19,47505,MRK3480 Forbrukeratferd,1453131636,2016-01-18 16:40:36,1453131779,143
5698da522fb0de2600f22a19,50285,MRK3480 Forbrukeratferd,1453145279,2016-01-18 20:27:59,1453145297,18
5698da522fb0de2600f22a19,96698,MRK3480 Forbrukeratferd,1453220224,2016-01-19 17:17:04,1453220225,1
5698da522fb0de2600f22a19,8096,MRK3480 Forbrukeratferd,1453374483,2016-01-21 12:08:03,1453375804,1321
5698da522fb0de2600f22a19,16059,MRK3480 Forbrukeratferd,1453384963,2016-01-21 15:02:43,1453385187,224
5698da522fb0de2600f22a19,79365,MRK3480 Forbrukeratferd,1453986696,2016-01-28 14:11:36,1453986812,116
5698da522fb0de2600f22a19,51041,MRK3480 Forbrukeratferd,1454902969,2016-02-08 04:42:49,1454903583,614
5698da522fb0de2600f22a1a,92570,MRK3480 Forbrukeratferd,1453208652,2016-01-19 14:04:12,1453209227,575
5698da522fb0de2600f22a1c,8390,MRK3480 Forbrukeratferd,1453242935,2016-01-19 23:35:35,1453243564,629
5698da522fb0de2600f22a1c,49701,MRK3480 Forbrukeratferd,1453852488,2016-01-27 00:54:48,1453853020,532
5698da522fb0de2600f22a1d,3109,MRK3480 Forbrukeratferd,1452881882,2016-01-15 19:18:02,1452882351,469
5698da522fb0de2600f22a1d,77001,MRK3480 Forbrukeratferd,1453125028,2016-01-18 14:50:28,1453125030,2
5698da522fb0de2600f22a1d,36143,MRK3480 Forbrukeratferd,1453194288,2016-01-19 10:04:48,1453194300,12
5698da522fb0de2600f22a1d,10271,MRK3480 Forbrukeratferd,1453199029,2016-01-19 11:23:49,1453199038,9
5698da522fb0de2600f22a1d,9354,MRK3480 Forbrukeratferd,1453201781,2016-01-19 12:09:41,1453201786,5
5698da522fb0de2600f22a1d,20208,MRK3480 Forbrukeratferd,1453210715,2016-01-19 14:38:35,1453210726,11
5698da522fb0de2600f22a1d,36230,MRK3480 Forbrukeratferd,1453228188,2016-01-19 19:29:48,1453228188,0
5698da522fb0de2600f22a1d,33686,MRK3480 Forbrukeratferd,1453363809,2016-01-21 09:10:09,1453364145,336
5698da522fb0de2600f22a1d,94764,MRK3480 Forbrukeratferd,1453387841,2016-01-21 15:50:41,1453387857,16
5698da522fb0de2600f22a1d,34176,MRK3480 Forbrukeratferd,1453556453,2016-01-23 14:40:53,1453556461,8
5698da522fb0de2600f22a1d,94482,MRK3480 Forbrukeratferd,1453713299,2016-01-25 10:14:59,1453713299,0
5698da522fb0de2600f22a1d,83094,MRK3480 Forbrukeratferd,1453719407,2016-01-25 11:56:47,1453719420,13
5698da522fb0de2600f22a1d,84367,MRK3480 Forbrukeratferd,1453897904,2016-01-27 13:31:44,1453897915,11
5698da522fb0de2600f22a1d,48720,MRK3480 Forbrukeratferd,1454233444,2016-01-31 10:44:04,1454233525,81
5698da522fb0de2600f22a1d,15828,MRK3480 Forbrukeratferd,1454333652,2016-02-01 14:34:12,1454333876,224
5698da522fb0de2600f22a1d,49841,MRK3480 Forbrukeratferd,1454667476,2016-02-05 11:17:56,1454668230,754
5698da522fb0de2600f22a1d,69121,MRK3480 Forbrukeratferd,1454669943,2016-02-05 11:59:03,1454670201,258
5698da5241a9d72100240733,86890,MRK3480 Forbrukeratferd,1453225039,2016-01-19 18:37:19,1453225361,322
5698da5241a9d72100240733,81152,MRK3480 Forbrukeratferd,1453227550,2016-01-19 19:19:10,1453228699,1149
5698da5241a9d72100240733,8966,MRK3480 Forbrukeratferd,1453316482,2016-01-20 20:01:22,1453317195,713
5698da5241a9d72100240733,12691,MRK3480 Forbrukeratferd,1453324276,2016-01-20 22:11:16,1453324740,464
5698da5241a9d72100240733,37460,MRK3480 Forbrukeratferd,1453326119,2016-01-20 22:41:59,1453326119,0
5698da5241a9d72100240733,80309,MRK3480 Forbrukeratferd,1453377804,2016-01-21 13:03:24,1453378010,206
5698da5241a9d72100240733,12261,MRK3480 Forbrukeratferd,1453381666,2016-01-21 14:07:46,1453381667,1
5698da5241a9d72100240733,97519,MRK3480 Forbrukeratferd,1453908991,2016-01-27 16:36:31,1453909207,216
5698da5241a9d72100240733,86278,MRK3480 Forbrukeratferd,1453920078,2016-01-27 19:41:18,1453920079,1
5698da5241a9d72100240733,11650,MRK3480 Forbrukeratferd,1453930701,2016-01-27 22:38:21,1453930703,2
5698da5241a9d72100240733,24041,MRK3480 Forbrukeratferd,1453979818,2016-01-28 12:16:58,1453979915,97
5698da5241a9d72100240733,31178,MRK3480 Forbrukeratferd,1453981515,2016-01-28 12:45:15,1453981599,84
5698da5241a9d72100240733,21124,MRK3480 Forbrukeratferd,1455230349,2016-02-11 23:39:09,1455230656,307
5698da5241a9d72100240733,60821,MRK3480 Forbrukeratferd,1455235264,2016-02-12 01:01:04,1455235278,14
5698da5241a9d72100240733,59308,MRK3480 Forbrukeratferd,1455274838,2016-02-12 12:00:38,1455274864,26
5698da5241a9d72100240733,70675,MRK3480 Forbrukeratferd,1455282295,2016-02-12 14:04:55,1455282300,5
5698da5241a9d72100240735,60842,MRK3480 Forbrukeratferd,1453133512,2016-01-18 17:11:52,1453133512,0
5698da5241a9d72100240735,19447,MRK3480 Forbrukeratferd,1453860714,2016-01-27 03:11:54,1453860768,54
5698da5241a9d72100240735,27519,MRK3480 Forbrukeratferd,1453895172,2016-01-27 12:46:12,1453895172,0
5698da5241a9d72100240735,22216,MRK3480 Forbrukeratferd,1453913392,2016-01-27 17:49:52,1453913439,47
5698da5241a9d72100240735,68445,MRK3480 Forbrukeratferd,1453918461,2016-01-27 19:14:21,1453918462,1
5698da5241a9d72100240735,79233,MRK3480 Forbrukeratferd,1455119679,2016-02-10 16:54:39,1455119722,43
5698da5241a9d72100240735,52891,MRK3480 Forbrukeratferd,1455122781,2016-02-10 17:46:21,1455122781,0
5698da5241a9d72100240736,74777,MRK3480 Forbrukeratferd,1453979937,2016-01-28 12:18:57,1453980192,255
5698da5241a9d72100240736,23970,MRK3480 Forbrukeratferd,1453991354,2016-01-28 15:29:14,1453992472,1118
5698da5241a9d72100240736,94241,MRK3480 Forbrukeratferd,1455270634,2016-02-12 10:50:34,1455271121,487
5698da532fb0de2600f22a1e,73521,MRK3480 Forbrukeratferd,1452890987,2016-01-15 21:49:47,1452891129,142
5698da532fb0de2600f22a1e,96569,MRK3480 Forbrukeratferd,1453050381,2016-01-17 18:06:21,1453051592,1211
5698da532fb0de2600f22a1e,43248,MRK3480 Forbrukeratferd,1453678533,2016-01-25 00:35:33,1453678534,1
5698da532fb0de2600f22a1e,67118,MRK3480 Forbrukeratferd,1453806731,2016-01-26 12:12:11,1453806796,65
5698da532fb0de2600f22a1e,52777,MRK3480 Forbrukeratferd,1453815335,2016-01-26 14:35:35,1453815336,1
5698da532fb0de2600f22a1e,87797,MRK3480 Forbrukeratferd,1453820465,2016-01-26 16:01:05,1453820466,1
5698da532fb0de2600f22a1e,64089,MRK3480 Forbrukeratferd,1453919317,2016-01-27 19:28:37,1453919480,163
5698da532fb0de2600f22a1e,3032,MRK3480 Forbrukeratferd,1454443120,2016-02-02 20:58:40,1454443162,42
5698da532fb0de2600f22a1f,86349,MRK3480 Forbrukeratferd,1453378725,2016-01-21 13:18:45,1453378870,145
5698da532fb0de2600f22a1f,5163,MRK3480 Forbrukeratferd,1453724118,2016-01-25 13:15:18,1453724148,30
5698da532fb0de2600f22a1f,14398,MRK3480 Forbrukeratferd,1453985051,2016-01-28 13:44:11,1453987601,2550
5698da532fb0de2600f22a1f,74616,MRK3480 Forbrukeratferd,1455223098,2016-02-11 21:38:18,1455223123,25
5698da5341a9d72100240738,52044,MRK3480 Forbrukeratferd,1453205659,2016-01-19 13:14:19,1453205817,158
5698da5341a9d72100240738,2882,MRK3480 Forbrukeratferd,1454583443,2016-02-04 11:57:23,1454583572,129
5698da5341a9d7210024073a,45622,MRK3480 Forbrukeratferd,1453678235,2016-01-25 00:30:35,1453678304,69
5698da5341a9d7210024073b,41367,MRK3480 Forbrukeratferd,1452890698,2016-01-15 21:44:58,1452891754,1056
5698da5341a9d7210024073b,11292,MRK3480 Forbrukeratferd,1452898442,2016-01-15 23:54:02,1452899752,1310
5698da5341a9d7210024073b,88214,MRK3480 Forbrukeratferd,1453475437,2016-01-22 16:10:37,1453475476,39
5698da5341a9d7210024073b,36532,MRK3480 Forbrukeratferd,1453565382,2016-01-23 17:09:42,1453566167,785
5698da5341a9d7210024073b,92747,MRK3480 Forbrukeratferd,1453721093,2016-01-25 12:24:53,1453721098,5
5698da5341a9d7210024073b,2046,MRK3480 Forbrukeratferd,1453723782,2016-01-25 13:09:42,1453723784,2
5698da5341a9d7210024073b,98595,MRK3480 Forbrukeratferd,1453726690,2016-01-25 13:58:10,1453727195,505
5698da5341a9d7210024073b,80456,MRK3480 Forbrukeratferd,1453916788,2016-01-27 18:46:28,1453916816,28
5698da5341a9d7210024073b,47248,MRK3480 Forbrukeratferd,1454354389,2016-02-01 20:19:49,1454354928,539
5698da5341a9d7210024073b,21664,MRK3480 Forbrukeratferd,1455112468,2016-02-10 14:54:28,1455112898,430
5698da542fb0de2600f22a3a,41697,MRK3480 Forbrukeratferd,1453122362,2016-01-18 14:06:02,1453122858,496
5698da542fb0de2600f22a3a,74009,MRK3480 Forbrukeratferd,1453125426,2016-01-18 14:57:06,1453125575,149
5698da542fb0de2600f22a3a,53303,MRK3480 Forbrukeratferd,1453127664,2016-01-18 15:34:24,1453127666,2
5698da542fb0de2600f22a3a,42843,MRK3480 Forbrukeratferd,1453290695,2016-01-20 12:51:35,1453291282,587
5698da542fb0de2600f22a3a,88168,MRK3480 Forbrukeratferd,1453378203,2016-01-21 13:10:03,1453378587,384
5698da542fb0de2600f22a3b,50731,MRK3480 Forbrukeratferd,1453301629,2016-01-20 15:53:49,1453301647,18
5698da542fb0de2600f22a3b,64755,MRK3480 Forbrukeratferd,1453374324,2016-01-21 12:05:24,1453375575,1251
5698da542fb0de2600f22a3b,5536,MRK3480 Forbrukeratferd,1453377719,2016-01-21 13:01:59,1453378407,688
5698da542fb0de2600f22a3b,44711,MRK3480 Forbrukeratferd,1453381567,2016-01-21 14:06:07,1453382340,773
5698da542fb0de2600f22a3b,36219,MRK3480 Forbrukeratferd,1453950869,2016-01-28 04:14:29,1453950988,119
5698da542fb0de2600f22a3b,16136,MRK3480 Forbrukeratferd,1455245050,2016-02-12 03:44:10,1455245168,118
5698da542fb0de2600f22a3b,53777,MRK3480 Forbrukeratferd,1455275011,2016-02-12 12:03:31,1455275204,193
5698da542fb0de2600f22a3b,50165,MRK3480 Forbrukeratferd,1455283551,2016-02-12 14:25:51,1455283553,2
5698da542fb0de2600f22a3c,37067,MRK3480 Forbrukeratferd,1452870658,2016-01-15 16:10:58,1452871607,949
5698da542fb0de2600f22a3c,90236,MRK3480 Forbrukeratferd,1453064158,2016-01-17 21:55:58,1453064191,33
5698da542fb0de2600f22a3c,78363,MRK3480 Forbrukeratferd,1453122019,2016-01-18 14:00:19,1453122115,96
5698da542fb0de2600f22a3c,23184,MRK3480 Forbrukeratferd,1453149451,2016-01-18 21:37:31,1453149495,44
5698da542fb0de2600f22a3c,84276,MRK3480 Forbrukeratferd,1453316460,2016-01-20 20:01:00,1453317183,723
5698da542fb0de2600f22a3c,87351,MRK3480 Forbrukeratferd,1453644463,2016-01-24 15:07:43,1453644463,0
5698da542fb0de2600f22a3c,69011,MRK3480 Forbrukeratferd,1453912818,2016-01-27 17:40:18,1453914439,1621
5698da542fb0de2600f22a3c,47130,MRK3480 Forbrukeratferd,1454003251,2016-01-28 18:47:31,1454003283,32
5698da542fb0de2600f22a3c,3964,MRK3480 Forbrukeratferd,1454516520,2016-02-03 17:22:00,1454517028,508
5698da542fb0de2600f22a3c,47008,MRK3480 Forbrukeratferd,1454518658,2016-02-03 17:57:38,1454518658,0
5698da542fb0de2600f22a3c,63672,MRK3480 Forbrukeratferd,1454670241,2016-02-05 12:04:01,1454670316,75
5698da542fb0de2600f22a3c,43403,MRK3480 Forbrukeratferd,1455378625,2016-02-13 16:50:25,1455378676,51
5698da542fb0de2600f22a3c,64016,MRK3480 Forbrukeratferd,1455380312,2016-02-13 17:18:32,1455380823,511
5698da542fb0de2600f22a3d,81280,MRK3480 Forbrukeratferd,1452872851,2016-01-15 16:47:31,1452872933,82
5698da542fb0de2600f22a3d,31684,MRK3480 Forbrukeratferd,1452874316,2016-01-15 17:11:56,1452874569,253
5698da542fb0de2600f22a3d,93696,MRK3480 Forbrukeratferd,1453145795,2016-01-18 20:36:35,1453145935,140
5698da542fb0de2600f22a3d,43610,MRK3480 Forbrukeratferd,1453363852,2016-01-21 09:10:52,1453363887,35
5698da542fb0de2600f22a3d,30826,MRK3480 Forbrukeratferd,1453391316,2016-01-21 16:48:36,1453391969,653
5698da542fb0de2600f22a3d,4974,MRK3480 Forbrukeratferd,1453832271,2016-01-26 19:17:51,1453832343,72
5698da542fb0de2600f22a3d,29923,MRK3480 Forbrukeratferd,1453930565,2016-01-27 22:36:05,1453930659,94
5698da542fb0de2600f22a3d,97983,MRK3480 Forbrukeratferd,1453976164,2016-01-28 11:16:04,1453976540,376
5698da542fb0de2600f22a3d,34325,MRK3480 Forbrukeratferd,1454421729,2016-02-02 15:02:09,1454421752,23
5698da542fb0de2600f22a3d,26458,MRK3480 Forbrukeratferd,1454599468,2016-02-04 16:24:28,1454599516,48
5698da542fb0de2600f22a3d,4960,MRK3480 Forbrukeratferd,1454670346,2016-02-05 12:05:46,1454670921,575
5698da542fb0de2600f22a3d,7207,MRK3480 Forbrukeratferd,1454675628,2016-02-05 13:33:48,1454675641,13
5698da542fb0de2600f22a3d,62502,MRK3480 Forbrukeratferd,1454679206,2016-02-05 14:33:26,1454679241,35
5698da542fb0de2600f22a3d,21270,MRK3480 Forbrukeratferd,1454849340,2016-02-07 13:49:00,1454849357,17
5698da542fb0de2600f22a3d,90713,MRK3480 Forbrukeratferd,1454850773,2016-02-07 14:12:53,1454850773,0
5698da542fb0de2600f22a3d,1260,MRK3480 Forbrukeratferd,1455264760,2016-02-12 09:12:40,1455265597,837
5698da542fb0de2600f22a3e,87387,MRK3480 Forbrukeratferd,1453393784,2016-01-21 17:29:44,1453394173,389
5698da542fb0de2600f22a3e,76453,MRK3480 Forbrukeratferd,1454338569,2016-02-01 15:56:09,1454338789,220
5698da5441a9d72100240756,294,MRK3480 Forbrukeratferd,1453204200,2016-01-19 12:50:00,1453204284,84
5698da5441a9d72100240756,34782,MRK3480 Forbrukeratferd,1453370245,2016-01-21 10:57:25,1453370345,100
5698da5441a9d72100240756,96132,MRK3480 Forbrukeratferd,1453908040,2016-01-27 16:20:40,1453908141,101
5698da5441a9d72100240756,5801,MRK3480 Forbrukeratferd,1453979742,2016-01-28 12:15:42,1453980084,342
5698da5441a9d72100240756,36548,MRK3480 Forbrukeratferd,1453983102,2016-01-28 13:11:42,1453983105,3
5698da5441a9d72100240756,44578,MRK3480 Forbrukeratferd,1454503780,2016-02-03 13:49:40,1454504085,305
5698da5441a9d72100240756,25806,MRK3480 Forbrukeratferd,1455275421,2016-02-12 12:10:21,1455275434,13
5698da552fb0de2600f22a3f,36654,MRK3480 Forbrukeratferd,1453894887,2016-01-27 12:41:27,1453894887,0
5698da552fb0de2600f22a3f,54797,MRK3480 Forbrukeratferd,1454601718,2016-02-04 17:01:58,1454601768,50
5698da5541a9d72100240758,75352,MRK3480 Forbrukeratferd,1453133533,2016-01-18 17:12:13,1453133542,9
5698da5541a9d72100240758,11009,MRK3480 Forbrukeratferd,1453138894,2016-01-18 18:41:34,1453138895,1
5698da5541a9d72100240758,29895,MRK3480 Forbrukeratferd,1453361901,2016-01-21 08:38:21,1453361989,88
5698da5541a9d72100240758,83848,MRK3480 Forbrukeratferd,1453366005,2016-01-21 09:46:45,1453366018,13
5698da5541a9d72100240758,28503,ORG3402 Organisasjonsatferd og ledelse,1454399959,2016-02-02 08:59:19,1454400091,132
5698da5541a9d72100240758,58711,MRK3480 Forbrukeratferd,1454411737,2016-02-02 12:15:37,1454411974,237
5698da5541a9d72100240758,30723,MRK3480 Forbrukeratferd,1455289697,2016-02-12 16:08:17,1455289741,44
5698da5541a9d72100240758,565,MRK3480 Forbrukeratferd,1455316654,2016-02-12 23:37:34,1455316654,0
5698da5541a9d72100240759,52785,MRK3480 Forbrukeratferd,1453377845,2016-01-21 13:04:05,1453378141,296
5698da5541a9d72100240759,67202,MRK3480 Forbrukeratferd,1453381489,2016-01-21 14:04:49,1453381880,391
5698da5541a9d72100240759,1925,MRK3480 Forbrukeratferd,1453933295,2016-01-27 23:21:35,1453933317,22
5698da5541a9d72100240759,54770,MRK3480 Forbrukeratferd,1453979062,2016-01-28 12:04:22,1453979883,821
5698da5541a9d72100240759,81079,MRK3480 Forbrukeratferd,1453986361,2016-01-28 14:06:01,1453986410,49
5698da5541a9d72100240759,16585,MRK3480 Forbrukeratferd,1453988468,2016-01-28 14:41:08,1453988468,0
5698da5541a9d72100240759,34092,MRK3480 Forbrukeratferd,1454435610,2016-02-02 18:53:30,1454435621,11
5698da5541a9d72100240759,81150,MRK3480 Forbrukeratferd,1454526552,2016-02-03 20:09:12,1454526559,7
5698da5541a9d72100240759,729,MRK3480 Forbrukeratferd,1454528321,2016-02-03 20:38:41,1454529213,892
5698da5541a9d72100240759,43628,MRK3480 Forbrukeratferd,1455127140,2016-02-10 18:59:00,1455127405,265
5698da5541a9d72100240759,28158,MRK3480 Forbrukeratferd,1455323543,2016-02-13 01:32:23,1455323544,1
5698da5541a9d7210024075a,4100,MRK3480 Forbrukeratferd,1453270235,2016-01-20 07:10:35,1453270335,100
5698da5541a9d7210024075a,53997,MRK3480 Forbrukeratferd,1453292184,2016-01-20 13:16:24,1453292513,329
5698da5541a9d7210024075a,50143,MRK3480 Forbrukeratferd,1453296600,2016-01-20 14:30:00,1453296601,1
5698da5541a9d7210024075a,94245,MRK3480 Forbrukeratferd,1453309330,2016-01-20 18:02:10,1453309330,0
5698da5541a9d7210024075a,61816,MRK3480 Forbrukeratferd,1453315989,2016-01-20 19:53:09,1453315989,0
5698da5541a9d7210024075a,88152,MRK3480 Forbrukeratferd,1453327574,2016-01-20 23:06:14,1453329629,2055
5698da5541a9d7210024075a,1769,MRK3480 Forbrukeratferd,1453375510,2016-01-21 12:25:10,1453377698,2188
5698da5541a9d7210024075a,64518,MRK3480 Forbrukeratferd,1453397005,2016-01-21 18:23:25,1453397005,0
5698da5541a9d7210024075a,58079,MRK3480 Forbrukeratferd,1453422721,2016-01-22 01:32:01,1453422721,0
5698da5541a9d7210024075a,73540,MRK3480 Forbrukeratferd,1453495030,2016-01-22 21:37:10,1453495030,0
5698da5541a9d7210024075a,34540,MRK3480 Forbrukeratferd,1453589042,2016-01-23 23:44:02,1453589048,6
5698da5541a9d7210024075a,96046,MRK3480 Forbrukeratferd,1453917886,2016-01-27 19:04:46,1453918517,631
5698da5541a9d7210024075a,2515,MRK3480 Forbrukeratferd,1453979197,2016-01-28 12:06:37,1453980036,839
5698da5541a9d7210024075a,22567,MRK3480 Forbrukeratferd,1454256509,2016-01-31 17:08:29,1454256509,0
5698da5541a9d7210024075a,62993,MRK3480 Forbrukeratferd,1454607602,2016-02-04 18:40:02,1454607627,25
5698da5541a9d7210024075a,90450,MRK3480 Forbrukeratferd,1454677365,2016-02-05 14:02:45,1454677366,1
5698da5541a9d7210024075a,49489,MRK3480 Forbrukeratferd,1454684955,2016-02-05 16:09:15,1454686545,1590
5698da5541a9d7210024075a,93880,MRK3480 Forbrukeratferd,1455274989,2016-02-12 12:03:09,1455274995,6
5698da5541a9d7210024075a,4111,MRK3480 Forbrukeratferd,1455276987,2016-02-12 12:36:27,1455277031,44
5698da5541a9d7210024075d,7388,MRK3480 Forbrukeratferd,1453375007,2016-01-21 12:16:47,1453375039,32
5698da5541a9d7210024075d,53395,MRK3480 Forbrukeratferd,1453376858,2016-01-21 12:47:38,1453377686,828
5698da5541a9d7210024075d,69293,MRK3480 Forbrukeratferd,1455275024,2016-02-12 12:03:44,1455275081,57
5698da5541a9d7210024075e,54900,MRK3480 Forbrukeratferd,1454609459,2016-02-04 19:10:59,1454610115,656
5698da5541a9d7210024075e,11370,MRK3480 Forbrukeratferd,1455122171,2016-02-10 17:36:11,1455122476,305
5698da5541a9d7210024075e,5820,MRK3480 Forbrukeratferd,1455274997,2016-02-12 12:03:17,1455275041,44
5698da5541a9d7210024075e,81914,MRK3480 Forbrukeratferd,1455279940,2016-02-12 13:25:40,1455279999,59
5698da562fb0de2600f22a4a,27648,MRK3480 Forbrukeratferd,1453120677,2016-01-18 13:37:57,1453120770,93
5698da562fb0de2600f22a4a,69057,MRK3480 Forbrukeratferd,1453123414,2016-01-18 14:23:34,1453123797,383
5698da562fb0de2600f22a4a,79977,MRK3480 Forbrukeratferd,1453288239,2016-01-20 12:10:39,1453288502,263
5698da562fb0de2600f22a4a,16004,MRK3480 Forbrukeratferd,1453301679,2016-01-20 15:54:39,1453301760,81
5698da562fb0de2600f22a4a,74705,MRK3480 Forbrukeratferd,1453321102,2016-01-20 21:18:22,1453322336,1234
5698da562fb0de2600f22a4a,58441,MRK3480 Forbrukeratferd,1453373668,2016-01-21 11:54:28,1453373668,0
5698da562fb0de2600f22a4a,54710,MRK3480 Forbrukeratferd,1453474997,2016-01-22 16:03:17,1453474998,1
5698da562fb0de2600f22a4a,30473,MRK3480 Forbrukeratferd,1453808165,2016-01-26 12:36:05,1453808438,273
5698da562fb0de2600f22a4a,63696,MRK3480 Forbrukeratferd,1453809732,2016-01-26 13:02:12,1453810900,1168
5698da562fb0de2600f22a4a,47859,MRK3480 Forbrukeratferd,1453813897,2016-01-26 14:11:37,1453813927,30
5698da562fb0de2600f22a4a,37013,MRK3480 Forbrukeratferd,1453877619,2016-01-27 07:53:39,1453877630,11
5698da562fb0de2600f22a4a,3225,MRK3480 Forbrukeratferd,1453892111,2016-01-27 11:55:11,1453892112,1
5698da562fb0de2600f22a4a,23456,MRK3480 Forbrukeratferd,1453977325,2016-01-28 11:35:25,1453977396,71
5698da562fb0de2600f22a4a,22886,MRK3480 Forbrukeratferd,1453979055,2016-01-28 12:04:15,1453979073,18
5698da562fb0de2600f22a4a,78286,MRK3480 Forbrukeratferd,1454059191,2016-01-29 10:19:51,1454059191,0
5698da562fb0de2600f22a4a,53493,MRK3480 Forbrukeratferd,1454270512,2016-01-31 21:01:52,1454270514,2
5698da562fb0de2600f22a4a,67492,MRK3480 Forbrukeratferd,1454327342,2016-02-01 12:49:02,1454327360,18
5698da562fb0de2600f22a4a,58011,MRK3480 Forbrukeratferd,1454584252,2016-02-04 12:10:52,1454584343,91
5698da562fb0de2600f22a4a,83773,MRK3480 Forbrukeratferd,1454590124,2016-02-04 13:48:44,1454590124,0
5698da562fb0de2600f22a4a,2262,MRK3480 Forbrukeratferd,1454614998,2016-02-04 20:43:18,1454614999,1
5698da562fb0de2600f22a4a,48863,MRK3480 Forbrukeratferd,1454672225,2016-02-05 12:37:05,1454672272,47
5698da562fb0de2600f22a4a,75675,MRK3480 Forbrukeratferd,1455105617,2016-02-10 13:00:17,1455105618,1
5698da562fb0de2600f22a4a,42151,MRK3480 Forbrukeratferd,1455268352,2016-02-12 10:12:32,1455269485,1133
5698da562fb0de2600f22a4a,14827,MRK3480 Forbrukeratferd,1455275035,2016-02-12 12:03:55,1455275047,12
5698da562fb0de2600f22a4a,16656,MRK3480 Forbrukeratferd,1455282348,2016-02-12 14:05:48,1455282350,2
5698da562fb0de2600f22a4b,55375,MRK3480 Forbrukeratferd,1453236350,2016-01-19 21:45:50,1453236436,86
5698da562fb0de2600f22a4b,68410,MRK3480 Forbrukeratferd,1453674012,2016-01-24 23:20:12,1453674765,753
5698da562fb0de2600f22a4b,87067,MRK3480 Forbrukeratferd,1455052846,2016-02-09 22:20:46,1455052933,87
5698da562fb0de2600f22a50,46829,MRK3480 Forbrukeratferd,1453058757,2016-01-17 20:25:57,1453058854,97
5698da562fb0de2600f22a50,15963,nan,1453116799,2016-01-18 12:33:19,1453117608,809
5698da562fb0de2600f22a50,21287,MRK3480 Forbrukeratferd,1453147142,2016-01-18 20:59:02,1453147290,148
5698da562fb0de2600f22a50,20141,MRK3480 Forbrukeratferd,1453374325,2016-01-21 12:05:25,1453374367,42
5698da562fb0de2600f22a50,121,MRK3480 Forbrukeratferd,1453377674,2016-01-21 13:01:14,1453378572,898
5698da562fb0de2600f22a50,59714,MRK3480 Forbrukeratferd,1453719930,2016-01-25 12:05:30,1453719939,9
5698da562fb0de2600f22a50,8899,MRK3480 Forbrukeratferd,1453751759,2016-01-25 20:55:59,1453751760,1
5698da562fb0de2600f22a50,17185,MRK3480 Forbrukeratferd,1453978884,2016-01-28 12:01:24,1453980170,1286
5698da562fb0de2600f22a50,95907,MRK3480 Forbrukeratferd,1453983951,2016-01-28 13:25:51,1453983951,0
5698da562fb0de2600f22a50,77443,MRK3480 Forbrukeratferd,1454000743,2016-01-28 18:05:43,1454000743,0
5698da562fb0de2600f22a50,44126,MRK3480 Forbrukeratferd,1455281454,2016-02-12 13:50:54,1455281576,122
5698da5641a9d7210024076b,3661,MRK3480 Forbrukeratferd,1453219451,2016-01-19 17:04:11,1453219533,82
5698da5641a9d7210024076b,96628,MRK3480 Forbrukeratferd,1453220994,2016-01-19 17:29:54,1453221908,914
5698da5641a9d7210024076b,343,MRK3480 Forbrukeratferd,1453307220,2016-01-20 17:27:00,1453307271,51
5698da5641a9d7210024076b,87870,MRK3480 Forbrukeratferd,1453391592,2016-01-21 16:53:12,1453391685,93
5698da5641a9d7210024076b,54169,MRK3480 Forbrukeratferd,1453933263,2016-01-27 23:21:03,1453933342,79
5698da572fb0de2600f22a52,89934,MRK3480 Forbrukeratferd,1453066980,2016-01-17 22:43:00,1453066983,3
5698da572fb0de2600f22a52,80322,MRK3480 Forbrukeratferd,1453371596,2016-01-21 11:19:56,1453371713,117
5698da572fb0de2600f22a52,68703,MRK3480 Forbrukeratferd,1453808173,2016-01-26 12:36:13,1453808223,50
5698da572fb0de2600f22a52,23484,MRK3480 Forbrukeratferd,1453972541,2016-01-28 10:15:41,1453977349,4808
5698da572fb0de2600f22a52,3143,MRK3480 Forbrukeratferd,1454317892,2016-02-01 10:11:32,1454317892,0
5698da572fb0de2600f22a52,36601,ORG3402 Organisasjonsatferd og ledelse,1454419793,2016-02-02 14:29:53,1454422490,2697
5698da572fb0de2600f22a52,68876,MRK3480 Forbrukeratferd,1454495853,2016-02-03 11:37:33,1454495889,36
5698da572fb0de2600f22a52,2354,ORG3402 Organisasjonsatferd og ledelse,1454517581,2016-02-03 17:39:41,1454517644,63
5698da572fb0de2600f22a52,82647,ORG3402 Organisasjonsatferd og ledelse,1454596595,2016-02-04 15:36:35,1454597076,481
5698da572fb0de2600f22a52,16637,MRK3480 Forbrukeratferd,1454605627,2016-02-04 18:07:07,1454605644,17
5698da572fb0de2600f22a52,22021,ORG3402 Organisasjonsatferd og ledelse,1455024967,2016-02-09 14:36:07,1455025053,86
5698da572fb0de2600f22a52,56766,MRK3480 Forbrukeratferd,1455116175,2016-02-10 15:56:15,1455116282,107
5698da572fb0de2600f22a52,62793,MRK3480 Forbrukeratferd,1455268639,2016-02-12 10:17:19,1455269169,530
5698da582fb0de2600f22a6b,43316,MRK3480 Forbrukeratferd,1452864666,2016-01-15 14:31:06,1452864751,85
5698da582fb0de2600f22a6b,76820,MRK3480 Forbrukeratferd,1453121476,2016-01-18 13:51:16,1453121476,0
5698da5841a9d72100240776,57780,MRK3480 Forbrukeratferd,1453365943,2016-01-21 09:45:43,1453366169,226
5698da5841a9d72100240776,95777,MRK3480 Forbrukeratferd,1453389607,2016-01-21 16:20:07,1453389694,87
5698da5841a9d72100240776,92007,MRK3480 Forbrukeratferd,1453820553,2016-01-26 16:02:33,1453820583,30
5698da5841a9d72100240776,91731,MRK3480 Forbrukeratferd,1453821815,2016-01-26 16:23:35,1453821832,17
5698da5841a9d72100240776,45078,MRK3480 Forbrukeratferd,1453922072,2016-01-27 20:14:32,1453922262,190
5698da5841a9d72100240776,65120,MRK3480 Forbrukeratferd,1454160496,2016-01-30 14:28:16,1454160508,12
5698da5841a9d72100240776,27882,MRK3480 Forbrukeratferd,1454436730,2016-02-02 19:12:10,1454436852,122
5698da5841a9d72100240776,22347,MRK3480 Forbrukeratferd,1454440092,2016-02-02 20:08:12,1454440097,5
5698da5841a9d72100240776,8998,MRK3480 Forbrukeratferd,1455012282,2016-02-09 11:04:42,1455012803,521
5698da5841a9d72100240776,5746,MRK3480 Forbrukeratferd,1455026058,2016-02-09 14:54:18,1455026059,1
5698da5841a9d72100240776,44021,MRK3480 Forbrukeratferd,1455112091,2016-02-10 14:48:11,1455112092,1
5698da5841a9d72100240776,26046,MRK3480 Forbrukeratferd,1455127160,2016-02-10 18:59:20,1455127160,0
5698da5841a9d72100240776,43901,MRK3480 Forbrukeratferd,1455389419,2016-02-13 19:50:19,1455391072,1653
5698da5841a9d72100240777,79334,MRK3480 Forbrukeratferd,1452863834,2016-01-15 14:17:14,1452863866,32
5698da5841a9d72100240777,71491,MRK3480 Forbrukeratferd,1453242921,2016-01-19 23:35:21,1453243060,139
5698da5841a9d72100240777,65620,MRK3480 Forbrukeratferd,1454704128,2016-02-05 21:28:48,1454704601,473
5698da5841a9d72100240778,93386,MRK3480 Forbrukeratferd,1452884855,2016-01-15 20:07:35,1452885348,493
5698da5841a9d72100240778,47158,MRK3480 Forbrukeratferd,1453320040,2016-01-20 21:00:40,1453320044,4
5698da5841a9d72100240778,10996,MRK3480 Forbrukeratferd,1453822819,2016-01-26 16:40:19,1453822819,0
5698da5841a9d72100240778,26488,MRK3480 Forbrukeratferd,1453832713,2016-01-26 19:25:13,1453832713,0
5698da5841a9d72100240778,82714,MRK3480 Forbrukeratferd,1453984491,2016-01-28 13:34:51,1453984559,68
5698da5841a9d72100240778,65445,MRK3480 Forbrukeratferd,1454514609,2016-02-03 16:50:09,1454514610,1
5698da5841a9d72100240778,14603,MRK3480 Forbrukeratferd,1455035741,2016-02-09 17:35:41,1455036811,1070
5698da5841a9d72100240779,14257,MRK3480 Forbrukeratferd,1453306724,2016-01-20 17:18:44,1453307423,699
5698da5841a9d72100240779,58838,MRK3480 Forbrukeratferd,1453312426,2016-01-20 18:53:46,1453312433,7
5698da5841a9d72100240779,75732,MRK3480 Forbrukeratferd,1453376092,2016-01-21 12:34:52,1453376102,10
5698da5841a9d72100240779,69543,MRK3480 Forbrukeratferd,1453418222,2016-01-22 00:17:02,1453418816,594
5698da5841a9d72100240779,16069,MRK3480 Forbrukeratferd,1453420945,2016-01-22 01:02:25,1453420945,0
5698da5841a9d72100240779,78927,MRK3480 Forbrukeratferd,1453758741,2016-01-25 22:52:21,1453758785,44
5698da5841a9d72100240779,32035,MRK3480 Forbrukeratferd,1453982414,2016-01-28 13:00:14,1453982448,34
5698da5841a9d72100240779,42984,MRK3480 Forbrukeratferd,1453991268,2016-01-28 15:27:48,1453992781,1513
5698da5841a9d72100240779,35600,MRK3480 Forbrukeratferd,1454264117,2016-01-31 19:15:17,1454264307,190
5698da5841a9d72100240779,27277,MRK3480 Forbrukeratferd,1454858299,2016-02-07 16:18:19,1454858549,250
5698da5841a9d72100240779,95286,MRK3480 Forbrukeratferd,1455275927,2016-02-12 12:18:47,1455275950,23
5698da5841a9d72100240779,63100,MRK3480 Forbrukeratferd,1455282597,2016-02-12 14:09:57,1455282664,67
5698da592fb0de2600f22a6d,27496,MRK3480 Forbrukeratferd,1453298306,2016-01-20 14:58:26,1453299905,1599
5698da592fb0de2600f22a6d,97597,MRK3480 Forbrukeratferd,1453374222,2016-01-21 12:03:42,1453374223,1
5698da592fb0de2600f22a6d,57342,MRK3480 Forbrukeratferd,1453747124,2016-01-25 19:38:44,1453747124,0
5698da592fb0de2600f22a6d,90662,MRK3480 Forbrukeratferd,1453857366,2016-01-27 02:16:06,1453857367,1
5698da592fb0de2600f22a6d,15730,MRK3480 Forbrukeratferd,1453888326,2016-01-27 10:52:06,1453888326,0
5698da592fb0de2600f22a6d,22991,MRK3480 Forbrukeratferd,1453924164,2016-01-27 20:49:24,1453924193,29
5698da592fb0de2600f22a6d,83572,MRK3480 Forbrukeratferd,1453975664,2016-01-28 11:07:44,1453975664,0
5698da592fb0de2600f22a6d,88099,MRK3480 Forbrukeratferd,1453997866,2016-01-28 17:17:46,1453997936,70
5698da592fb0de2600f22a6d,8544,MRK3480 Forbrukeratferd,1454008110,2016-01-28 20:08:30,1454008111,1
5698da592fb0de2600f22a6d,14461,MRK3480 Forbrukeratferd,1454118339,2016-01-30 02:45:39,1454118340,1
5698da592fb0de2600f22a70,38947,MRK3480 Forbrukeratferd,1452876045,2016-01-15 17:40:45,1452876045,0
5698da592fb0de2600f22a70,18155,MRK3480 Forbrukeratferd,1453290374,2016-01-20 12:46:14,1453290486,112
5698da592fb0de2600f22a70,33555,MRK3480 Forbrukeratferd,1453499218,2016-01-22 22:46:58,1453499218,0
5698da592fb0de2600f22a70,4163,MRK3480 Forbrukeratferd,1455289529,2016-02-12 16:05:29,1455289598,69
5698da5941a9d7210024077b,85245,MRK3480 Forbrukeratferd,1452861613,2016-01-15 13:40:13,1452861614,1
5698da5941a9d7210024077b,51937,MRK3480 Forbrukeratferd,1453913286,2016-01-27 17:48:06,1453913290,4
5698da5941a9d7210024077b,30979,MRK3480 Forbrukeratferd,1453917195,2016-01-27 18:53:15,1453917197,2
5698da5941a9d7210024077c,60739,MRK3480 Forbrukeratferd,1453374333,2016-01-21 12:05:33,1453374430,97
5698da5941a9d7210024077c,43470,MRK3480 Forbrukeratferd,1453377978,2016-01-21 13:06:18,1453379325,1347
5698da5941a9d7210024077c,37287,MRK3480 Forbrukeratferd,1454368425,2016-02-02 00:13:45,1454368563,138
5698da5941a9d7210024077c,35194,MRK3480 Forbrukeratferd,1454971609,2016-02-08 23:46:49,1454971618,9
5698da5941a9d7210024077c,9643,MRK3480 Forbrukeratferd,1455213234,2016-02-11 18:53:54,1455213875,641
5698da5941a9d7210024077c,95598,MRK3480 Forbrukeratferd,1455281434,2016-02-12 13:50:34,1455281871,437
5698da5941a9d7210024077c,4218,MRK3480 Forbrukeratferd,1455397433,2016-02-13 22:03:53,1455397433,0
5698da5941a9d7210024078d,90413,MRK3480 Forbrukeratferd,1453122627,2016-01-18 14:10:27,1453122842,215
5698da5941a9d7210024078d,14557,MRK3480 Forbrukeratferd,1453343324,2016-01-21 03:28:44,1453343414,90
5698da5941a9d7210024078d,91531,MRK3480 Forbrukeratferd,1453819479,2016-01-26 15:44:39,1453819510,31
5698da5941a9d7210024078d,58956,MRK3480 Forbrukeratferd,1454269534,2016-01-31 20:45:34,1454270238,704
5698da5a2fb0de2600f22a71,45554,MRK3480 Forbrukeratferd,1453117850,2016-01-18 12:50:50,1453118509,659
5698da5a2fb0de2600f22a72,78920,MRK3480 Forbrukeratferd,1453193298,2016-01-19 09:48:18,1453193299,1
5698da5a2fb0de2600f22a72,28283,MRK3480 Forbrukeratferd,1453375590,2016-01-21 12:26:30,1453375610,20
5698da5a2fb0de2600f22a72,5353,MRK3480 Forbrukeratferd,1453377577,2016-01-21 12:59:37,1453377578,1
5698da5a2fb0de2600f22a72,10961,MRK3480 Forbrukeratferd,1453851139,2016-01-27 00:32:19,1453851311,172
5698da5a2fb0de2600f22a72,25196,MRK3480 Forbrukeratferd,1453988240,2016-01-28 14:37:20,1453988286,46
5698da5a2fb0de2600f22a74,87004,MRK3480 Forbrukeratferd,1454581209,2016-02-04 11:20:09,1454581328,119
5698da5a2fb0de2600f22a74,39791,MRK3480 Forbrukeratferd,1454583086,2016-02-04 11:51:26,1454583088,2
5698da5a2fb0de2600f22a78,84010,MRK3480 Forbrukeratferd,1453287687,2016-01-20 12:01:27,1453287837,150
5698da5a2fb0de2600f22a78,33222,MRK3480 Forbrukeratferd,1453892458,2016-01-27 12:00:58,1453893033,575
5698da5a2fb0de2600f22a78,82889,MRK3480 Forbrukeratferd,1453900994,2016-01-27 14:23:14,1453900994,0
5698da5a2fb0de2600f22a78,51679,MRK3480 Forbrukeratferd,1453905766,2016-01-27 15:42:46,1453905766,0
5698da5a2fb0de2600f22a78,317,MRK3480 Forbrukeratferd,1454243325,2016-01-31 13:28:45,1454243347,22
5698da5a2fb0de2600f22a78,53514,MRK3480 Forbrukeratferd,1454497459,2016-02-03 12:04:19,1454497467,8
5698da5a2fb0de2600f22a78,72884,MRK3480 Forbrukeratferd,1454523806,2016-02-03 19:23:26,1454523811,5
5698da5a2fb0de2600f22a78,11229,MRK3480 Forbrukeratferd,1454706315,2016-02-05 22:05:15,1454706391,76
5698da5a2fb0de2600f22a78,93841,MRK3480 Forbrukeratferd,1455363268,2016-02-13 12:34:28,1455363282,14
5698da5a2fb0de2600f22a7a,67547,ORG3402 Organisasjonsatferd og ledelse,1453110121,2016-01-18 10:42:01,1453110449,328
5698da5a2fb0de2600f22a7a,85489,MRK3480 Forbrukeratferd,1453141862,2016-01-18 19:31:02,1453142392,530
5698da5a2fb0de2600f22a7a,15695,MRK3480 Forbrukeratferd,1453321336,2016-01-20 21:22:16,1453321967,631
5698da5a2fb0de2600f22a7a,76512,ORG3402 Organisasjonsatferd og ledelse,1453643498,2016-01-24 14:51:38,1453643543,45
5698da5a2fb0de2600f22a7a,63430,MRK3480 Forbrukeratferd,1453801560,2016-01-26 10:46:00,1453803241,1681
5698da5a2fb0de2600f22a7a,91713,ORG3402 Organisasjonsatferd og ledelse,1454668889,2016-02-05 11:41:29,1454669203,314
5698da5a2fb0de2600f22a7a,75201,MRK3480 Forbrukeratferd,1454844542,2016-02-07 12:29:02,1454845164,622
5698da5a2fb0de2600f22a7a,6164,ORG3402 Organisasjonsatferd og ledelse,1454954069,2016-02-08 18:54:29,1454954456,387
5698da5a2fb0de2600f22a7a,37292,MRK3480 Forbrukeratferd,1455104930,2016-02-10 12:48:50,1455104951,21
5698da5b2fb0de2600f22a88,34733,MRK3480 Forbrukeratferd,1452861974,2016-01-15 13:46:14,1452862005,31
5698da5b2fb0de2600f22a88,48133,MRK3480 Forbrukeratferd,1452878469,2016-01-15 18:21:09,1452878503,34
5698da5b2fb0de2600f22a88,91618,MRK3480 Forbrukeratferd,1452987213,2016-01-17 00:33:33,1452987247,34
5698da5b2fb0de2600f22a88,94100,MRK3480 Forbrukeratferd,1453313754,2016-01-20 19:15:54,1453313845,91
5698da5b2fb0de2600f22a88,20108,MRK3480 Forbrukeratferd,1453319073,2016-01-20 20:44:33,1453319107,34
5698da5b2fb0de2600f22a88,15176,MRK3480 Forbrukeratferd,1453843128,2016-01-26 22:18:48,1453843140,12
5698da5b2fb0de2600f22a88,73987,MRK3480 Forbrukeratferd,1453902218,2016-01-27 14:43:38,1453902267,49
5698da5b2fb0de2600f22a88,52138,MRK3480 Forbrukeratferd,1453991279,2016-01-28 15:27:59,1453993297,2018
5698da5b2fb0de2600f22a88,2361,MRK3480 Forbrukeratferd,1454587840,2016-02-04 13:10:40,1454587841,1
5698da5b2fb0de2600f22a88,12287,MRK3480 Forbrukeratferd,1454591090,2016-02-04 14:04:50,1454591577,487
5698da5b2fb0de2600f22a88,69869,MRK3480 Forbrukeratferd,1454616412,2016-02-04 21:06:52,1454616465,53
5698da5b2fb0de2600f22a88,56761,MRK3480 Forbrukeratferd,1455229764,2016-02-11 23:29:24,1455230174,410
5698da5b2fb0de2600f22a88,11745,MRK3480 Forbrukeratferd,1455274757,2016-02-12 11:59:17,1455274771,14
5698da5b41a9d7210024079f,96535,MRK3480 Forbrukeratferd,1453822807,2016-01-26 16:40:07,1453823600,793
5698da5b41a9d7210024079f,63493,MRK3480 Forbrukeratferd,1453995001,2016-01-28 16:30:01,1453995080,79
5698da5b41a9d7210024079f,85059,MRK3480 Forbrukeratferd,1454879857,2016-02-07 22:17:37,1454879975,118
5698da5b41a9d721002407a0,79153,MRK3480 Forbrukeratferd,1453058643,2016-01-17 20:24:03,1453059743,1100
5698da5b41a9d721002407a0,45271,MRK3480 Forbrukeratferd,1453307902,2016-01-20 17:38:22,1453309889,1987
5698da5b41a9d721002407a0,48332,MRK3480 Forbrukeratferd,1453907655,2016-01-27 16:14:15,1453907718,63
5698da5b41a9d721002407a1,5251,MRK3480 Forbrukeratferd,1453811950,2016-01-26 13:39:10,1453812791,841
5698da5b41a9d721002407a1,3125,MRK3480 Forbrukeratferd,1454505541,2016-02-03 14:19:01,1454505550,9
5698da5b41a9d721002407a1,31716,MRK3480 Forbrukeratferd,1454507792,2016-02-03 14:56:32,1454507795,3
5698da5b41a9d721002407a1,44546,MRK3480 Forbrukeratferd,1454582520,2016-02-04 11:42:00,1454582540,20
5698da5c2fb0de2600f22a96,90389,MRK3480 Forbrukeratferd,1454497643,2016-02-03 12:07:23,1454498499,856
5698da5c2fb0de2600f22a97,26495,MRK3480 Forbrukeratferd,1453724214,2016-01-25 13:16:54,1453724237,23
5698da5c2fb0de2600f22a97,1570,MRK3480 Forbrukeratferd,1453918623,2016-01-27 19:17:03,1453918624,1
5698da5c41a9d721002407a3,72778,MRK3480 Forbrukeratferd,1453122682,2016-01-18 14:11:22,1453122960,278
5698da5c41a9d721002407a3,15165,MRK3480 Forbrukeratferd,1453682118,2016-01-25 01:35:18,1453682190,72
5698da5c41a9d721002407a3,54646,MRK3480 Forbrukeratferd,1455140972,2016-02-10 22:49:32,1455141013,41
5698da5c41a9d721002407a3,92075,MRK3480 Forbrukeratferd,1455275060,2016-02-12 12:04:20,1455275130,70
5698da5c41a9d721002407a3,89627,MRK3480 Forbrukeratferd,1455282345,2016-02-12 14:05:45,1455282367,22
5698da5c41a9d721002407a6,78882,MRK3480 Forbrukeratferd,1453221388,2016-01-19 17:36:28,1453221560,172
5698da5c41a9d721002407a6,94791,MRK3480 Forbrukeratferd,1454614839,2016-02-04 20:40:39,1454614840,1
5698da5c41a9d721002407a6,95730,MRK3480 Forbrukeratferd,1454617224,2016-02-04 21:20:24,1454617330,106
5698da5c41a9d721002407a6,30207,MRK3480 Forbrukeratferd,1455214888,2016-02-11 19:21:28,1455214931,43
5698da5c41a9d721002407a6,32234,MRK3480 Forbrukeratferd,1455226150,2016-02-11 22:29:10,1455226150,0
5698da5c41a9d721002407a7,37930,MRK3480 Forbrukeratferd,1453136809,2016-01-18 18:06:49,1453136883,74
5698da5c41a9d721002407a7,58037,MRK3480 Forbrukeratferd,1453145273,2016-01-18 20:27:53,1453145290,17
5698da5c41a9d721002407a7,52573,MRK3480 Forbrukeratferd,1453147078,2016-01-18 20:57:58,1453147360,282
5698da5c41a9d721002407a7,95126,MRK3480 Forbrukeratferd,1453155836,2016-01-18 23:23:56,1453155836,0
5698da5c41a9d721002407a7,28953,MRK3480 Forbrukeratferd,1453211447,2016-01-19 14:50:47,1453211465,18
5698da5c41a9d721002407a7,13674,MRK3480 Forbrukeratferd,1453811147,2016-01-26 13:25:47,1453811179,32
5698da5c41a9d721002407a7,66567,MRK3480 Forbrukeratferd,1453814254,2016-01-26 14:17:34,1453814390,136
5698da5c41a9d721002407a7,98341,MRK3480 Forbrukeratferd,1453983133,2016-01-28 13:12:13,1453983153,20
5698da5c41a9d721002407a7,74031,MRK3480 Forbrukeratferd,1454062583,2016-01-29 11:16:23,1454062648,65
5698da5c41a9d721002407a7,65681,MRK3480 Forbrukeratferd,1454063978,2016-01-29 11:39:38,1454063981,3
5698da5c41a9d721002407a7,14582,MRK3480 Forbrukeratferd,1454671317,2016-02-05 12:21:57,1454671524,207
5698da5c41a9d721002407a7,30809,MRK3480 Forbrukeratferd,1454679357,2016-02-05 14:35:57,1454679443,86
5698da5c41a9d721002407a7,61782,MRK3480 Forbrukeratferd,1455275020,2016-02-12 12:03:40,1455275473,453
5698da5d2fb0de2600f22a9c,44603,MRK3480 Forbrukeratferd,1453301309,2016-01-20 15:48:29,1453303058,1749
5698da5d2fb0de2600f22a9c,27517,MRK3480 Forbrukeratferd,1453847934,2016-01-26 23:38:54,1453848020,86
5698da5d2fb0de2600f22a9c,45708,MRK3480 Forbrukeratferd,1453849259,2016-01-27 00:00:59,1453849303,44
5698da5d2fb0de2600f22a9c,16287,MRK3480 Forbrukeratferd,1453850718,2016-01-27 00:25:18,1453850719,1
5698da5d2fb0de2600f22a9c,77002,MRK3480 Forbrukeratferd,1453905920,2016-01-27 15:45:20,1453905937,17
5698da5d2fb0de2600f22a9c,50843,MRK3480 Forbrukeratferd,1454247253,2016-01-31 14:34:13,1454247365,112
5698da5d2fb0de2600f22a9c,20080,MRK3480 Forbrukeratferd,1454330509,2016-02-01 13:41:49,1454330865,356
5698da5d2fb0de2600f22a9c,18855,MRK3480 Forbrukeratferd,1455061087,2016-02-10 00:38:07,1455061140,53
5698da5d2fb0de2600f22a9c,69905,MRK3480 Forbrukeratferd,1455450306,2016-02-14 12:45:06,1455450736,430
5698da5d2fb0de2600f22a9e,20101,MRK3480 Forbrukeratferd,1452861764,2016-01-15 13:42:44,1452861884,120
5698da5d2fb0de2600f22a9e,96354,MRK3480 Forbrukeratferd,1452878386,2016-01-15 18:19:46,1452878444,58
5698da5d2fb0de2600f22a9e,75291,MRK3480 Forbrukeratferd,1452902006,2016-01-16 00:53:26,1452902059,53
5698da5d2fb0de2600f22a9e,4642,MRK3480 Forbrukeratferd,1453037893,2016-01-17 14:38:13,1453037897,4
5698da5d2fb0de2600f22a9e,21223,MRK3480 Forbrukeratferd,1453040923,2016-01-17 15:28:43,1453041514,591
5698da5d2fb0de2600f22a9e,62797,MRK3480 Forbrukeratferd,1453125621,2016-01-18 15:00:21,1453125650,29
5698da5d2fb0de2600f22a9e,4906,MRK3480 Forbrukeratferd,1453132809,2016-01-18 17:00:09,1453132810,1
5698da5d2fb0de2600f22a9e,49848,MRK3480 Forbrukeratferd,1453161445,2016-01-19 00:57:25,1453161540,95
5698da5d2fb0de2600f22a9e,41038,MRK3480 Forbrukeratferd,1453251460,2016-01-20 01:57:40,1453251546,86
5698da5d2fb0de2600f22a9e,71087,MRK3480 Forbrukeratferd,1453292826,2016-01-20 13:27:06,1453292826,0
5698da5d2fb0de2600f22a9e,38792,MRK3480 Forbrukeratferd,1453324911,2016-01-20 22:21:51,1453324949,38
5698da5d2fb0de2600f22a9e,98241,MRK3480 Forbrukeratferd,1453371512,2016-01-21 11:18:32,1453371529,17
5698da5d2fb0de2600f22a9e,60526,MRK3480 Forbrukeratferd,1453373735,2016-01-21 11:55:35,1453373735,0
5698da5d2fb0de2600f22a9e,49060,MRK3480 Forbrukeratferd,1453722456,2016-01-25 12:47:36,1453722507,51
5698da5d2fb0de2600f22a9e,30905,MRK3480 Forbrukeratferd,1453724809,2016-01-25 13:26:49,1453724811,2
5698da5d2fb0de2600f22a9e,63544,MRK3480 Forbrukeratferd,1453813912,2016-01-26 14:11:52,1453813913,1
5698da5d2fb0de2600f22a9e,38194,MRK3480 Forbrukeratferd,1453819337,2016-01-26 15:42:17,1453819338,1
5698da5d2fb0de2600f22a9e,99104,MRK3480 Forbrukeratferd,1453845238,2016-01-26 22:53:58,1453845256,18
5698da5d2fb0de2600f22a9e,44664,MRK3480 Forbrukeratferd,1453891597,2016-01-27 11:46:37,1453891597,0
5698da5d2fb0de2600f22a9e,38546,MRK3480 Forbrukeratferd,1453913158,2016-01-27 17:45:58,1453913159,1
5698da5d2fb0de2600f22a9e,14840,MRK3480 Forbrukeratferd,1454024298,2016-01-29 00:38:18,1454024661,363
5698da5d2fb0de2600f22a9e,76876,MRK3480 Forbrukeratferd,1454601509,2016-02-04 16:58:29,1454601515,6
5698da5d2fb0de2600f22a9e,31102,MRK3480 Forbrukeratferd,1454667617,2016-02-05 11:20:17,1454667617,0
5698da5d2fb0de2600f22a9e,11059,MRK3480 Forbrukeratferd,1454948196,2016-02-08 17:16:36,1454948213,17
5698da5d2fb0de2600f22a9e,43090,MRK3480 Forbrukeratferd,1455057253,2016-02-09 23:34:13,1455057253,0
5698da5d2fb0de2600f22a9e,26490,MRK3480 Forbrukeratferd,1455202252,2016-02-11 15:50:52,1455202270,18
5698da5d2fb0de2600f22a9e,49509,MRK3480 Forbrukeratferd,1455275030,2016-02-12 12:03:50,1455275033,3
5698da5d2fb0de2600f22a9e,98243,MRK3480 Forbrukeratferd,1455463385,2016-02-14 16:23:05,1455463444,59
5698da5d41a9d721002407b8,13648,MRK3480 Forbrukeratferd,1453732003,2016-01-25 15:26:43,1453732083,80
5698da5d41a9d721002407b8,91131,MRK3480 Forbrukeratferd,1453814734,2016-01-26 14:25:34,1453816020,1286
5698da5d41a9d721002407b8,88544,MRK3480 Forbrukeratferd,1453817454,2016-01-26 15:10:54,1453817804,350
5698da5d41a9d721002407b8,2810,MRK3480 Forbrukeratferd,1455275557,2016-02-12 12:12:37,1455275686,129
5698da5e2fb0de2600f22aa2,7091,MRK3480 Forbrukeratferd,1453197480,2016-01-19 10:58:00,1453197861,381
5698da5e2fb0de2600f22aa2,6827,MRK3480 Forbrukeratferd,1453364601,2016-01-21 09:23:21,1453365114,513
5698da5e2fb0de2600f22aa2,55168,MRK3480 Forbrukeratferd,1453374134,2016-01-21 12:02:14,1453374405,271
5698da5e2fb0de2600f22aa2,85291,MRK3480 Forbrukeratferd,1453378039,2016-01-21 13:07:19,1453379014,975
5698da5e2fb0de2600f22aa2,29114,MRK3480 Forbrukeratferd,1453382379,2016-01-21 14:19:39,1453382381,2
5698da5e2fb0de2600f22aa2,16275,MRK3480 Forbrukeratferd,1453560851,2016-01-23 15:54:11,1453560851,0
5698da5e2fb0de2600f22aa2,22608,MRK3480 Forbrukeratferd,1454411880,2016-02-02 12:18:00,1454411885,5
5698da5e2fb0de2600f22aa2,8463,MRK3480 Forbrukeratferd,1455275010,2016-02-12 12:03:30,1455275010,0
5698da5e2fb0de2600f22aa2,24194,MRK3480 Forbrukeratferd,1455276499,2016-02-12 12:28:19,1455276499,0
5698da5e2fb0de2600f22aa3,58015,MRK3480 Forbrukeratferd,1453045902,2016-01-17 16:51:42,1453046158,256
5698da5e2fb0de2600f22aa3,29147,MRK3480 Forbrukeratferd,1453308858,2016-01-20 17:54:18,1453309215,357
5698da5e2fb0de2600f22aa3,94252,MRK3480 Forbrukeratferd,1453377490,2016-01-21 12:58:10,1453378013,523
5698da5e2fb0de2600f22aa3,65657,MRK3480 Forbrukeratferd,1453382548,2016-01-21 14:22:28,1453382559,11
5698da5e2fb0de2600f22aa3,8822,MRK3480 Forbrukeratferd,1453385159,2016-01-21 15:05:59,1453385176,17
5698da5e2fb0de2600f22aa3,33984,MRK3480 Forbrukeratferd,1453388212,2016-01-21 15:56:52,1453389446,1234
5698da5e2fb0de2600f22aa3,73048,MRK3480 Forbrukeratferd,1453391803,2016-01-21 16:56:43,1453391817,14
5698da5e2fb0de2600f22aa3,42503,MRK3480 Forbrukeratferd,1453721527,2016-01-25 12:32:07,1453721568,41
5698da5e2fb0de2600f22aa3,61851,MRK3480 Forbrukeratferd,1453724220,2016-01-25 13:17:00,1453724231,11
5698da5e2fb0de2600f22aa3,80258,MRK3480 Forbrukeratferd,1453816256,2016-01-26 14:50:56,1453816331,75
5698da5e2fb0de2600f22aa3,48029,MRK3480 Forbrukeratferd,1453892678,2016-01-27 12:04:38,1453892687,9
5698da5e2fb0de2600f22aa3,54772,MRK3480 Forbrukeratferd,1453919339,2016-01-27 19:28:59,1453919340,1
5698da5e2fb0de2600f22aa3,54827,MRK3480 Forbrukeratferd,1453983547,2016-01-28 13:19:07,1453983554,7
5698da5e2fb0de2600f22aa3,5234,MRK3480 Forbrukeratferd,1453987354,2016-01-28 14:22:34,1453987358,4
5698da5e2fb0de2600f22aa3,60335,MRK3480 Forbrukeratferd,1455275498,2016-02-12 12:11:38,1455275518,20
5698da5e2fb0de2600f22ab6,92071,MRK3480 Forbrukeratferd,1453213828,2016-01-19 15:30:28,1453213840,12
5698da5e2fb0de2600f22ab6,40548,MRK3480 Forbrukeratferd,1453675606,2016-01-24 23:46:46,1453675627,21
5698da5e2fb0de2600f22ab6,5257,MRK3480 Forbrukeratferd,1453713373,2016-01-25 10:16:13,1453713435,62
5698da5e2fb0de2600f22ab6,71297,MRK3480 Forbrukeratferd,1453805515,2016-01-26 11:51:55,1453805536,21
5698da5e2fb0de2600f22ab6,58348,MRK3480 Forbrukeratferd,1453813190,2016-01-26 13:59:50,1453813191,1
5698da5e2fb0de2600f22ab6,28433,MRK3480 Forbrukeratferd,1453911036,2016-01-27 17:10:36,1453911060,24
5698da5e2fb0de2600f22ab6,64885,MRK3480 Forbrukeratferd,1454752503,2016-02-06 10:55:03,1454752539,36
5698da5e41a9d721002407cb,99463,MRK3480 Forbrukeratferd,1452925700,2016-01-16 07:28:20,1452925777,77
5698da5e41a9d721002407cb,19216,MRK3480 Forbrukeratferd,1453066237,2016-01-17 22:30:37,1453066238,1
5698da5e41a9d721002407cb,81743,MRK3480 Forbrukeratferd,1453376924,2016-01-21 12:48:44,1453377130,206
5698da5e41a9d721002407cb,97910,MRK3480 Forbrukeratferd,1453405214,2016-01-21 20:40:14,1453405262,48
5698da5e41a9d721002407cb,48207,MRK3480 Forbrukeratferd,1453820239,2016-01-26 15:57:19,1453820259,20
5698da5e41a9d721002407cb,98721,MRK3480 Forbrukeratferd,1453826382,2016-01-26 17:39:42,1453826813,431
5698da5e41a9d721002407cb,85085,MRK3480 Forbrukeratferd,1453836115,2016-01-26 20:21:55,1453836126,11
5698da5e41a9d721002407cb,21645,MRK3480 Forbrukeratferd,1453902654,2016-01-27 14:50:54,1453902663,9
5698da5e41a9d721002407cb,7482,MRK3480 Forbrukeratferd,1453919237,2016-01-27 19:27:17,1453919242,5
5698da5e41a9d721002407cb,13360,MRK3480 Forbrukeratferd,1453979021,2016-01-28 12:03:41,1453979541,520
5698da5e41a9d721002407cb,21986,MRK3480 Forbrukeratferd,1453981489,2016-01-28 12:44:49,1453981493,4
5698da5e41a9d721002407cb,37920,MRK3480 Forbrukeratferd,1454360469,2016-02-01 22:01:09,1454360469,0
5698da5e41a9d721002407cb,18358,MRK3480 Forbrukeratferd,1455105164,2016-02-10 12:52:44,1455105167,3
5698da5e41a9d721002407cb,54205,MRK3480 Forbrukeratferd,1455276228,2016-02-12 12:23:48,1455276247,19
5698da5f2fb0de2600f22ac2,34651,MRK3480 Forbrukeratferd,1453289057,2016-01-20 12:24:17,1453289143,86
5698da5f2fb0de2600f22ac2,6754,MRK3480 Forbrukeratferd,1453309823,2016-01-20 18:10:23,1453310296,473
5698da5f2fb0de2600f22ac2,70887,MRK3480 Forbrukeratferd,1453323119,2016-01-20 21:51:59,1453323120,1
5698da5f2fb0de2600f22ac2,56500,MRK3480 Forbrukeratferd,1453329060,2016-01-20 23:31:00,1453329128,68
5698da5f2fb0de2600f22ac2,26479,MRK3480 Forbrukeratferd,1453373686,2016-01-21 11:54:46,1453373945,259
5698da5f2fb0de2600f22ac2,2524,MRK3480 Forbrukeratferd,1453377464,2016-01-21 12:57:44,1453377594,130
5698da5f2fb0de2600f22ac2,5160,MRK3480 Forbrukeratferd,1453731995,2016-01-25 15:26:35,1453732032,37
5698da5f2fb0de2600f22ac2,86351,MRK3480 Forbrukeratferd,1453822360,2016-01-26 16:32:40,1453822365,5
5698da5f2fb0de2600f22ac2,7516,MRK3480 Forbrukeratferd,1453978985,2016-01-28 12:03:05,1453979027,42
5698da5f2fb0de2600f22ac2,43489,MRK3480 Forbrukeratferd,1453982402,2016-01-28 13:00:02,1453982404,2
5698da5f2fb0de2600f22ac2,35578,MRK3480 Forbrukeratferd,1454504431,2016-02-03 14:00:31,1454504431,0
5698da5f41a9d721002407cd,4429,MRK3480 Forbrukeratferd,1453138676,2016-01-18 18:37:56,1453138780,104
5698da5f41a9d721002407cd,34836,MRK3480 Forbrukeratferd,1453816288,2016-01-26 14:51:28,1453816929,641
5698da5f41a9d721002407cd,90645,MRK3480 Forbrukeratferd,1453820923,2016-01-26 16:08:43,1453820934,11
5698da5f41a9d721002407cd,67676,MRK3480 Forbrukeratferd,1453906262,2016-01-27 15:51:02,1453906403,141
5698da5f41a9d721002407cd,98736,MRK3480 Forbrukeratferd,1453914800,2016-01-27 18:13:20,1453914818,18
5698da5f41a9d721002407cd,67162,MRK3480 Forbrukeratferd,1454591369,2016-02-04 14:09:29,1454591582,213
5698da5f41a9d721002407cd,32827,MRK3480 Forbrukeratferd,1454602124,2016-02-04 17:08:44,1454602135,11
5698da5f41a9d721002407cd,28926,MRK3480 Forbrukeratferd,1455019997,2016-02-09 13:13:17,1455020046,49
5698da5f41a9d721002407cd,78321,MRK3480 Forbrukeratferd,1455026001,2016-02-09 14:53:21,1455026228,227
5698da5f41a9d721002407ce,5677,MRK3480 Forbrukeratferd,1453743788,2016-01-25 18:43:08,1453743813,25
5698da5f41a9d721002407d0,65026,MRK3480 Forbrukeratferd,1453753257,2016-01-25 21:20:57,1453753783,526
5698da5f41a9d721002407d0,35597,MRK3480 Forbrukeratferd,1453758148,2016-01-25 22:42:28,1453758158,10
5698da5f41a9d721002407d0,60087,MRK3480 Forbrukeratferd,1453936840,2016-01-28 00:20:40,1453936887,47
5698da5f41a9d721002407d1,86788,MRK3480 Forbrukeratferd,1453904900,2016-01-27 15:28:20,1453905050,150
5698da602fb0de2600f22ac4,44616,MRK3480 Forbrukeratferd,1452865525,2016-01-15 14:45:25,1452865699,174
5698da602fb0de2600f22ac4,433,MRK3480 Forbrukeratferd,1452872767,2016-01-15 16:46:07,1452872767,0
5698da602fb0de2600f22ac4,63594,MRK3480 Forbrukeratferd,1452906219,2016-01-16 02:03:39,1452906261,42
5698da602fb0de2600f22ac4,8833,MRK3480 Forbrukeratferd,1453121090,2016-01-18 13:44:50,1453121214,124
5698da602fb0de2600f22ac4,73805,MRK3480 Forbrukeratferd,1453321709,2016-01-20 21:28:29,1453322341,632
5698da602fb0de2600f22ac4,871,MRK3480 Forbrukeratferd,1453377740,2016-01-21 13:02:20,1453378531,791
5698da602fb0de2600f22ac4,75714,MRK3480 Forbrukeratferd,1453388187,2016-01-21 15:56:27,1453388188,1
5698da602fb0de2600f22ac4,69921,MRK3480 Forbrukeratferd,1453457731,2016-01-22 11:15:31,1453457735,4
5698da602fb0de2600f22ac4,95706,MRK3480 Forbrukeratferd,1453675574,2016-01-24 23:46:14,1453675575,1
5698da602fb0de2600f22ac4,16601,MRK3480 Forbrukeratferd,1453681289,2016-01-25 01:21:29,1453681291,2
5698da602fb0de2600f22ac4,35048,MRK3480 Forbrukeratferd,1453717549,2016-01-25 11:25:49,1453717620,71
5698da602fb0de2600f22ac4,42537,MRK3480 Forbrukeratferd,1453726620,2016-01-25 13:57:00,1453726655,35
5698da602fb0de2600f22ac4,6599,MRK3480 Forbrukeratferd,1453804998,2016-01-26 11:43:18,1453805011,13
5698da602fb0de2600f22ac4,56526,MRK3480 Forbrukeratferd,1453913078,2016-01-27 17:44:38,1453913198,120
5698da602fb0de2600f22ac4,51499,MRK3480 Forbrukeratferd,1454001128,2016-01-28 18:12:08,1454001128,0
5698da602fb0de2600f22ac4,69001,MRK3480 Forbrukeratferd,1454164517,2016-01-30 15:35:17,1454164518,1
5698da602fb0de2600f22ac4,89489,MRK3480 Forbrukeratferd,1454357049,2016-02-01 21:04:09,1454357049,0
5698da602fb0de2600f22ac4,64945,MRK3480 Forbrukeratferd,1454503353,2016-02-03 13:42:33,1454503353,0
5698da602fb0de2600f22ac4,81519,MRK3480 Forbrukeratferd,1454935093,2016-02-08 13:38:13,1454935379,286
5698da602fb0de2600f22ac4,50639,MRK3480 Forbrukeratferd,1455016879,2016-02-09 12:21:19,1455016879,0
5698da602fb0de2600f22ac4,64326,MRK3480 Forbrukeratferd,1455129843,2016-02-10 19:44:03,1455130763,920
5698da602fb0de2600f22ac4,39119,MRK3480 Forbrukeratferd,1455142892,2016-02-10 23:21:32,1455142892,0
5698da602fb0de2600f22ac4,72332,MRK3480 Forbrukeratferd,1455217200,2016-02-11 20:00:00,1455217219,19
5698da602fb0de2600f22ac4,4318,MRK3480 Forbrukeratferd,1455272870,2016-02-12 11:27:50,1455272870,0
5698da602fb0de2600f22ac4,35896,MRK3480 Forbrukeratferd,1455286459,2016-02-12 15:14:19,1455286459,0
5698da602fb0de2600f22ac4,12532,MRK3480 Forbrukeratferd,1455301009,2016-02-12 19:16:49,1455301022,13
5698da602fb0de2600f22ac5,77905,MRK3480 Forbrukeratferd,1452867113,2016-01-15 15:11:53,1452867149,36
5698da602fb0de2600f22ac5,98288,MRK3480 Forbrukeratferd,1452873090,2016-01-15 16:51:30,1452873123,33
5698da602fb0de2600f22ac5,52236,MRK3480 Forbrukeratferd,1453723799,2016-01-25 13:09:59,1453723801,2
5698da602fb0de2600f22ac5,92353,MRK3480 Forbrukeratferd,1453733772,2016-01-25 15:56:12,1453733828,56
5698da602fb0de2600f22ac5,54868,MRK3480 Forbrukeratferd,1453805063,2016-01-26 11:44:23,1453805064,1
5698da602fb0de2600f22ac5,7273,MRK3480 Forbrukeratferd,1453920361,2016-01-27 19:46:01,1453920363,2
5698da602fb0de2600f22ac5,24423,MRK3480 Forbrukeratferd,1453927352,2016-01-27 21:42:32,1453927420,68
5698da602fb0de2600f22ac5,91766,MRK3480 Forbrukeratferd,1455161640,2016-02-11 04:34:00,1455161917,277
5698da602fb0de2600f22ac5,69627,MRK3480 Forbrukeratferd,1455219246,2016-02-11 20:34:06,1455219247,1
5698da602fb0de2600f22ac7,33411,MRK3480 Forbrukeratferd,1452869340,2016-01-15 15:49:00,1452869497,157
5698da602fb0de2600f22ac7,2594,MRK3480 Forbrukeratferd,1452871552,2016-01-15 16:25:52,1452871554,2
5698da602fb0de2600f22ac7,81687,MRK3480 Forbrukeratferd,1454606476,2016-02-04 18:21:16,1454606583,107
5698da602fb0de2600f22ac7,80505,MRK3480 Forbrukeratferd,1454626557,2016-02-04 23:55:57,1454626709,152
5698da602fb0de2600f22ac7,74421,MRK3480 Forbrukeratferd,1454856243,2016-02-07 15:44:03,1454857572,1329
5698da602fb0de2600f22ac7,13019,MRK3480 Forbrukeratferd,1454862382,2016-02-07 17:26:22,1454862582,200
5698da602fb0de2600f22ac7,15047,MRK3480 Forbrukeratferd,1454932708,2016-02-08 12:58:28,1454934423,1715
5698da602fb0de2600f22ac7,26579,MRK3480 Forbrukeratferd,1454941090,2016-02-08 15:18:10,1454941090,0
5698da602fb0de2600f22ac7,94466,MRK3480 Forbrukeratferd,1455031590,2016-02-09 16:26:30,1455031597,7
5698da602fb0de2600f22ac9,32132,MRK3480 Forbrukeratferd,1453128397,2016-01-18 15:46:37,1453128693,296
5698da602fb0de2600f22ac9,83919,MRK3480 Forbrukeratferd,1453201406,2016-01-19 12:03:26,1453201462,56
5698da602fb0de2600f22ac9,18150,MRK3480 Forbrukeratferd,1453892414,2016-01-27 12:00:14,1453892542,128
5698da602fb0de2600f22ac9,36745,MRK3480 Forbrukeratferd,1453994690,2016-01-28 16:24:50,1453995203,513
5698da602fb0de2600f22ac9,98062,MRK3480 Forbrukeratferd,1454665051,2016-02-05 10:37:31,1454665079,28
5698da602fb0de2600f22ac9,80712,MRK3480 Forbrukeratferd,1455276347,2016-02-12 12:25:47,1455276354,7
5698da6041a9d721002407d3,98859,MRK3480 Forbrukeratferd,1453216843,2016-01-19 16:20:43,1453216966,123
5698da6041a9d721002407d3,68731,MRK3480 Forbrukeratferd,1453979339,2016-01-28 12:08:59,1453979390,51
5698da6041a9d721002407d3,3374,MRK3480 Forbrukeratferd,1455020030,2016-02-09 13:13:50,1455020136,106
5698da6041a9d721002407e4,37466,MRK3480 Forbrukeratferd,1453378141,2016-01-21 13:09:01,1453379266,1125
5698da6041a9d721002407e4,42429,MRK3480 Forbrukeratferd,1453383112,2016-01-21 14:31:52,1453383116,4
5698da6041a9d721002407e4,16800,MRK3480 Forbrukeratferd,1454499569,2016-02-03 12:39:29,1454499585,16
5698da6041a9d721002407e4,87258,MRK3480 Forbrukeratferd,1454501917,2016-02-03 13:18:37,1454501918,1
5698da6041a9d721002407e4,2483,MRK3480 Forbrukeratferd,1455052875,2016-02-09 22:21:15,1455052985,110
5698da6041a9d721002407e4,64394,MRK3480 Forbrukeratferd,1455366078,2016-02-13 13:21:18,1455366938,860
5698da6041a9d721002407e4,70612,MRK3480 Forbrukeratferd,1455368889,2016-02-13 14:08:09,1455369446,557
5698da6041a9d721002407e4,60869,MRK3480 Forbrukeratferd,1455371317,2016-02-13 14:48:37,1455373701,2384
5698da6041a9d721002407e5,31048,MRK3480 Forbrukeratferd,1453416823,2016-01-21 23:53:43,1453416870,47
5698da6041a9d721002407e5,55531,MRK3480 Forbrukeratferd,1453942673,2016-01-28 01:57:53,1453942737,64
5698da6041a9d721002407e5,59822,MRK3480 Forbrukeratferd,1453945819,2016-01-28 02:50:19,1453945873,54
5698da6041a9d721002407e5,68918,MRK3480 Forbrukeratferd,1453996908,2016-01-28 17:01:48,1453996909,1
5698da6041a9d721002407e5,76436,MRK3480 Forbrukeratferd,1455205543,2016-02-11 16:45:43,1455205543,0
5698da6041a9d721002407e5,97502,MRK3480 Forbrukeratferd,1455225570,2016-02-11 22:19:30,1455225609,39
5698da612fb0de2600f22acb,40211,MRK3480 Forbrukeratferd,1452863142,2016-01-15 14:05:42,1452863142,0
5698da612fb0de2600f22acb,61382,MRK3480 Forbrukeratferd,1452864651,2016-01-15 14:30:51,1452864996,345
5698da612fb0de2600f22acb,26400,MRK3480 Forbrukeratferd,1453191968,2016-01-19 09:26:08,1453192756,788
5698da612fb0de2600f22acb,26416,MRK3480 Forbrukeratferd,1453283073,2016-01-20 10:44:33,1453284166,1093
5698da612fb0de2600f22acb,81207,MRK3480 Forbrukeratferd,1453285537,2016-01-20 11:25:37,1453285941,404
5698da612fb0de2600f22acb,64531,MRK3480 Forbrukeratferd,1453292941,2016-01-20 13:29:01,1453292945,4
5698da612fb0de2600f22acb,29563,MRK3480 Forbrukeratferd,1453374321,2016-01-21 12:05:21,1453374321,0
5698da612fb0de2600f22acb,71657,MRK3480 Forbrukeratferd,1453375778,2016-01-21 12:29:38,1453375783,5
5698da612fb0de2600f22acb,73248,MRK3480 Forbrukeratferd,1453378181,2016-01-21 13:09:41,1453378486,305
5698da612fb0de2600f22acb,44245,MRK3480 Forbrukeratferd,1453815842,2016-01-26 14:44:02,1453815943,101
5698da612fb0de2600f22acb,60874,MRK3480 Forbrukeratferd,1453825397,2016-01-26 17:23:17,1453825417,20
5698da612fb0de2600f22acb,422,MRK3480 Forbrukeratferd,1453908515,2016-01-27 16:28:35,1453908552,37
5698da612fb0de2600f22acb,85495,MRK3480 Forbrukeratferd,1453913578,2016-01-27 17:52:58,1453913610,32
5698da612fb0de2600f22acb,87393,MRK3480 Forbrukeratferd,1453979014,2016-01-28 12:03:34,1453979953,939
5698da612fb0de2600f22acb,94731,MRK3480 Forbrukeratferd,1453986534,2016-01-28 14:08:54,1453986539,5
5698da612fb0de2600f22acb,90847,MRK3480 Forbrukeratferd,1453988531,2016-01-28 14:42:11,1453988531,0
5698da612fb0de2600f22acb,40361,MRK3480 Forbrukeratferd,1454420614,2016-02-02 14:43:34,1454420734,120
5698da612fb0de2600f22acb,49221,MRK3480 Forbrukeratferd,1454670052,2016-02-05 12:00:52,1454670127,75
5698da612fb0de2600f22acb,65640,MRK3480 Forbrukeratferd,1454678790,2016-02-05 14:26:30,1454679408,618
5698da612fb0de2600f22acb,30460,MRK3480 Forbrukeratferd,1455143200,2016-02-10 23:26:40,1455143216,16
5698da612fb0de2600f22acb,35391,MRK3480 Forbrukeratferd,1455271396,2016-02-12 11:03:16,1455272462,1066
5698da612fb0de2600f22acb,86642,MRK3480 Forbrukeratferd,1455281425,2016-02-12 13:50:25,1455281648,223
5698da612fb0de2600f22acb,80195,MRK3480 Forbrukeratferd,1455283320,2016-02-12 14:22:00,1455284369,1049
5698da612fb0de2600f22acd,10446,MRK3480 Forbrukeratferd,1452954974,2016-01-16 15:36:14,1452955524,550
5698da612fb0de2600f22acd,16005,MRK3480 Forbrukeratferd,1452958360,2016-01-16 16:32:40,1452958866,506
5698da612fb0de2600f22acd,52466,MRK3480 Forbrukeratferd,1453119051,2016-01-18 13:10:51,1453119052,1
5698da612fb0de2600f22acd,37774,MRK3480 Forbrukeratferd,1453125477,2016-01-18 14:57:57,1453125506,29
5698da612fb0de2600f22acd,59901,MRK3480 Forbrukeratferd,1453293900,2016-01-20 13:45:00,1453294115,215
5698da612fb0de2600f22acd,45964,MRK3480 Forbrukeratferd,1453326876,2016-01-20 22:54:36,1453326973,97
5698da612fb0de2600f22acd,60386,MRK3480 Forbrukeratferd,1453637220,2016-01-24 13:07:00,1453637221,1
5698da612fb0de2600f22acd,23582,MRK3480 Forbrukeratferd,1453717515,2016-01-25 11:25:15,1453717530,15
5698da612fb0de2600f22acd,39636,MRK3480 Forbrukeratferd,1453978299,2016-01-28 11:51:39,1453978353,54
5698da612fb0de2600f22acd,80507,MRK3480 Forbrukeratferd,1454245950,2016-01-31 14:12:30,1454245950,0
5698da612fb0de2600f22acd,49517,MRK3480 Forbrukeratferd,1454423856,2016-02-02 15:37:36,1454423856,0
5698da612fb0de2600f22acd,45707,MRK3480 Forbrukeratferd,1454429376,2016-02-02 17:09:36,1454429389,13
5698da612fb0de2600f22acd,66920,MRK3480 Forbrukeratferd,1454856877,2016-02-07 15:54:37,1454856878,1
5698da612fb0de2600f22acd,85382,MRK3480 Forbrukeratferd,1454969482,2016-02-08 23:11:22,1454969482,0
5698da612fb0de2600f22acd,50751,MRK3480 Forbrukeratferd,1455266782,2016-02-12 09:46:22,1455266822,40
5698da612fb0de2600f22acd,76607,MRK3480 Forbrukeratferd,1455282364,2016-02-12 14:06:04,1455282458,94
5698da612fb0de2600f22ace,39100,MRK3480 Forbrukeratferd,1453240866,2016-01-19 23:01:06,1453242083,1217
5698da612fb0de2600f22ace,49025,MRK3480 Forbrukeratferd,1453290747,2016-01-20 12:52:27,1453292056,1309
5698da612fb0de2600f22ace,68602,MRK3480 Forbrukeratferd,1453299714,2016-01-20 15:21:54,1453299753,39
5698da612fb0de2600f22ace,63789,MRK3480 Forbrukeratferd,1453405775,2016-01-21 20:49:35,1453405783,8
5698da612fb0de2600f22ace,55465,MRK3480 Forbrukeratferd,1453848862,2016-01-26 23:54:22,1453849071,209
5698da612fb0de2600f22ace,1699,MRK3480 Forbrukeratferd,1454492255,2016-02-03 10:37:35,1454492597,342
5698da612fb0de2600f22ace,70028,MRK3480 Forbrukeratferd,1454619001,2016-02-04 21:50:01,1454619239,238
5698da622fb0de2600f22ae6,41446,MRK3480 Forbrukeratferd,1453139334,2016-01-18 18:48:54,1453143784,4450
5698da622fb0de2600f22ae6,63504,MRK3480 Forbrukeratferd,1453146154,2016-01-18 20:42:34,1453146154,0
5698da622fb0de2600f22ae6,87580,MRK3480 Forbrukeratferd,1453801135,2016-01-26 10:38:55,1453801147,12
5698da622fb0de2600f22ae6,10611,MRK3480 Forbrukeratferd,1453920609,2016-01-27 19:50:09,1453920768,159
5698da622fb0de2600f22ae6,6292,MRK3480 Forbrukeratferd,1454331907,2016-02-01 14:05:07,1454332040,133
5698da622fb0de2600f22ae9,10538,MRK3480 Forbrukeratferd,1453843583,2016-01-26 22:26:23,1453843652,69
5698da6241a9d721002408cb,76662,MRK3480 Forbrukeratferd,1453292787,2016-01-20 13:26:27,1453293028,241
5698da6241a9d721002408cb,96808,MRK3480 Forbrukeratferd,1453808477,2016-01-26 12:41:17,1453809518,1041
5698da6241a9d721002408cb,36415,MRK3480 Forbrukeratferd,1455105025,2016-02-10 12:50:25,1455105092,67
5698da6241a9d721002408cb,19621,MRK3480 Forbrukeratferd,1455112851,2016-02-10 15:00:51,1455112855,4
5698da6241a9d721002408cb,50651,MRK3480 Forbrukeratferd,1455114937,2016-02-10 15:35:37,1455114967,30
5698da6241a9d721002408cc,19448,MRK3480 Forbrukeratferd,1453377075,2016-01-21 12:51:15,1453378361,1286
5698da6241a9d721002408cc,88401,MRK3480 Forbrukeratferd,1453416645,2016-01-21 23:50:45,1453418105,1460
5698da6241a9d721002408cc,41739,MRK3480 Forbrukeratferd,1453861441,2016-01-27 03:24:01,1453862338,897
5698da6241a9d721002408cc,25647,MRK3480 Forbrukeratferd,1455243639,2016-02-12 03:20:39,1455243639,0
5698da6241a9d721002408cc,98751,MRK3480 Forbrukeratferd,1455245403,2016-02-12 03:50:03,1455245403,0
5698da632fb0de2600f22aee,75,MRK3480 Forbrukeratferd,1453374573,2016-01-21 12:09:33,1453374605,32
5698da632fb0de2600f22aee,28930,MRK3480 Forbrukeratferd,1453377483,2016-01-21 12:58:03,1453378382,899
5698da632fb0de2600f22aef,82063,MRK3480 Forbrukeratferd,1455026126,2016-02-09 14:55:26,1455026126,0
5698da632fb0de2600f22aef,70651,MRK3480 Forbrukeratferd,1455110858,2016-02-10 14:27:38,1455110858,0
5698da632fb0de2600f22af0,25444,MRK3480 Forbrukeratferd,1453237784,2016-01-19 22:09:44,1453237822,38
5698da6341a9d721002408cd,27709,MRK3480 Forbrukeratferd,1453668409,2016-01-24 21:46:49,1453668551,142
5698da6341a9d721002408cd,92299,MRK3480 Forbrukeratferd,1453670233,2016-01-24 22:17:13,1453671697,1464
5698da6341a9d721002408cd,4989,MRK3480 Forbrukeratferd,1453724723,2016-01-25 13:25:23,1453724779,56
5698da6341a9d721002408cd,75035,MRK3480 Forbrukeratferd,1453805332,2016-01-26 11:48:52,1453805359,27
5698da6341a9d721002408cd,57380,MRK3480 Forbrukeratferd,1453826889,2016-01-26 17:48:09,1453826889,0
5698da6341a9d721002408cd,21288,MRK3480 Forbrukeratferd,1453829622,2016-01-26 18:33:42,1453829622,0
5698da6341a9d721002408cd,5733,MRK3480 Forbrukeratferd,1453916567,2016-01-27 18:42:47,1453916567,0
5698da6341a9d721002408cd,4456,MRK3480 Forbrukeratferd,1454421929,2016-02-02 15:05:29,1454421947,18
5698da6341a9d721002408cd,10487,MRK3480 Forbrukeratferd,1454594699,2016-02-04 15:04:59,1454594699,0
5698da6341a9d721002408cd,55320,MRK3480 Forbrukeratferd,1454768155,2016-02-06 15:15:55,1454768290,135
5698da6341a9d721002408cd,95423,MRK3480 Forbrukeratferd,1455113206,2016-02-10 15:06:46,1455114080,874
5698da6341a9d721002408cd,65064,MRK3480 Forbrukeratferd,1455477729,2016-02-14 20:22:09,1455477730,1
5698da6341a9d721002408cd,95958,MRK3480 Forbrukeratferd,1455483371,2016-02-14 21:56:11,1455483658,287
5698da6341a9d721002408ce,91835,MRK3480 Forbrukeratferd,1453118244,2016-01-18 12:57:24,1453118523,279
5698da6341a9d721002408ce,86356,MRK3480 Forbrukeratferd,1453721626,2016-01-25 12:33:46,1453722050,424
5698da6341a9d721002408ce,47345,MRK3480 Forbrukeratferd,1453937159,2016-01-28 00:25:59,1453937963,804
5698da6341a9d721002408ce,78855,MRK3480 Forbrukeratferd,1454014864,2016-01-28 22:01:04,1454014867,3
5698da6341a9d721002408cf,90938,MRK3480 Forbrukeratferd,1453376158,2016-01-21 12:35:58,1453376174,16
5698da6341a9d721002408cf,93710,MRK3480 Forbrukeratferd,1453377995,2016-01-21 13:06:35,1453378036,41
5698da6341a9d721002408cf,16612,MRK3480 Forbrukeratferd,1453978814,2016-01-28 12:00:14,1453979188,374
5698da6341a9d721002408cf,21108,MRK3480 Forbrukeratferd,1454499409,2016-02-03 12:36:49,1454499414,5
5698da6341a9d721002408d0,4941,MRK3480 Forbrukeratferd,1452866742,2016-01-15 15:05:42,1452867133,391
5698da6341a9d721002408d0,49707,MRK3480 Forbrukeratferd,1453374513,2016-01-21 12:08:33,1453374651,138
5698da6341a9d721002408d0,80552,MRK3480 Forbrukeratferd,1453376254,2016-01-21 12:37:34,1453376296,42
5698da6341a9d721002408d0,99223,MRK3480 Forbrukeratferd,1453741474,2016-01-25 18:04:34,1453741874,400
5698da6341a9d721002408d0,37623,MRK3480 Forbrukeratferd,1453815998,2016-01-26 14:46:38,1453817095,1097
5698da6341a9d721002408d0,66323,MRK3480 Forbrukeratferd,1454512181,2016-02-03 16:09:41,1454512975,794
5698da6341a9d721002408d0,59932,MRK3480 Forbrukeratferd,1454671113,2016-02-05 12:18:33,1454671434,321
5698da6341a9d721002408d0,1220,MRK3480 Forbrukeratferd,1455101561,2016-02-10 11:52:41,1455101561,0
5698da6341a9d721002408d0,92542,MRK3480 Forbrukeratferd,1455188557,2016-02-11 12:02:37,1455188559,2
5698da6341a9d721002408d0,12680,MRK3480 Forbrukeratferd,1455197369,2016-02-11 14:29:29,1455197543,174
5698da6341a9d721002408d0,73045,MRK3480 Forbrukeratferd,1455200091,2016-02-11 15:14:51,1455200091,0
5698da6341a9d721002408d0,67317,MRK3480 Forbrukeratferd,1455201595,2016-02-11 15:39:55,1455201607,12
5698da6341a9d721002408db,32156,MRK3480 Forbrukeratferd,1452863942,2016-01-15 14:19:02,1452863942,0
5698da6341a9d721002408db,78854,MRK3480 Forbrukeratferd,1452881774,2016-01-15 19:16:14,1452882213,439
5698da6341a9d721002408db,148,MRK3480 Forbrukeratferd,1453222748,2016-01-19 17:59:08,1453222825,77
5698da6341a9d721002408db,97161,MRK3480 Forbrukeratferd,1453374325,2016-01-21 12:05:25,1453374556,231
5698da6341a9d721002408db,14455,MRK3480 Forbrukeratferd,1453377803,2016-01-21 13:03:23,1453378035,232
5698da6341a9d721002408db,12699,MRK3480 Forbrukeratferd,1453483165,2016-01-22 18:19:25,1453483165,0
5698da6341a9d721002408db,91643,MRK3480 Forbrukeratferd,1453652014,2016-01-24 17:13:34,1453652063,49
5698da6341a9d721002408db,26243,MRK3480 Forbrukeratferd,1453677048,2016-01-25 00:10:48,1453677049,1
5698da6341a9d721002408db,61727,MRK3480 Forbrukeratferd,1453752078,2016-01-25 21:01:18,1453752078,0
5698da6341a9d721002408db,26787,MRK3480 Forbrukeratferd,1453753633,2016-01-25 21:27:13,1453754019,386
5698da6341a9d721002408db,81223,MRK3480 Forbrukeratferd,1453757022,2016-01-25 22:23:42,1453757098,76
5698da6341a9d721002408db,12010,MRK3480 Forbrukeratferd,1453892000,2016-01-27 11:53:20,1453892020,20
5698da6341a9d721002408db,9499,MRK3480 Forbrukeratferd,1453978594,2016-01-28 11:56:34,1453978692,98
5698da6341a9d721002408db,56358,MRK3480 Forbrukeratferd,1454362617,2016-02-01 22:36:57,1454362812,195
5698da6341a9d721002408db,62379,MRK3480 Forbrukeratferd,1454436975,2016-02-02 19:16:15,1454436997,22
5698da6341a9d721002408db,14560,MRK3480 Forbrukeratferd,1455274535,2016-02-12 11:55:35,1455275006,471
5698da642fb0de2600f22af5,16821,MRK3480 Forbrukeratferd,1453128896,2016-01-18 15:54:56,1453129069,173
5698da642fb0de2600f22af5,99653,MRK3480 Forbrukeratferd,1453211855,2016-01-19 14:57:35,1453211895,40
5698da642fb0de2600f22af5,11173,MRK3480 Forbrukeratferd,1453218965,2016-01-19 16:56:05,1453218966,1
5698da642fb0de2600f22af5,16407,MRK3480 Forbrukeratferd,1453376167,2016-01-21 12:36:07,1453376181,14
5698da642fb0de2600f22af5,79560,MRK3480 Forbrukeratferd,1453378524,2016-01-21 13:15:24,1453378566,42
5698da642fb0de2600f22af5,30404,MRK3480 Forbrukeratferd,1453675598,2016-01-24 23:46:38,1453675599,1
5698da642fb0de2600f22af5,73267,MRK3480 Forbrukeratferd,1453733905,2016-01-25 15:58:25,1453733979,74
5698da642fb0de2600f22af5,65593,MRK3480 Forbrukeratferd,1453915167,2016-01-27 18:19:27,1453915222,55
5698da642fb0de2600f22af5,15475,MRK3480 Forbrukeratferd,1453934572,2016-01-27 23:42:52,1453934573,1
5698da642fb0de2600f22af5,14679,MRK3480 Forbrukeratferd,1453978978,2016-01-28 12:02:58,1453979918,940
5698da642fb0de2600f22af5,58474,MRK3480 Forbrukeratferd,1453981512,2016-01-28 12:45:12,1453981513,1
5698da642fb0de2600f22af5,80889,MRK3480 Forbrukeratferd,1453990817,2016-01-28 15:20:17,1453990818,1
5698da642fb0de2600f22af5,43102,MRK3480 Forbrukeratferd,1454014452,2016-01-28 21:54:12,1454014464,12
5698da642fb0de2600f22af5,51323,MRK3480 Forbrukeratferd,1454063222,2016-01-29 11:27:02,1454063238,16
5698da642fb0de2600f22af5,97483,MRK3480 Forbrukeratferd,1454669884,2016-02-05 11:58:04,1454669884,0
5698da642fb0de2600f22af7,690,MRK3480 Forbrukeratferd,1454588617,2016-02-04 13:23:37,1454588617,0
5698da642fb0de2600f22afa,83561,MRK3480 Forbrukeratferd,1453316664,2016-01-20 20:04:24,1453316805,141
5698da642fb0de2600f22afa,99372,MRK3480 Forbrukeratferd,1453724520,2016-01-25 13:22:00,1453724525,5
5698da642fb0de2600f22afa,97686,MRK3480 Forbrukeratferd,1453726773,2016-01-25 13:59:33,1453726805,32
5698da642fb0de2600f22afa,21095,MRK3480 Forbrukeratferd,1453815744,2016-01-26 14:42:24,1453815759,15
5698da642fb0de2600f22afa,91782,MRK3480 Forbrukeratferd,1453981134,2016-01-28 12:38:54,1453981185,51
5698da642fb0de2600f22afa,27371,MRK3480 Forbrukeratferd,1453999718,2016-01-28 17:48:38,1453999718,0
5698da642fb0de2600f22afa,19769,MRK3480 Forbrukeratferd,1454108418,2016-01-30 00:00:18,1454108418,0
5698da642fb0de2600f22afa,15698,MRK3480 Forbrukeratferd,1454678714,2016-02-05 14:25:14,1454679273,559
5698da642fb0de2600f22afa,78387,MRK3480 Forbrukeratferd,1455226121,2016-02-11 22:28:41,1455226913,792
5698da6441a9d721002408e0,95937,MRK3480 Forbrukeratferd,1453210382,2016-01-19 14:33:02,1453210410,28
5698da6441a9d721002408e0,46747,MRK3480 Forbrukeratferd,1453211997,2016-01-19 14:59:57,1453212363,366
5698da6441a9d721002408e0,48059,MRK3480 Forbrukeratferd,1453461823,2016-01-22 12:23:43,1453461996,173
5698da6441a9d721002408e0,84014,MRK3480 Forbrukeratferd,1454530573,2016-02-03 21:16:13,1454530760,187
5698da6441a9d721002408e0,55125,MRK3480 Forbrukeratferd,1455119643,2016-02-10 16:54:03,1455120164,521
5698da6441a9d721002408e3,34749,MRK3480 Forbrukeratferd,1454009249,2016-01-28 20:27:29,1454009344,95
5698da6441a9d721002408e3,10121,MRK3480 Forbrukeratferd,1455487671,2016-02-14 23:07:51,1455488747,1076
5698da6441a9d721002408e4,88007,MRK3480 Forbrukeratferd,1453138116,2016-01-18 18:28:36,1453138523,407
5698da6441a9d721002408e4,24886,MRK3480 Forbrukeratferd,1453139856,2016-01-18 18:57:36,1453139883,27
5698da6441a9d721002408e4,37586,MRK3480 Forbrukeratferd,1453208818,2016-01-19 14:06:58,1453208848,30
5698da6441a9d721002408e4,22162,MRK3480 Forbrukeratferd,1453212493,2016-01-19 15:08:13,1453212989,496
5698da6441a9d721002408e4,91970,MRK3480 Forbrukeratferd,1453680126,2016-01-25 01:02:06,1453680701,575
5698da6441a9d721002408e4,93080,MRK3480 Forbrukeratferd,1453720460,2016-01-25 12:14:20,1453720486,26
5698da6441a9d721002408e4,17799,MRK3480 Forbrukeratferd,1453721690,2016-01-25 12:34:50,1453721694,4
5698da6441a9d721002408e4,78657,MRK3480 Forbrukeratferd,1453724471,2016-01-25 13:21:11,1453724522,51
5698da6441a9d721002408e4,23058,MRK3480 Forbrukeratferd,1453936322,2016-01-28 00:12:02,1453936451,129
5698da6441a9d721002408e4,36098,MRK3480 Forbrukeratferd,1453992903,2016-01-28 15:55:03,1453992926,23
5698da6441a9d721002408e4,54976,MRK3480 Forbrukeratferd,1454422606,2016-02-02 15:16:46,1454423108,502
5698da6441a9d721002408e4,35072,MRK3480 Forbrukeratferd,1455111204,2016-02-10 14:33:24,1455111256,52
5698da6441a9d721002408e4,9315,MRK3480 Forbrukeratferd,1455112893,2016-02-10 15:01:33,1455113158,265
5698da652fb0de2600f22b12,82536,MRK3480 Forbrukeratferd,1453374874,2016-01-21 12:14:34,1453374915,41
5698da652fb0de2600f22b12,23761,MRK3480 Forbrukeratferd,1453923425,2016-01-27 20:37:05,1453923470,45
5698da652fb0de2600f22b12,66624,MRK3480 Forbrukeratferd,1453924697,2016-01-27 20:58:17,1453925269,572
5698da6541a9d721002408fa,2956,MRK3480 Forbrukeratferd,1452861968,2016-01-15 13:46:08,1452862102,134
5698da6541a9d721002408fa,81483,MRK3480 Forbrukeratferd,1452865564,2016-01-15 14:46:04,1452865565,1
5698da6541a9d721002408fa,50116,MRK3480 Forbrukeratferd,1453104322,2016-01-18 09:05:22,1453104338,16
5698da6541a9d721002408fa,60556,MRK3480 Forbrukeratferd,1453373774,2016-01-21 11:56:14,1453373796,22
5698da6541a9d721002408fa,95626,MRK3480 Forbrukeratferd,1453384427,2016-01-21 14:53:47,1453384866,439
5698da6541a9d721002408fa,50360,MRK3480 Forbrukeratferd,1453386940,2016-01-21 15:35:40,1453387012,72
5698da6541a9d721002408fa,18905,MRK3480 Forbrukeratferd,1453656692,2016-01-24 18:31:32,1453656748,56
5698da6541a9d721002408fa,39242,MRK3480 Forbrukeratferd,1453727161,2016-01-25 14:06:01,1453727175,14
5698da6541a9d721002408fa,92283,MRK3480 Forbrukeratferd,1453835655,2016-01-26 20:14:15,1453835656,1
5698da6541a9d721002408fa,81311,MRK3480 Forbrukeratferd,1453977009,2016-01-28 11:30:09,1453977285,276
5698da6541a9d721002408fa,84553,MRK3480 Forbrukeratferd,1453978888,2016-01-28 12:01:28,1453978990,102
5698da6541a9d721002408fa,16349,MRK3480 Forbrukeratferd,1454366153,2016-02-01 23:35:53,1454366490,337
5698da6541a9d721002408fa,16551,MRK3480 Forbrukeratferd,1454457352,2016-02-03 00:55:52,1454457352,0
5698da6541a9d721002408fa,63929,MRK3480 Forbrukeratferd,1454670359,2016-02-05 12:05:59,1454670360,1
5698da6541a9d721002408fa,1257,MRK3480 Forbrukeratferd,1454675570,2016-02-05 13:32:50,1454675577,7
5698da6541a9d721002408fa,94076,MRK3480 Forbrukeratferd,1455190332,2016-02-11 12:32:12,1455190336,4
5698da6541a9d721002408fa,28740,MRK3480 Forbrukeratferd,1455274983,2016-02-12 12:03:03,1455275445,462
5698da6541a9d721002408fa,32372,MRK3480 Forbrukeratferd,1455282526,2016-02-12 14:08:46,1455282532,6
5698da662fb0de2600f22b15,70468,MRK3480 Forbrukeratferd,1453038747,2016-01-17 14:52:27,1453039500,753
5698da662fb0de2600f22b15,81673,MRK3480 Forbrukeratferd,1453069890,2016-01-17 23:31:30,1453069899,9
5698da662fb0de2600f22b15,59461,MRK3480 Forbrukeratferd,1453147966,2016-01-18 21:12:46,1453147967,1
5698da662fb0de2600f22b15,98925,MRK3480 Forbrukeratferd,1453157728,2016-01-18 23:55:28,1453159156,1428
5698da662fb0de2600f22b15,95401,MRK3480 Forbrukeratferd,1453645523,2016-01-24 15:25:23,1453645524,1
5698da662fb0de2600f22b15,95379,MRK3480 Forbrukeratferd,1453719655,2016-01-25 12:00:55,1453720286,631
5698da662fb0de2600f22b15,47259,MRK3480 Forbrukeratferd,1453730189,2016-01-25 14:56:29,1453730189,0
5698da662fb0de2600f22b15,24974,MRK3480 Forbrukeratferd,1453752492,2016-01-25 21:08:12,1453752795,303
5698da662fb0de2600f22b15,76801,MRK3480 Forbrukeratferd,1453837249,2016-01-26 20:40:49,1453837310,61
5698da662fb0de2600f22b15,7772,MRK3480 Forbrukeratferd,1453893211,2016-01-27 12:13:31,1453893603,392
5698da662fb0de2600f22b15,29796,MRK3480 Forbrukeratferd,1453895383,2016-01-27 12:49:43,1453896135,752
5698da662fb0de2600f22b15,53400,MRK3480 Forbrukeratferd,1453900782,2016-01-27 14:19:42,1453900787,5
5698da662fb0de2600f22b15,57791,MRK3480 Forbrukeratferd,1453910778,2016-01-27 17:06:18,1453910779,1
5698da662fb0de2600f22b15,20754,MRK3480 Forbrukeratferd,1453934047,2016-01-27 23:34:07,1453934156,109
5698da662fb0de2600f22b15,99292,MRK3480 Forbrukeratferd,1454187441,2016-01-30 21:57:21,1454187557,116
5698da662fb0de2600f22b15,79791,MRK3480 Forbrukeratferd,1454670308,2016-02-05 12:05:08,1454670334,26
5698da662fb0de2600f22b15,54534,MRK3480 Forbrukeratferd,1454671914,2016-02-05 12:31:54,1454671957,43
5698da662fb0de2600f22b15,62455,MRK3480 Forbrukeratferd,1454673224,2016-02-05 12:53:44,1454673224,0
5698da662fb0de2600f22b15,49706,MRK3480 Forbrukeratferd,1454674669,2016-02-05 13:17:49,1454675642,973
5698da662fb0de2600f22b15,76503,MRK3480 Forbrukeratferd,1454679188,2016-02-05 14:33:08,1454679198,10
5698da662fb0de2600f22b15,72504,MRK3480 Forbrukeratferd,1454680719,2016-02-05 14:58:39,1454682758,2039
5698da662fb0de2600f22b15,98165,MRK3480 Forbrukeratferd,1455230847,2016-02-11 23:47:27,1455230853,6
5698da662fb0de2600f22b15,86189,MRK3480 Forbrukeratferd,1455263738,2016-02-12 08:55:38,1455263741,3
5698da662fb0de2600f22b15,31376,MRK3480 Forbrukeratferd,1455273864,2016-02-12 11:44:24,1455274196,332
5698da662fb0de2600f22b15,86775,MRK3480 Forbrukeratferd,1455282114,2016-02-12 14:01:54,1455282481,367
5698da662fb0de2600f22b15,35185,MRK3480 Forbrukeratferd,1455284585,2016-02-12 14:43:05,1455284588,3
5698da662fb0de2600f22b15,19323,MRK3480 Forbrukeratferd,1455312122,2016-02-12 22:22:02,1455312151,29
5698da662fb0de2600f22b19,33070,MRK3480 Forbrukeratferd,1453374555,2016-01-21 12:09:15,1453374555,0
5698da662fb0de2600f22b19,98116,MRK3480 Forbrukeratferd,1453376875,2016-01-21 12:47:55,1453378016,1141
5698da662fb0de2600f22b19,12597,MRK3480 Forbrukeratferd,1453382343,2016-01-21 14:19:03,1453382385,42
5698da662fb0de2600f22b19,34552,MRK3480 Forbrukeratferd,1453729004,2016-01-25 14:36:44,1453729656,652
5698da662fb0de2600f22b19,30066,MRK3480 Forbrukeratferd,1453983616,2016-01-28 13:20:16,1453984319,703
5698da6641a9d721002408fb,49683,MRK3480 Forbrukeratferd,1453287003,2016-01-20 11:50:03,1453287004,1
5698da6641a9d721002408fb,40567,MRK3480 Forbrukeratferd,1453288291,2016-01-20 12:11:31,1453289105,814
5698da6641a9d721002408fb,80192,MRK3480 Forbrukeratferd,1453664712,2016-01-24 20:45:12,1453665334,622
5698da6641a9d721002408fb,96012,MRK3480 Forbrukeratferd,1453677928,2016-01-25 00:25:28,1453677967,39
5698da6641a9d721002408fb,77170,MRK3480 Forbrukeratferd,1453723826,2016-01-25 13:10:26,1453723827,1
5698da6641a9d721002408fb,30974,MRK3480 Forbrukeratferd,1453837754,2016-01-26 20:49:14,1453838080,326
5698da6641a9d721002408fb,18743,MRK3480 Forbrukeratferd,1454076336,2016-01-29 15:05:36,1454076358,22
5698da6641a9d721002408fb,70204,MRK3480 Forbrukeratferd,1454576193,2016-02-04 09:56:33,1454576199,6
5698da6641a9d721002408fb,22149,MRK3480 Forbrukeratferd,1454665272,2016-02-05 10:41:12,1454665299,27
5698da6641a9d721002408fb,21398,MRK3480 Forbrukeratferd,1454669840,2016-02-05 11:57:20,1454670337,497
5698da6641a9d721002408fb,22485,MRK3480 Forbrukeratferd,1455185548,2016-02-11 11:12:28,1455185832,284
5698da6641a9d721002408fb,35070,MRK3480 Forbrukeratferd,1455187750,2016-02-11 11:49:10,1455190517,2767
5698da6641a9d721002408fb,25965,MRK3480 Forbrukeratferd,1455193540,2016-02-11 13:25:40,1455193650,110
5698da6641a9d721002408fb,5397,MRK3480 Forbrukeratferd,1455274420,2016-02-12 11:53:40,1455275763,1343
5698da6641a9d721002408fb,42296,MRK3480 Forbrukeratferd,1455282359,2016-02-12 14:05:59,1455282384,25
5698da6641a9d721002408fb,37695,MRK3480 Forbrukeratferd,1455287217,2016-02-12 15:26:57,1455288253,1036
5698da6641a9d721002408fb,45415,MRK3480 Forbrukeratferd,1455297744,2016-02-12 18:22:24,1455297744,0
5698da6641a9d721002408fc,63419,MRK3480 Forbrukeratferd,1452864384,2016-01-15 14:26:24,1452864415,31
5698da6641a9d721002408fc,41976,MRK3480 Forbrukeratferd,1453721737,2016-01-25 12:35:37,1453721820,83
5698da6641a9d721002408fc,139,MRK3480 Forbrukeratferd,1453818766,2016-01-26 15:32:46,1453819938,1172
5698da6641a9d721002408fc,44186,MRK3480 Forbrukeratferd,1454692373,2016-02-05 18:12:53,1454692389,16
5698da6641a9d721002408fc,77027,MRK3480 Forbrukeratferd,1455109984,2016-02-10 14:13:04,1455110027,43
5698da6641a9d721002408fc,59237,MRK3480 Forbrukeratferd,1455111591,2016-02-10 14:39:51,1455111637,46
5698da6641a9d721002408fc,52741,MRK3480 Forbrukeratferd,1455113286,2016-02-10 15:08:06,1455113791,505
5698da6641a9d721002408fd,56760,MRK3480 Forbrukeratferd,1453375774,2016-01-21 12:29:34,1453375775,1
5698da6641a9d721002408fd,63213,MRK3480 Forbrukeratferd,1453378000,2016-01-21 13:06:40,1453378013,13
5698da6641a9d721002408fd,12264,MRK3480 Forbrukeratferd,1453730984,2016-01-25 15:09:44,1453730996,12
5698da6641a9d721002408fd,21263,MRK3480 Forbrukeratferd,1453892473,2016-01-27 12:01:13,1453892475,2
5698da6641a9d721002408fd,62283,MRK3480 Forbrukeratferd,1453982552,2016-01-28 13:02:32,1453983770,1218
5698da6641a9d721002408fd,80671,MRK3480 Forbrukeratferd,1454493666,2016-02-03 11:01:06,1454494021,355
5698da6641a9d721002408fd,31964,MRK3480 Forbrukeratferd,1454679222,2016-02-05 14:33:42,1454679222,0
5698da6641a9d721002408fe,27763,MRK3480 Forbrukeratferd,1455012073,2016-02-09 11:01:13,1455012073,0
5698da6641a9d721002408fe,68457,MRK3480 Forbrukeratferd,1455017410,2016-02-09 12:30:10,1455017502,92
5698da6641a9d721002408fe,43683,MRK3480 Forbrukeratferd,1455368907,2016-02-13 14:08:27,1455368960,53
5698da672fb0de2600f22b1d,47493,MRK3480 Forbrukeratferd,1452876705,2016-01-15 17:51:45,1452877395,690
5698da672fb0de2600f22b1d,87018,MRK3480 Forbrukeratferd,1453212121,2016-01-19 15:02:01,1453212609,488
5698da672fb0de2600f22b1d,90721,MRK3480 Forbrukeratferd,1453217035,2016-01-19 16:23:55,1453217035,0
5698da672fb0de2600f22b1d,90419,MRK3480 Forbrukeratferd,1453288075,2016-01-20 12:07:55,1453288075,0
5698da672fb0de2600f22b1d,51556,MRK3480 Forbrukeratferd,1453291705,2016-01-20 13:08:25,1453292027,322
5698da672fb0de2600f22b1d,31713,MRK3480 Forbrukeratferd,1454498761,2016-02-03 12:26:01,1454499564,803
5698da672fb0de2600f22b1d,48960,MRK3480 Forbrukeratferd,1454503199,2016-02-03 13:39:59,1454503200,1
5698da672fb0de2600f22b1d,97321,MRK3480 Forbrukeratferd,1454508565,2016-02-03 15:09:25,1454508638,73
5698da672fb0de2600f22b1d,79774,MRK3480 Forbrukeratferd,1454509996,2016-02-03 15:33:16,1454511188,1192
5698da672fb0de2600f22b1d,51559,MRK3480 Forbrukeratferd,1455025492,2016-02-09 14:44:52,1455026873,1381
5698da672fb0de2600f22b1f,47905,MRK3480 Forbrukeratferd,1452862730,2016-01-15 13:58:50,1452862981,251
5698da672fb0de2600f22b1f,70017,MRK3480 Forbrukeratferd,1452864303,2016-01-15 14:25:03,1452864347,44
5698da672fb0de2600f22b1f,79347,MRK3480 Forbrukeratferd,1453045375,2016-01-17 16:42:55,1453045634,259
5698da672fb0de2600f22b1f,30277,MRK3480 Forbrukeratferd,1453375409,2016-01-21 12:23:29,1453375744,335
5698da672fb0de2600f22b1f,77641,MRK3480 Forbrukeratferd,1453822836,2016-01-26 16:40:36,1453824579,1743
5698da672fb0de2600f22b1f,32786,MRK3480 Forbrukeratferd,1454590817,2016-02-04 14:00:17,1454590876,59
5698da672fb0de2600f22b1f,50730,MRK3480 Forbrukeratferd,1454671000,2016-02-05 12:16:40,1454671060,60
5698da672fb0de2600f22b1f,69259,MRK3480 Forbrukeratferd,1454681532,2016-02-05 15:12:12,1454681547,15
5698da672fb0de2600f22b1f,19336,MRK3480 Forbrukeratferd,1455029972,2016-02-09 15:59:32,1455032001,2029
5698da672fb0de2600f22b1f,23686,MRK3480 Forbrukeratferd,1455113481,2016-02-10 15:11:21,1455113696,215
5698da6741a9d72100240900,40618,MRK3480 Forbrukeratferd,1453078445,2016-01-18 01:54:05,1453078696,251
5698da6741a9d72100240900,63865,MRK3480 Forbrukeratferd,1453374734,2016-01-21 12:12:14,1453374751,17
5698da6741a9d72100240900,46445,MRK3480 Forbrukeratferd,1453675885,2016-01-24 23:51:25,1453677776,1891
5698da6741a9d72100240900,42566,MRK3480 Forbrukeratferd,1453979401,2016-01-28 12:10:01,1453979984,583
5698da6741a9d72100240900,41771,MRK3480 Forbrukeratferd,1454448190,2016-02-02 22:23:10,1454448195,5
5698da6741a9d72100240900,39652,MRK3480 Forbrukeratferd,1454671485,2016-02-05 12:24:45,1454671721,236
5698da6741a9d72100240900,18617,MRK3480 Forbrukeratferd,1454676301,2016-02-05 13:45:01,1454676302,1
5698da6741a9d72100240900,56823,MRK3480 Forbrukeratferd,1455224145,2016-02-11 21:55:45,1455224274,129
5698da6741a9d72100240900,11157,MRK3480 Forbrukeratferd,1455275463,2016-02-12 12:11:03,1455275474,11
5698da6741a9d72100240900,66171,MRK3480 Forbrukeratferd,1455278290,2016-02-12 12:58:10,1455278304,14
5698da6741a9d72100240904,65743,MRK3480 Forbrukeratferd,1453039329,2016-01-17 15:02:09,1453039836,507
5698da6741a9d72100240904,11892,MRK3480 Forbrukeratferd,1453120346,2016-01-18 13:32:26,1453120431,85
5698da6741a9d72100240904,53406,MRK3480 Forbrukeratferd,1453208051,2016-01-19 13:54:11,1453208051,0
5698da6741a9d72100240904,47880,MRK3480 Forbrukeratferd,1453209539,2016-01-19 14:18:59,1453209724,185
5698da6741a9d72100240904,74363,MRK3480 Forbrukeratferd,1453388513,2016-01-21 16:01:53,1453389505,992
5698da6741a9d72100240904,43132,MRK3480 Forbrukeratferd,1453805190,2016-01-26 11:46:30,1453805216,26
5698da6741a9d72100240904,95234,MRK3480 Forbrukeratferd,1453810509,2016-01-26 13:15:09,1453810510,1
5698da6741a9d72100240904,24016,MRK3480 Forbrukeratferd,1453835017,2016-01-26 20:03:37,1453835079,62
5698da6741a9d72100240904,60412,MRK3480 Forbrukeratferd,1453904670,2016-01-27 15:24:30,1453904993,323
5698da6741a9d72100240904,59883,MRK3480 Forbrukeratferd,1453911661,2016-01-27 17:21:01,1453911701,40
5698da6741a9d72100240904,34932,MRK3480 Forbrukeratferd,1455220325,2016-02-11 20:52:05,1455220779,454
5698da6741a9d72100240904,85692,MRK3480 Forbrukeratferd,1455289741,2016-02-12 16:09:01,1455290690,949
5698da682fb0de2600f22b24,17776,MRK3480 Forbrukeratferd,1453133580,2016-01-18 17:13:00,1453133640,60
5698da682fb0de2600f22b24,60815,MRK3480 Forbrukeratferd,1453300681,2016-01-20 15:38:01,1453300739,58
5698da682fb0de2600f22b24,4102,MRK3480 Forbrukeratferd,1453375327,2016-01-21 12:22:07,1453375462,135
5698da682fb0de2600f22b24,207,MRK3480 Forbrukeratferd,1453378035,2016-01-21 13:07:15,1453378236,201
5698da682fb0de2600f22b24,52384,MRK3480 Forbrukeratferd,1453748838,2016-01-25 20:07:18,1453748903,65
5698da682fb0de2600f22b24,66979,MRK3480 Forbrukeratferd,1453811168,2016-01-26 13:26:08,1453811173,5
5698da682fb0de2600f22b24,30379,MRK3480 Forbrukeratferd,1453844918,2016-01-26 22:48:38,1453844965,47
5698da682fb0de2600f22b24,28813,MRK3480 Forbrukeratferd,1453906732,2016-01-27 15:58:52,1453906772,40
5698da682fb0de2600f22b24,2418,MRK3480 Forbrukeratferd,1453930135,2016-01-27 22:28:55,1453930179,44
5698da682fb0de2600f22b24,76419,MRK3480 Forbrukeratferd,1453980959,2016-01-28 12:35:59,1453980979,20
5698da682fb0de2600f22b24,93735,MRK3480 Forbrukeratferd,1453986123,2016-01-28 14:02:03,1453986130,7
5698da682fb0de2600f22b24,7982,MRK3480 Forbrukeratferd,1455104440,2016-02-10 12:40:40,1455104441,1
5698da682fb0de2600f22b24,59425,MRK3480 Forbrukeratferd,1455115696,2016-02-10 15:48:16,1455115841,145
5698da682fb0de2600f22b24,12706,MRK3480 Forbrukeratferd,1455375872,2016-02-13 16:04:32,1455375899,27
5698da682fb0de2600f22b24,85606,MRK3480 Forbrukeratferd,1455378291,2016-02-13 16:44:51,1455378316,25
5698da682fb0de2600f22b24,31674,MRK3480 Forbrukeratferd,1455380668,2016-02-13 17:24:28,1455380679,11
5698da682fb0de2600f22b24,95922,MRK3480 Forbrukeratferd,1455382050,2016-02-13 17:47:30,1455382061,11
5698da682fb0de2600f22b25,9191,MRK3480 Forbrukeratferd,1453122848,2016-01-18 14:14:08,1453123388,540
5698da682fb0de2600f22b25,61029,MRK3480 Forbrukeratferd,1453370178,2016-01-21 10:56:18,1453370631,453
5698da682fb0de2600f22b25,62764,MRK3480 Forbrukeratferd,1453376584,2016-01-21 12:43:04,1453377742,1158
5698da682fb0de2600f22b25,67456,MRK3480 Forbrukeratferd,1453638525,2016-01-24 13:28:45,1453638543,18
5698da682fb0de2600f22b25,54284,MRK3480 Forbrukeratferd,1453709113,2016-01-25 09:05:13,1453709120,7
5698da682fb0de2600f22b25,74930,MRK3480 Forbrukeratferd,1453805289,2016-01-26 11:48:09,1453805330,41
5698da682fb0de2600f22b25,2675,MRK3480 Forbrukeratferd,1453993056,2016-01-28 15:57:36,1453993198,142
5698da682fb0de2600f22b25,88531,MRK3480 Forbrukeratferd,1454009904,2016-01-28 20:38:24,1454009904,0
5698da682fb0de2600f22b25,64277,MRK3480 Forbrukeratferd,1454014829,2016-01-28 22:00:29,1454014829,0
5698da682fb0de2600f22b25,49180,MRK3480 Forbrukeratferd,1454063105,2016-01-29 11:25:05,1454063117,12
5698da6841a9d7210024090a,16763,MRK3480 Forbrukeratferd,1453239183,2016-01-19 22:33:03,1453239223,40
5698da6841a9d7210024090a,28879,MRK3480 Forbrukeratferd,1453305448,2016-01-20 16:57:28,1453306097,649
5698da6841a9d7210024090a,41332,MRK3480 Forbrukeratferd,1453315934,2016-01-20 19:52:14,1453317849,1915
5698da6841a9d7210024090a,85171,MRK3480 Forbrukeratferd,1453320021,2016-01-20 21:00:21,1453320218,197
5698da6841a9d7210024090a,3524,MRK3480 Forbrukeratferd,1453366607,2016-01-21 09:56:47,1453366846,239
5698da6841a9d7210024090a,72263,MRK3480 Forbrukeratferd,1453456117,2016-01-22 10:48:37,1453456117,0
5698da6841a9d7210024090a,13623,MRK3480 Forbrukeratferd,1453471086,2016-01-22 14:58:06,1453471086,0
5698da6841a9d7210024090a,82335,MRK3480 Forbrukeratferd,1453676397,2016-01-24 23:59:57,1453676398,1
5698da6841a9d7210024090a,68453,MRK3480 Forbrukeratferd,1453725356,2016-01-25 13:35:56,1453725357,1
5698da6841a9d7210024090a,94376,MRK3480 Forbrukeratferd,1453810930,2016-01-26 13:22:10,1453810951,21
5698da6841a9d7210024090a,70835,MRK3480 Forbrukeratferd,1453912942,2016-01-27 17:42:22,1453912990,48
5698da6841a9d7210024090a,13563,MRK3480 Forbrukeratferd,1454002177,2016-01-28 18:29:37,1454002804,627
5698da6841a9d7210024090a,35582,MRK3480 Forbrukeratferd,1454018408,2016-01-28 23:00:08,1454018498,90
5698da6841a9d7210024090a,61168,MRK3480 Forbrukeratferd,1454068204,2016-01-29 12:50:04,1454068208,4
5698da6841a9d7210024090a,59762,MRK3480 Forbrukeratferd,1454432262,2016-02-02 17:57:42,1454432310,48
5698da6841a9d7210024090a,94719,MRK3480 Forbrukeratferd,1454594953,2016-02-04 15:09:13,1454594953,0
5698da6841a9d7210024090a,86500,MRK3480 Forbrukeratferd,1454667068,2016-02-05 11:11:08,1454667078,10
5698da6841a9d7210024090a,45274,MRK3480 Forbrukeratferd,1454950278,2016-02-08 17:51:18,1454950279,1
5698da6841a9d7210024090a,30756,MRK3480 Forbrukeratferd,1455135117,2016-02-10 21:11:57,1455135179,62
5698da6841a9d7210024090a,27857,MRK3480 Forbrukeratferd,1455274798,2016-02-12 11:59:58,1455275420,622
5698da6841a9d7210024090a,56045,MRK3480 Forbrukeratferd,1455282329,2016-02-12 14:05:29,1455282346,17
5698da6841a9d7210024090a,88148,MRK3480 Forbrukeratferd,1455284600,2016-02-12 14:43:20,1455284602,2
5698da6841a9d7210024090c,23716,MRK3480 Forbrukeratferd,1453049576,2016-01-17 17:52:56,1453049631,55
5698da6841a9d7210024090c,44993,MRK3480 Forbrukeratferd,1453986786,2016-01-28 14:13:06,1453986858,72
5698da6841a9d7210024090c,33590,MRK3480 Forbrukeratferd,1454681648,2016-02-05 15:14:08,1454681703,55
5698da6841a9d7210024090c,85526,MRK3480 Forbrukeratferd,1455138000,2016-02-10 22:00:00,1455138044,44
5698da6841a9d7210024091f,65469,MRK3480 Forbrukeratferd,1453143138,2016-01-18 19:52:18,1453143435,297
5698da6841a9d7210024091f,84036,MRK3480 Forbrukeratferd,1453145740,2016-01-18 20:35:40,1453146671,931
5698da6841a9d7210024091f,55523,MRK3480 Forbrukeratferd,1453492547,2016-01-22 20:55:47,1453492552,5
5698da6841a9d7210024091f,7939,MRK3480 Forbrukeratferd,1453729361,2016-01-25 14:42:41,1453729415,54
5698da6841a9d7210024091f,20612,MRK3480 Forbrukeratferd,1453940686,2016-01-28 01:24:46,1453940933,247
5698da6841a9d7210024091f,59531,MRK3480 Forbrukeratferd,1453994648,2016-01-28 16:24:08,1453994649,1
5698da6841a9d7210024091f,91351,MRK3480 Forbrukeratferd,1454081805,2016-01-29 16:36:45,1454081808,3
5698da6841a9d7210024091f,24668,MRK3480 Forbrukeratferd,1454949224,2016-02-08 17:33:44,1454949225,1
5698da6841a9d7210024091f,85525,MRK3480 Forbrukeratferd,1454951114,2016-02-08 18:05:14,1454951114,0
5698da6841a9d7210024091f,55877,MRK3480 Forbrukeratferd,1454955758,2016-02-08 19:22:38,1454955758,0
5698da692fb0de2600f22b3b,87050,MRK3480 Forbrukeratferd,1453819703,2016-01-26 15:48:23,1453819820,117
5698da692fb0de2600f22b3c,74812,MRK3480 Forbrukeratferd,1453570698,2016-01-23 18:38:18,1453570717,19
5698da692fb0de2600f22b3c,82239,MRK3480 Forbrukeratferd,1454960678,2016-02-08 20:44:38,1454961187,509
5698da692fb0de2600f22b3d,86520,MRK3480 Forbrukeratferd,1453032876,2016-01-17 13:14:36,1453033405,529
5698da692fb0de2600f22b3d,48480,MRK3480 Forbrukeratferd,1453244645,2016-01-20 00:04:05,1453244740,95
5698da692fb0de2600f22b3d,48085,MRK3480 Forbrukeratferd,1453906402,2016-01-27 15:53:22,1453906768,366
5698da692fb0de2600f22b3d,97468,MRK3480 Forbrukeratferd,1454067114,2016-01-29 12:31:54,1454067240,126
5698da692fb0de2600f22b3d,27708,MRK3480 Forbrukeratferd,1454069270,2016-01-29 13:07:50,1454069751,481
5698da692fb0de2600f22b3d,83378,MRK3480 Forbrukeratferd,1454071756,2016-01-29 13:49:16,1454071786,30
5698da692fb0de2600f22b3d,13093,MRK3480 Forbrukeratferd,1454077660,2016-01-29 15:27:40,1454077665,5
5698da692fb0de2600f22b3d,75831,MRK3480 Forbrukeratferd,1454270315,2016-01-31 20:58:35,1454270551,236
5698da692fb0de2600f22b3e,98363,MRK3480 Forbrukeratferd,1453111853,2016-01-18 11:10:53,1453112433,580
5698da692fb0de2600f22b3e,18323,MRK3480 Forbrukeratferd,1453318546,2016-01-20 20:35:46,1453319137,591
5698da692fb0de2600f22b3e,21552,MRK3480 Forbrukeratferd,1453660438,2016-01-24 19:33:58,1453660479,41
5698da692fb0de2600f22b3e,42678,MRK3480 Forbrukeratferd,1453675918,2016-01-24 23:51:58,1453675928,10
5698da692fb0de2600f22b3e,2129,MRK3480 Forbrukeratferd,1453807413,2016-01-26 12:23:33,1453807447,34
5698da692fb0de2600f22b3e,33793,MRK3480 Forbrukeratferd,1453911081,2016-01-27 17:11:21,1453911082,1
5698da692fb0de2600f22b3e,95855,MRK3480 Forbrukeratferd,1454495081,2016-02-03 11:24:41,1454495140,59
5698da692fb0de2600f22b3e,10056,MRK3480 Forbrukeratferd,1454618988,2016-02-04 21:49:48,1454619131,143
5698da692fb0de2600f22b3e,59336,MRK3480 Forbrukeratferd,1454626423,2016-02-04 23:53:43,1454626487,64
5698da692fb0de2600f22b3e,9925,MRK3480 Forbrukeratferd,1454664789,2016-02-05 10:33:09,1454664790,1
5698da6941a9d72100240922,49597,MRK3480 Forbrukeratferd,1453304165,2016-01-20 16:36:05,1453304509,344
5698da6941a9d72100240922,28528,MRK3480 Forbrukeratferd,1453376533,2016-01-21 12:42:13,1453376554,21
5698da6941a9d72100240922,34576,MRK3480 Forbrukeratferd,1453978924,2016-01-28 12:02:04,1453979950,1026
5698da6941a9d72100240922,86966,MRK3480 Forbrukeratferd,1454030177,2016-01-29 02:16:17,1454030188,11
5698da6941a9d72100240922,74905,MRK3480 Forbrukeratferd,1454670946,2016-02-05 12:15:46,1454670955,9
5698da6941a9d72100240922,41600,MRK3480 Forbrukeratferd,1455275028,2016-02-12 12:03:48,1455275051,23
5698da6941a9d72100240922,68682,MRK3480 Forbrukeratferd,1455281466,2016-02-12 13:51:06,1455281484,18
5698da6941a9d72100240923,58366,MRK3480 Forbrukeratferd,1453377283,2016-01-21 12:54:43,1453378168,885
5698da6941a9d72100240923,2352,MRK3480 Forbrukeratferd,1453899983,2016-01-27 14:06:23,1453901888,1905
5698da6941a9d72100240923,44868,MRK3480 Forbrukeratferd,1453904713,2016-01-27 15:25:13,1453904713,0
5698da6941a9d72100240923,22906,MRK3480 Forbrukeratferd,1453907007,2016-01-27 16:03:27,1453907430,423
5698da6941a9d72100240923,36340,MRK3480 Forbrukeratferd,1455144309,2016-02-10 23:45:09,1455144406,97
5698da6941a9d72100240923,409,MRK3480 Forbrukeratferd,1455217474,2016-02-11 20:04:34,1455217850,376
5698da6941a9d72100240923,42539,MRK3480 Forbrukeratferd,1455224552,2016-02-11 22:02:32,1455224553,1
5698da6941a9d72100240924,87365,MRK3480 Forbrukeratferd,1453903090,2016-01-27 14:58:10,1453904949,1859
5698da6941a9d72100240925,2219,MRK3480 Forbrukeratferd,1453741824,2016-01-25 18:10:24,1453741865,41
5698da6941a9d72100240925,97966,MRK3480 Forbrukeratferd,1453810377,2016-01-26 13:12:57,1453810385,8
5698da6941a9d72100240925,97804,MRK3480 Forbrukeratferd,1455105586,2016-02-10 12:59:46,1455105626,40
5698da6a2fb0de2600f22b44,42746,MRK3480 Forbrukeratferd,1453818472,2016-01-26 15:27:52,1453818672,200
5698da6a2fb0de2600f22b44,50094,MRK3480 Forbrukeratferd,1453913377,2016-01-27 17:49:37,1453914077,700
5698da6a2fb0de2600f22b44,34142,MRK3480 Forbrukeratferd,1453915616,2016-01-27 18:26:56,1453915716,100
5698da6a2fb0de2600f22b44,22804,MRK3480 Forbrukeratferd,1453937017,2016-01-28 00:23:37,1453937201,184
5698da6a2fb0de2600f22b45,11558,MRK3480 Forbrukeratferd,1452888239,2016-01-15 21:03:59,1452888306,67
5698da6a2fb0de2600f22b45,16573,MRK3480 Forbrukeratferd,1453131341,2016-01-18 16:35:41,1453131921,580
5698da6a2fb0de2600f22b45,81347,MRK3480 Forbrukeratferd,1453291837,2016-01-20 13:10:37,1453291885,48
5698da6a2fb0de2600f22b45,81881,MRK3480 Forbrukeratferd,1453729800,2016-01-25 14:50:00,1453729858,58
5698da6a2fb0de2600f22b45,14124,MRK3480 Forbrukeratferd,1453886312,2016-01-27 10:18:32,1453886356,44
5698da6a2fb0de2600f22b45,37122,MRK3480 Forbrukeratferd,1453979835,2016-01-28 12:17:15,1453979851,16
5698da6a2fb0de2600f22b45,3533,MRK3480 Forbrukeratferd,1453981065,2016-01-28 12:37:45,1453981068,3
5698da6a2fb0de2600f22b45,26297,MRK3480 Forbrukeratferd,1454332750,2016-02-01 14:19:10,1454332750,0
5698da6a2fb0de2600f22b45,92865,MRK3480 Forbrukeratferd,1454930114,2016-02-08 12:15:14,1454930133,19
5698da6a2fb0de2600f22b45,83125,MRK3480 Forbrukeratferd,1454931692,2016-02-08 12:41:32,1454932571,879
5698da6a2fb0de2600f22b45,52127,MRK3480 Forbrukeratferd,1454934437,2016-02-08 13:27:17,1454934476,39
5698da6a41a9d72100240928,38076,MRK3480 Forbrukeratferd,1453111266,2016-01-18 11:01:06,1453111423,157
5698da6a41a9d72100240928,71073,MRK3480 Forbrukeratferd,1453288666,2016-01-20 12:17:46,1453289033,367
5698da6a41a9d72100240928,50503,MRK3480 Forbrukeratferd,1453716513,2016-01-25 11:08:33,1453716526,13
5698da6a41a9d72100240928,61611,MRK3480 Forbrukeratferd,1453808644,2016-01-26 12:44:04,1453808713,69
5698da6a41a9d72100240928,48443,MRK3480 Forbrukeratferd,1453928263,2016-01-27 21:57:43,1453928352,89
5698da6a41a9d72100240928,82086,MRK3480 Forbrukeratferd,1454531980,2016-02-03 21:39:40,1454532342,362
5698da6a41a9d72100240928,95584,MRK3480 Forbrukeratferd,1454534732,2016-02-03 22:25:32,1454534732,0
5698da6a41a9d72100240928,82313,MRK3480 Forbrukeratferd,1454933131,2016-02-08 13:05:31,1454933151,20
5698da6a41a9d72100240928,58905,MRK3480 Forbrukeratferd,1454936541,2016-02-08 14:02:21,1454936566,25
5698da6a41a9d72100240934,39383,MRK3480 Forbrukeratferd,1453758556,2016-01-25 22:49:16,1453758640,84
5698da6a41a9d72100240934,34131,MRK3480 Forbrukeratferd,1453985813,2016-01-28 13:56:53,1453985879,66
5698da6a41a9d72100240934,72316,MRK3480 Forbrukeratferd,1453987478,2016-01-28 14:24:38,1453987484,6
5698da6a41a9d72100240934,23443,MRK3480 Forbrukeratferd,1454322972,2016-02-01 11:36:12,1454324243,1271
5698da6b2fb0de2600f22b4b,267,MRK3480 Forbrukeratferd,1453127198,2016-01-18 15:26:38,1453127523,325
5698da6b2fb0de2600f22b4b,87388,MRK3480 Forbrukeratferd,1453722567,2016-01-25 12:49:27,1453722603,36
5698da6b2fb0de2600f22b4b,36679,MRK3480 Forbrukeratferd,1453856077,2016-01-27 01:54:37,1453856077,0
5698da6b2fb0de2600f22b4b,23223,MRK3480 Forbrukeratferd,1453950619,2016-01-28 04:10:19,1453950659,40
5698da6b2fb0de2600f22b4b,38909,MRK3480 Forbrukeratferd,1454494046,2016-02-03 11:07:26,1454494098,52
5698da6b2fb0de2600f22b4b,73316,MRK3480 Forbrukeratferd,1454611969,2016-02-04 19:52:49,1454611990,21
5698da6b2fb0de2600f22b4b,63099,MRK3480 Forbrukeratferd,1455057551,2016-02-09 23:39:11,1455057941,390
5698da6b2fb0de2600f22b4b,32309,MRK3480 Forbrukeratferd,1455268337,2016-02-12 10:12:17,1455268338,1
5698da6b2fb0de2600f22b4c,42242,MRK3480 Forbrukeratferd,1453252765,2016-01-20 02:19:25,1453253569,804
5698da6b2fb0de2600f22b4c,81486,MRK3480 Forbrukeratferd,1453336155,2016-01-21 01:29:15,1453336871,716
5698da6b2fb0de2600f22b4c,10133,MRK3480 Forbrukeratferd,1453660843,2016-01-24 19:40:43,1453660872,29
5698da6b2fb0de2600f22b4c,93002,MRK3480 Forbrukeratferd,1453677170,2016-01-25 00:12:50,1453677244,74
5698da6b2fb0de2600f22b4c,52805,MRK3480 Forbrukeratferd,1453919272,2016-01-27 19:27:52,1453919585,313
5698da6b2fb0de2600f22b4c,82618,MRK3480 Forbrukeratferd,1453939280,2016-01-28 01:01:20,1453940964,1684
5698da6b2fb0de2600f22b4c,21689,MRK3480 Forbrukeratferd,1453984526,2016-01-28 13:35:26,1453984787,261
5698da6b2fb0de2600f22b4c,43022,MRK3480 Forbrukeratferd,1453994711,2016-01-28 16:25:11,1453995796,1085
5698da6b2fb0de2600f22b4c,71495,MRK3480 Forbrukeratferd,1454016659,2016-01-28 22:30:59,1454016813,154
5698da6b2fb0de2600f22b4c,14593,MRK3480 Forbrukeratferd,1454019336,2016-01-28 23:15:36,1454019336,0
5698da6b2fb0de2600f22b4c,67491,MRK3480 Forbrukeratferd,1454273483,2016-01-31 21:51:23,1454273483,0
5698da6b2fb0de2600f22b4c,31289,MRK3480 Forbrukeratferd,1454278505,2016-01-31 23:15:05,1454278514,9
5698da6b2fb0de2600f22b4c,18390,MRK3480 Forbrukeratferd,1454623945,2016-02-04 23:12:25,1454624159,214
5698da6b2fb0de2600f22b4c,39745,MRK3480 Forbrukeratferd,1455061932,2016-02-10 00:52:12,1455061987,55
5698da6b2fb0de2600f22b4c,52065,MRK3480 Forbrukeratferd,1455146880,2016-02-11 00:28:00,1455147340,460
5698da6b2fb0de2600f22b4c,21572,MRK3480 Forbrukeratferd,1455466256,2016-02-14 17:10:56,1455466709,453
5698da6b2fb0de2600f22b4c,47036,MRK3480 Forbrukeratferd,1455475349,2016-02-14 19:42:29,1455475746,397
5698da6b2fb0de2600f22b4d,53698,MRK3480 Forbrukeratferd,1452894448,2016-01-15 22:47:28,1452894609,161
5698da6b2fb0de2600f22b4d,43595,MRK3480 Forbrukeratferd,1453145341,2016-01-18 20:29:01,1453145436,95
5698da6b2fb0de2600f22b4d,93580,MRK3480 Forbrukeratferd,1453150757,2016-01-18 21:59:17,1453150847,90
5698da6b2fb0de2600f22b4d,54541,MRK3480 Forbrukeratferd,1453153808,2016-01-18 22:50:08,1453155387,1579
5698da6b2fb0de2600f22b4d,99668,MRK3480 Forbrukeratferd,1453375310,2016-01-21 12:21:50,1453375510,200
5698da6b2fb0de2600f22b4d,5621,MRK3480 Forbrukeratferd,1453377053,2016-01-21 12:50:53,1453377264,211
5698da6b2fb0de2600f22b4d,70320,MRK3480 Forbrukeratferd,1453381704,2016-01-21 14:08:24,1453381704,0
5698da6b2fb0de2600f22b4d,64365,MRK3480 Forbrukeratferd,1453408920,2016-01-21 21:42:00,1453408922,2
5698da6b2fb0de2600f22b4d,42310,MRK3480 Forbrukeratferd,1453675850,2016-01-24 23:50:50,1453675850,0
5698da6b2fb0de2600f22b4d,55652,MRK3480 Forbrukeratferd,1453806028,2016-01-26 12:00:28,1453806029,1
5698da6b2fb0de2600f22b4d,57042,MRK3480 Forbrukeratferd,1453915716,2016-01-27 18:28:36,1453915807,91
5698da6b2fb0de2600f22b4d,23404,MRK3480 Forbrukeratferd,1453983096,2016-01-28 13:11:36,1453983129,33
5698da6b2fb0de2600f22b4d,80768,MRK3480 Forbrukeratferd,1454358259,2016-02-01 21:24:19,1454358417,158
5698da6b2fb0de2600f22b4d,56554,MRK3480 Forbrukeratferd,1454511972,2016-02-03 16:06:12,1454512012,40
5698da6c2fb0de2600f22b62,24253,MRK3480 Forbrukeratferd,1453297823,2016-01-20 14:50:23,1453298306,483
5698da6c2fb0de2600f22b62,99879,MRK3480 Forbrukeratferd,1453301604,2016-01-20 15:53:24,1453301605,1
5698da6c2fb0de2600f22b62,20796,MRK3480 Forbrukeratferd,1453723816,2016-01-25 13:10:16,1453723824,8
5698da6c2fb0de2600f22b62,44068,MRK3480 Forbrukeratferd,1453729270,2016-01-25 14:41:10,1453729620,350
5698da6c2fb0de2600f22b62,99631,MRK3480 Forbrukeratferd,1453732755,2016-01-25 15:39:15,1453732756,1
5698da6c2fb0de2600f22b62,43182,MRK3480 Forbrukeratferd,1453807287,2016-01-26 12:21:27,1453807311,24
5698da6c2fb0de2600f22b62,42753,MRK3480 Forbrukeratferd,1453812839,2016-01-26 13:53:59,1453813538,699
5698da6c2fb0de2600f22b64,96013,MRK3480 Forbrukeratferd,1452959892,2016-01-16 16:58:12,1452959937,45
5698da6c2fb0de2600f22b64,79939,MRK3480 Forbrukeratferd,1452971106,2016-01-16 20:05:06,1452971221,115
5698da6c2fb0de2600f22b64,39360,MRK3480 Forbrukeratferd,1452972431,2016-01-16 20:27:11,1452972518,87
5698da6c2fb0de2600f22b64,87134,MRK3480 Forbrukeratferd,1453067772,2016-01-17 22:56:12,1453067858,86
5698da6c2fb0de2600f22b64,14302,MRK3480 Forbrukeratferd,1453125627,2016-01-18 15:00:27,1453125688,61
5698da6c2fb0de2600f22b64,22866,MRK3480 Forbrukeratferd,1453211066,2016-01-19 14:44:26,1453211067,1
5698da6c2fb0de2600f22b64,2277,MRK3480 Forbrukeratferd,1453243090,2016-01-19 23:38:10,1453243106,16
5698da6c2fb0de2600f22b64,29868,MRK3480 Forbrukeratferd,1453314043,2016-01-20 19:20:43,1453314265,222
5698da6c2fb0de2600f22b64,98960,MRK3480 Forbrukeratferd,1453316047,2016-01-20 19:54:07,1453317205,1158
5698da6c2fb0de2600f22b64,22979,MRK3480 Forbrukeratferd,1453323216,2016-01-20 21:53:36,1453323357,141
5698da6c2fb0de2600f22b64,78767,MRK3480 Forbrukeratferd,1453380992,2016-01-21 13:56:32,1453381076,84
5698da6c2fb0de2600f22b64,62425,MRK3480 Forbrukeratferd,1453770633,2016-01-26 02:10:33,1453770669,36
5698da6c2fb0de2600f22b64,15280,MRK3480 Forbrukeratferd,1453978943,2016-01-28 12:02:23,1453978991,48
5698da6c2fb0de2600f22b64,1645,MRK3480 Forbrukeratferd,1454030660,2016-01-29 02:24:20,1454030660,0
5698da6c2fb0de2600f22b64,54805,MRK3480 Forbrukeratferd,1454273771,2016-01-31 21:56:11,1454273771,0
5698da6c2fb0de2600f22b64,85924,MRK3480 Forbrukeratferd,1454315818,2016-02-01 09:36:58,1454315818,0
5698da6c2fb0de2600f22b64,45852,MRK3480 Forbrukeratferd,1454338917,2016-02-01 16:01:57,1454338917,0
5698da6c2fb0de2600f22b64,64369,MRK3480 Forbrukeratferd,1454355341,2016-02-01 20:35:41,1454355341,0
5698da6c2fb0de2600f22b64,51794,MRK3480 Forbrukeratferd,1454423082,2016-02-02 15:24:42,1454423178,96
5698da6c2fb0de2600f22b64,22453,MRK3480 Forbrukeratferd,1454491801,2016-02-03 10:30:01,1454491801,0
5698da6c2fb0de2600f22b64,65254,MRK3480 Forbrukeratferd,1454504470,2016-02-03 14:01:10,1454504474,4
5698da6c2fb0de2600f22b64,49282,MRK3480 Forbrukeratferd,1454505690,2016-02-03 14:21:30,1454505709,19
5698da6c2fb0de2600f22b64,14537,MRK3480 Forbrukeratferd,1454598518,2016-02-04 16:08:38,1454598518,0
5698da6c2fb0de2600f22b64,72584,MRK3480 Forbrukeratferd,1454612712,2016-02-04 20:05:12,1454612718,6
5698da6c2fb0de2600f22b64,89523,MRK3480 Forbrukeratferd,1454674916,2016-02-05 13:21:56,1454674916,0
5698da6c2fb0de2600f22b64,30785,MRK3480 Forbrukeratferd,1454679962,2016-02-05 14:46:02,1454679963,1
5698da6c2fb0de2600f22b64,6101,MRK3480 Forbrukeratferd,1454872514,2016-02-07 20:15:14,1454872514,0
5698da6c2fb0de2600f22b64,37276,MRK3480 Forbrukeratferd,1454945685,2016-02-08 16:34:45,1454945926,241
5698da6c2fb0de2600f22b64,24023,MRK3480 Forbrukeratferd,1454947131,2016-02-08 16:58:51,1454947132,1
5698da6c2fb0de2600f22b66,1643,MRK3480 Forbrukeratferd,1453153461,2016-01-18 22:44:21,1453153757,296
5698da6c2fb0de2600f22b66,34692,MRK3480 Forbrukeratferd,1453883874,2016-01-27 09:37:54,1453884246,372
5698da6c2fb0de2600f22b66,80763,MRK3480 Forbrukeratferd,1454435100,2016-02-02 18:45:00,1454435174,74
5698da6c2fb0de2600f22b66,73008,MRK3480 Forbrukeratferd,1455061270,2016-02-10 00:41:10,1455061478,208
5698da6c41a9d72100240947,45669,MRK3480 Forbrukeratferd,1453105182,2016-01-18 09:19:42,1453105259,77
5698da6c41a9d72100240947,31642,MRK3480 Forbrukeratferd,1453719877,2016-01-25 12:04:37,1453719986,109
5698da6c41a9d72100240947,64785,MRK3480 Forbrukeratferd,1453733499,2016-01-25 15:51:39,1453733558,59
5698da6c41a9d72100240947,76702,MRK3480 Forbrukeratferd,1455274956,2016-02-12 12:02:36,1455275478,522
5698da6c41a9d72100240947,38355,MRK3480 Forbrukeratferd,1455282295,2016-02-12 14:04:55,1455282299,4
5698da6c41a9d72100240948,64164,MRK3480 Forbrukeratferd,1452868981,2016-01-15 15:43:01,1452869004,23
5698da6c41a9d72100240948,51740,MRK3480 Forbrukeratferd,1453724167,2016-01-25 13:16:07,1453724192,25
5698da6c41a9d72100240948,26557,MRK3480 Forbrukeratferd,1453979852,2016-01-28 12:17:32,1453979880,28
5698da6d41a9d72100240952,82369,MRK3480 Forbrukeratferd,1453119740,2016-01-18 13:22:20,1453120228,488
5698da6d41a9d72100240952,71268,MRK3480 Forbrukeratferd,1453676859,2016-01-25 00:07:39,1453676975,116
5698da6d41a9d72100240952,80269,MRK3480 Forbrukeratferd,1453724863,2016-01-25 13:27:43,1453724868,5
5698da6d41a9d72100240952,78758,MRK3480 Forbrukeratferd,1453805679,2016-01-26 11:54:39,1453805680,1
5698da6d41a9d72100240952,60095,MRK3480 Forbrukeratferd,1453922094,2016-01-27 20:14:54,1453922135,41
5698da6d41a9d72100240952,14690,MRK3480 Forbrukeratferd,1453925686,2016-01-27 21:14:46,1453925688,2
5698da6d41a9d72100240952,25555,MRK3480 Forbrukeratferd,1454420162,2016-02-02 14:36:02,1454420497,335
5698da6e2fb0de2600f22b6f,92261,MRK3480 Forbrukeratferd,1454462635,2016-02-03 02:23:55,1454462635,0
5698da6e2fb0de2600f22b6f,17282,MRK3480 Forbrukeratferd,1455056147,2016-02-09 23:15:47,1455056148,1
5698da6e2fb0de2600f22b6f,85504,MRK3480 Forbrukeratferd,1455062673,2016-02-10 01:04:33,1455062782,109
5698da6e2fb0de2600f22b71,82466,MRK3480 Forbrukeratferd,1452862167,2016-01-15 13:49:27,1452862216,49
5698da6e2fb0de2600f22b71,77948,MRK3480 Forbrukeratferd,1452863454,2016-01-15 14:10:54,1452863504,50
5698da6e2fb0de2600f22b71,89629,MRK3480 Forbrukeratferd,1452875624,2016-01-15 17:33:44,1452875706,82
5698da6e2fb0de2600f22b71,12558,MRK3480 Forbrukeratferd,1452894281,2016-01-15 22:44:41,1452894301,20
5698da6e2fb0de2600f22b71,40166,MRK3480 Forbrukeratferd,1452900019,2016-01-16 00:20:19,1452900021,2
5698da6e2fb0de2600f22b71,83260,MRK3480 Forbrukeratferd,1452986648,2016-01-17 00:24:08,1452986658,10
5698da6e2fb0de2600f22b71,75586,MRK3480 Forbrukeratferd,1453030116,2016-01-17 12:28:36,1453030161,45
5698da6e2fb0de2600f22b71,12611,MRK3480 Forbrukeratferd,1453374336,2016-01-21 12:05:36,1453374758,422
5698da6e2fb0de2600f22b71,56441,MRK3480 Forbrukeratferd,1453376532,2016-01-21 12:42:12,1453376548,16
5698da6e2fb0de2600f22b71,34689,MRK3480 Forbrukeratferd,1453718191,2016-01-25 11:36:31,1453718204,13
5698da6e2fb0de2600f22b71,42697,MRK3480 Forbrukeratferd,1453805430,2016-01-26 11:50:30,1453805431,1
5698da6e2fb0de2600f22b71,37312,MRK3480 Forbrukeratferd,1453938152,2016-01-28 00:42:32,1453938184,32
5698da6e2fb0de2600f22b71,36161,MRK3480 Forbrukeratferd,1454410554,2016-02-02 11:55:54,1454410554,0
5698da6e2fb0de2600f22b71,27617,MRK3480 Forbrukeratferd,1454696728,2016-02-05 19:25:28,1454696728,0
5698da6e2fb0de2600f22b71,10269,MRK3480 Forbrukeratferd,1454763229,2016-02-06 13:53:49,1454763237,8
5698da6e2fb0de2600f22b73,18881,MRK3480 Forbrukeratferd,1455150220,2016-02-11 01:23:40,1455150221,1
5698da6e2fb0de2600f22b73,50887,MRK3480 Forbrukeratferd,1455195797,2016-02-11 14:03:17,1455195798,1
5698da6e2fb0de2600f22b74,95341,MRK3480 Forbrukeratferd,1452896533,2016-01-15 23:22:13,1452896718,185
5698da6e2fb0de2600f22b74,48826,MRK3480 Forbrukeratferd,1452967043,2016-01-16 18:57:23,1452967043,0
5698da6e2fb0de2600f22b74,1531,MRK3480 Forbrukeratferd,1453112582,2016-01-18 11:23:02,1453112582,0
5698da6e2fb0de2600f22b74,88735,MRK3480 Forbrukeratferd,1453119838,2016-01-18 13:23:58,1453120385,547
5698da6e2fb0de2600f22b74,17376,MRK3480 Forbrukeratferd,1453151349,2016-01-18 22:09:09,1453151358,9
5698da6e2fb0de2600f22b74,16548,MRK3480 Forbrukeratferd,1453376225,2016-01-21 12:37:05,1453376292,67
5698da6e2fb0de2600f22b74,61373,MRK3480 Forbrukeratferd,1453723166,2016-01-25 12:59:26,1453723179,13
5698da6e2fb0de2600f22b74,66890,MRK3480 Forbrukeratferd,1453726667,2016-01-25 13:57:47,1453726675,8
5698da6e2fb0de2600f22b74,67872,MRK3480 Forbrukeratferd,1453815260,2016-01-26 14:34:20,1453815261,1
5698da6e2fb0de2600f22b74,92414,MRK3480 Forbrukeratferd,1453913045,2016-01-27 17:44:05,1453913103,58
5698da6e2fb0de2600f22b74,60465,MRK3480 Forbrukeratferd,1454578373,2016-02-04 10:32:53,1454578373,0
5698da6e2fb0de2600f22b74,58788,MRK3480 Forbrukeratferd,1454605256,2016-02-04 18:00:56,1454605257,1
5698da6e2fb0de2600f22b74,47297,MRK3480 Forbrukeratferd,1454670170,2016-02-05 12:02:50,1454670933,763
5698da6e2fb0de2600f22b74,50362,MRK3480 Forbrukeratferd,1455021782,2016-02-09 13:43:02,1455021808,26
5698da6e2fb0de2600f22b74,58032,MRK3480 Forbrukeratferd,1455114632,2016-02-10 15:30:32,1455114656,24
5698da6e2fb0de2600f22b74,28353,MRK3480 Forbrukeratferd,1455217484,2016-02-11 20:04:44,1455217522,38
5698da6e41a9d72100240954,48657,MRK3480 Forbrukeratferd,1453289253,2016-01-20 12:27:33,1453290000,747
5698da6e41a9d72100240954,61145,MRK3480 Forbrukeratferd,1453892570,2016-01-27 12:02:50,1453893582,1012
5698da6e41a9d72100240954,46966,MRK3480 Forbrukeratferd,1454497556,2016-02-03 12:05:56,1454497565,9
5698da6e41a9d72100240955,3298,MRK3480 Forbrukeratferd,1453709884,2016-01-25 09:18:04,1453709926,42
5698da6e41a9d72100240955,31640,MRK3480 Forbrukeratferd,1453979449,2016-01-28 12:10:49,1453979936,487
5698da6e41a9d72100240955,94595,MRK3480 Forbrukeratferd,1453982038,2016-01-28 12:53:58,1453982465,427
5698da6e41a9d72100240955,97221,MRK3480 Forbrukeratferd,1454015675,2016-01-28 22:14:35,1454016304,629
5698da6e41a9d72100240955,56979,MRK3480 Forbrukeratferd,1454018979,2016-01-28 23:09:39,1454018983,4
5698da6e41a9d72100240956,88782,MRK3480 Forbrukeratferd,1453998032,2016-01-28 17:20:32,1453998230,198
5698da6e41a9d72100240956,63031,MRK3480 Forbrukeratferd,1454809218,2016-02-07 02:40:18,1454809614,396
5698da6e41a9d72100240957,63201,MRK3480 Forbrukeratferd,1453377691,2016-01-21 13:01:31,1453378453,762
5698da6e41a9d72100240957,93827,MRK3480 Forbrukeratferd,1453821148,2016-01-26 16:12:28,1453821781,633
5698da6e41a9d72100240957,28126,MRK3480 Forbrukeratferd,1453982480,2016-01-28 13:01:20,1453982496,16
5698da6e41a9d72100240957,31633,MRK3480 Forbrukeratferd,1454524385,2016-02-03 19:33:05,1454524406,21
5698da6e41a9d72100240957,1489,MRK3480 Forbrukeratferd,1454697444,2016-02-05 19:37:24,1454697450,6
5698da6e41a9d72100240958,96246,MRK3480 Forbrukeratferd,1453246160,2016-01-20 00:29:20,1453246279,119
5698da6e41a9d72100240958,24161,MRK3480 Forbrukeratferd,1453408400,2016-01-21 21:33:20,1453408406,6
5698da6e41a9d72100240958,32173,MRK3480 Forbrukeratferd,1453639665,2016-01-24 13:47:45,1453639697,32
5698da6f2fb0de2600f22b8a,38349,MRK3480 Forbrukeratferd,1452902225,2016-01-16 00:57:05,1452902384,159
5698da6f2fb0de2600f22b8a,97875,MRK3480 Forbrukeratferd,1453679818,2016-01-25 00:56:58,1453679819,1
5698da6f41a9d7210024096f,71734,MRK3480 Forbrukeratferd,1452872681,2016-01-15 16:44:41,1452872719,38
5698da6f41a9d7210024096f,35290,MRK3480 Forbrukeratferd,1452888701,2016-01-15 21:11:41,1452888701,0
5698da6f41a9d7210024096f,36174,MRK3480 Forbrukeratferd,1453471328,2016-01-22 15:02:08,1453471431,103
5698da6f41a9d7210024096f,29925,MRK3480 Forbrukeratferd,1453480242,2016-01-22 17:30:42,1453480245,3
5698da6f41a9d7210024096f,39816,MRK3480 Forbrukeratferd,1453493480,2016-01-22 21:11:20,1453493965,485
5698da6f41a9d7210024096f,33302,MRK3480 Forbrukeratferd,1453546247,2016-01-23 11:50:47,1453546247,0
5698da6f41a9d7210024096f,3194,MRK3480 Forbrukeratferd,1453560971,2016-01-23 15:56:11,1453560977,6
5698da6f41a9d7210024096f,32180,MRK3480 Forbrukeratferd,1453633538,2016-01-24 12:05:38,1453635381,1843
5698da6f41a9d7210024096f,42755,MRK3480 Forbrukeratferd,1453918451,2016-01-27 19:14:11,1453918480,29
5698da6f41a9d7210024096f,65615,MRK3480 Forbrukeratferd,1454612952,2016-02-04 20:09:12,1454616420,3468
5698da7041a9d72100240970,31168,MRK3480 Forbrukeratferd,1452879106,2016-01-15 18:31:46,1452879869,763
5698da7041a9d72100240971,17294,MRK3480 Forbrukeratferd,1453813465,2016-01-26 14:04:25,1453813465,0
5698da7041a9d72100240971,83106,MRK3480 Forbrukeratferd,1453816313,2016-01-26 14:51:53,1453816329,16
5698da7041a9d72100240971,2498,MRK3480 Forbrukeratferd,1453905157,2016-01-27 15:32:37,1453905192,35
5698da7041a9d72100240971,47300,MRK3480 Forbrukeratferd,1453979114,2016-01-28 12:05:14,1453979956,842
5698da7041a9d72100240971,31525,MRK3480 Forbrukeratferd,1453981777,2016-01-28 12:49:37,1453981786,9
5698da7041a9d72100240971,15267,MRK3480 Forbrukeratferd,1454670463,2016-02-05 12:07:43,1454670903,440
5698da7041a9d72100240971,77396,MRK3480 Forbrukeratferd,1454676487,2016-02-05 13:48:07,1454676507,20
5698da7041a9d72100240971,97604,MRK3480 Forbrukeratferd,1454679220,2016-02-05 14:33:40,1454679228,8
5698da7041a9d72100240971,95663,MRK3480 Forbrukeratferd,1454933995,2016-02-08 13:19:55,1454933996,1
5698da7041a9d72100240971,4512,MRK3480 Forbrukeratferd,1454944095,2016-02-08 16:08:15,1454944095,0
5698da7041a9d72100240971,61620,MRK3480 Forbrukeratferd,1454945673,2016-02-08 16:34:33,1454945677,4
5698da7041a9d72100240972,51880,MRK3480 Forbrukeratferd,1452863107,2016-01-15 14:05:07,1452863159,52
5698da7041a9d72100240972,60418,MRK3480 Forbrukeratferd,1453154687,2016-01-18 23:04:47,1453154935,248
5698da7041a9d72100240972,67641,MRK3480 Forbrukeratferd,1453320795,2016-01-20 21:13:15,1453320958,163
5698da7041a9d72100240972,71252,MRK3480 Forbrukeratferd,1453326754,2016-01-20 22:52:34,1453326759,5
5698da7041a9d72100240972,81692,MRK3480 Forbrukeratferd,1453719697,2016-01-25 12:01:37,1453719713,16
5698da7041a9d72100240972,49424,MRK3480 Forbrukeratferd,1453725617,2016-01-25 13:40:17,1453725618,1
5698da7041a9d72100240972,64476,MRK3480 Forbrukeratferd,1453729484,2016-01-25 14:44:44,1453729485,1
5698da7041a9d72100240972,1589,MRK3480 Forbrukeratferd,1453742230,2016-01-25 18:17:10,1453742230,0
5698da7041a9d72100240972,97111,MRK3480 Forbrukeratferd,1453978358,2016-01-28 11:52:38,1453978502,144
5698da7041a9d72100240972,35294,MRK3480 Forbrukeratferd,1453992266,2016-01-28 15:44:26,1453992306,40
5698da7041a9d72100240972,58064,MRK3480 Forbrukeratferd,1454075921,2016-01-29 14:58:41,1454076033,112
5698da7041a9d72100240972,34892,MRK3480 Forbrukeratferd,1454671108,2016-02-05 12:18:28,1454671223,115
5698da7041a9d72100240972,31829,MRK3480 Forbrukeratferd,1454672458,2016-02-05 12:40:58,1454673567,1109
5698da712fb0de2600f22b8d,42530,MRK3480 Forbrukeratferd,1453058043,2016-01-17 20:14:03,1453059343,1300
5698da712fb0de2600f22b8d,69674,MRK3480 Forbrukeratferd,1453374335,2016-01-21 12:05:35,1453374477,142
5698da712fb0de2600f22b8d,40550,MRK3480 Forbrukeratferd,1453376180,2016-01-21 12:36:20,1453376185,5
5698da712fb0de2600f22b8d,61351,MRK3480 Forbrukeratferd,1453750859,2016-01-25 20:40:59,1453751989,1130
5698da712fb0de2600f22b8d,58367,MRK3480 Forbrukeratferd,1454539004,2016-02-03 23:36:44,1454540170,1166
5698da712fb0de2600f22b8e,48423,MRK3480 Forbrukeratferd,1453135357,2016-01-18 17:42:37,1453135389,32
5698da712fb0de2600f22b8e,82514,MRK3480 Forbrukeratferd,1453373941,2016-01-21 11:59:01,1453374137,196
5698da712fb0de2600f22b8e,47640,MRK3480 Forbrukeratferd,1453378031,2016-01-21 13:07:11,1453378405,374
5698da712fb0de2600f22b8e,87405,MRK3480 Forbrukeratferd,1453400949,2016-01-21 19:29:09,1453400950,1
5698da712fb0de2600f22b8e,96448,MRK3480 Forbrukeratferd,1453822301,2016-01-26 16:31:41,1453822335,34
5698da712fb0de2600f22b8e,34930,MRK3480 Forbrukeratferd,1455217106,2016-02-11 19:58:26,1455218160,1054
5698da712fb0de2600f22b8f,9474,MRK3480 Forbrukeratferd,1453396044,2016-01-21 18:07:24,1453396205,161
5698da712fb0de2600f22b8f,90133,MRK3480 Forbrukeratferd,1454586264,2016-02-04 12:44:24,1454586308,44
5698da712fb0de2600f22b90,67825,MRK3480 Forbrukeratferd,1453326593,2016-01-20 22:49:53,1453328211,1618
5698da712fb0de2600f22b90,55993,MRK3480 Forbrukeratferd,1453373838,2016-01-21 11:57:18,1453374455,617
5698da712fb0de2600f22b90,1180,MRK3480 Forbrukeratferd,1453378413,2016-01-21 13:13:33,1453378469,56
5698da712fb0de2600f22b90,31868,MRK3480 Forbrukeratferd,1453400722,2016-01-21 19:25:22,1453400808,86
5698da712fb0de2600f22b90,99948,MRK3480 Forbrukeratferd,1453454697,2016-01-22 10:24:57,1453455142,445
5698da712fb0de2600f22b90,47004,MRK3480 Forbrukeratferd,1453459853,2016-01-22 11:50:53,1453460020,167
5698da712fb0de2600f22b90,88881,MRK3480 Forbrukeratferd,1453472675,2016-01-22 15:24:35,1453474115,1440
5698da712fb0de2600f22b90,83490,MRK3480 Forbrukeratferd,1453803374,2016-01-26 11:16:14,1453803532,158
5698da712fb0de2600f22b90,22352,MRK3480 Forbrukeratferd,1453805783,2016-01-26 11:56:23,1453805784,1
5698da712fb0de2600f22b90,23034,MRK3480 Forbrukeratferd,1453823630,2016-01-26 16:53:50,1453824279,649
5698da712fb0de2600f22b90,17977,MRK3480 Forbrukeratferd,1453842714,2016-01-26 22:11:54,1453842715,1
5698da712fb0de2600f22b90,92711,MRK3480 Forbrukeratferd,1453911268,2016-01-27 17:14:28,1453912000,732
5698da712fb0de2600f22b90,35319,MRK3480 Forbrukeratferd,1453913290,2016-01-27 17:48:10,1453913349,59
5698da712fb0de2600f22b90,58705,MRK3480 Forbrukeratferd,1454156870,2016-01-30 13:27:50,1454156929,59
5698da712fb0de2600f22b90,9824,MRK3480 Forbrukeratferd,1454414430,2016-02-02 13:00:30,1454414503,73
5698da712fb0de2600f22b90,99850,MRK3480 Forbrukeratferd,1454678873,2016-02-05 14:27:53,1454678958,85
5698da712fb0de2600f22b90,7012,MRK3480 Forbrukeratferd,1454929725,2016-02-08 12:08:45,1454929831,106
5698da712fb0de2600f22b90,18639,MRK3480 Forbrukeratferd,1455048757,2016-02-09 21:12:37,1455048816,59
5698da712fb0de2600f22b90,84766,MRK3480 Forbrukeratferd,1455137757,2016-02-10 21:55:57,1455137799,42
5698da712fb0de2600f22b90,76808,MRK3480 Forbrukeratferd,1455139158,2016-02-10 22:19:18,1455139167,9
5698da712fb0de2600f22b90,14551,MRK3480 Forbrukeratferd,1455141197,2016-02-10 22:53:17,1455141201,4
5698da712fb0de2600f22b91,55956,MRK3480 Forbrukeratferd,1453162225,2016-01-19 01:10:25,1453162651,426
5698da712fb0de2600f22b91,72178,MRK3480 Forbrukeratferd,1453287415,2016-01-20 11:56:55,1453287470,55
5698da712fb0de2600f22b91,66643,MRK3480 Forbrukeratferd,1453312374,2016-01-20 18:52:54,1453313595,1221
5698da712fb0de2600f22b91,50270,MRK3480 Forbrukeratferd,1453727023,2016-01-25 14:03:43,1453727094,71
5698da712fb0de2600f22b91,31589,MRK3480 Forbrukeratferd,1453734672,2016-01-25 16:11:12,1453734686,14
5698da712fb0de2600f22b91,48305,MRK3480 Forbrukeratferd,1453805006,2016-01-26 11:43:26,1453805053,47
5698da712fb0de2600f22b91,58261,MRK3480 Forbrukeratferd,1453912317,2016-01-27 17:31:57,1453912319,2
5698da712fb0de2600f22b92,89626,MRK3480 Forbrukeratferd,1453050138,2016-01-17 18:02:18,1453050350,212
5698da712fb0de2600f22b92,82368,MRK3480 Forbrukeratferd,1453138606,2016-01-18 18:36:46,1453138620,14
5698da712fb0de2600f22b92,71288,MRK3480 Forbrukeratferd,1453388322,2016-01-21 15:58:42,1453388623,301
5698da712fb0de2600f22b92,49630,MRK3480 Forbrukeratferd,1453398745,2016-01-21 18:52:25,1453398803,58
5698da712fb0de2600f22b92,7806,MRK3480 Forbrukeratferd,1453733913,2016-01-25 15:58:33,1453733944,31
5698da712fb0de2600f22b92,67545,MRK3480 Forbrukeratferd,1453913283,2016-01-27 17:48:03,1453913330,47
5698da712fb0de2600f22b92,34401,MRK3480 Forbrukeratferd,1453993515,2016-01-28 16:05:15,1453994663,1148
5698da712fb0de2600f22b92,26136,MRK3480 Forbrukeratferd,1454411160,2016-02-02 12:06:00,1454411167,7
5698da712fb0de2600f22b92,65051,MRK3480 Forbrukeratferd,1454516884,2016-02-03 17:28:04,1454516905,21
5698da712fb0de2600f22b92,80491,MRK3480 Forbrukeratferd,1455230364,2016-02-11 23:39:24,1455230468,104
5698da712fb0de2600f22b93,45553,MRK3480 Forbrukeratferd,1453925174,2016-01-27 21:06:14,1453925758,584
5698da712fb0de2600f22b93,83448,MRK3480 Forbrukeratferd,1453979839,2016-01-28 12:17:19,1453979883,44
5698da712fb0de2600f22b93,52192,MRK3480 Forbrukeratferd,1454163484,2016-01-30 15:18:04,1454163485,1
5698da712fb0de2600f22b94,27535,MRK3480 Forbrukeratferd,1455020283,2016-02-09 13:18:03,1455020284,1
5698da7141a9d7210024097a,42935,MRK3480 Forbrukeratferd,1453048279,2016-01-17 17:31:19,1453048345,66
5698da7141a9d7210024097a,48777,MRK3480 Forbrukeratferd,1453152019,2016-01-18 22:20:19,1453152041,22
5698da7141a9d7210024097a,281,MRK3480 Forbrukeratferd,1453885102,2016-01-27 09:58:22,1453885216,114
5698da7141a9d7210024097c,37112,MRK3480 Forbrukeratferd,1453119724,2016-01-18 13:22:04,1453119838,114
5698da7141a9d7210024097c,88125,MRK3480 Forbrukeratferd,1453375660,2016-01-21 12:27:40,1453375803,143
5698da7141a9d7210024097c,43110,MRK3480 Forbrukeratferd,1453979116,2016-01-28 12:05:16,1453979173,57
5698da7141a9d7210024097e,32461,MRK3480 Forbrukeratferd,1454678940,2016-02-05 14:29:00,1454679202,262
5698da7141a9d7210024097f,8314,MRK3480 Forbrukeratferd,1453457609,2016-01-22 11:13:29,1453458281,672
5698da7141a9d7210024097f,77262,MRK3480 Forbrukeratferd,1453890847,2016-01-27 11:34:07,1453891220,373
5698da7141a9d7210024097f,35108,MRK3480 Forbrukeratferd,1453895962,2016-01-27 12:59:22,1453895978,16
5698da7141a9d7210024097f,47212,MRK3480 Forbrukeratferd,1453911015,2016-01-27 17:10:15,1453911060,45
5698da7141a9d7210024097f,49510,MRK3480 Forbrukeratferd,1453912613,2016-01-27 17:36:53,1453912621,8
5698da7141a9d7210024097f,73056,MRK3480 Forbrukeratferd,1454937886,2016-02-08 14:24:46,1454939055,1169
5698da7141a9d7210024097f,92582,MRK3480 Forbrukeratferd,1455190011,2016-02-11 12:26:51,1455190277,266
5698da7141a9d72100240980,88271,MRK3480 Forbrukeratferd,1453374205,2016-01-21 12:03:25,1453374220,15
5698da7141a9d72100240980,57162,MRK3480 Forbrukeratferd,1453378585,2016-01-21 13:16:25,1453378586,1
5698da7141a9d72100240980,61870,MRK3480 Forbrukeratferd,1453980471,2016-01-28 12:27:51,1453980568,97
5698da7141a9d72100240980,31123,MRK3480 Forbrukeratferd,1453999154,2016-01-28 17:39:14,1453999263,109
5698da7241a9d72100240997,95527,MRK3480 Forbrukeratferd,1453040363,2016-01-17 15:19:23,1453040509,146
5698da7241a9d72100240997,38418,MRK3480 Forbrukeratferd,1453280401,2016-01-20 10:00:01,1453280434,33
5698da7241a9d72100240997,1323,MRK3480 Forbrukeratferd,1453284780,2016-01-20 11:13:00,1453284866,86
5698da7241a9d72100240997,36727,MRK3480 Forbrukeratferd,1453374399,2016-01-21 12:06:39,1453374504,105
5698da7241a9d72100240997,72627,MRK3480 Forbrukeratferd,1453471437,2016-01-22 15:03:57,1453471465,28
5698da7241a9d72100240997,70742,MRK3480 Forbrukeratferd,1453721602,2016-01-25 12:33:22,1453721683,81
5698da7241a9d72100240997,23282,MRK3480 Forbrukeratferd,1453741191,2016-01-25 17:59:51,1453741194,3
5698da7241a9d72100240997,52620,MRK3480 Forbrukeratferd,1454419931,2016-02-02 14:32:11,1454419968,37
5698da7241a9d72100240997,93274,MRK3480 Forbrukeratferd,1455274509,2016-02-12 11:55:09,1455274653,144
5698da7241a9d72100240997,70869,MRK3480 Forbrukeratferd,1455281041,2016-02-12 13:44:01,1455281044,3
5698da732fb0de2600f22bb2,49581,MRK3480 Forbrukeratferd,1453045303,2016-01-17 16:41:43,1453045357,54
5698da732fb0de2600f22bb2,19260,MRK3480 Forbrukeratferd,1453218535,2016-01-19 16:48:55,1453218560,25
5698da732fb0de2600f22bb2,73950,MRK3480 Forbrukeratferd,1453978703,2016-01-28 11:58:23,1453979522,819
5698da732fb0de2600f22bb2,57829,MRK3480 Forbrukeratferd,1454069739,2016-01-29 13:15:39,1454069773,34
5698da732fb0de2600f22bb2,38450,MRK3480 Forbrukeratferd,1454504653,2016-02-03 14:04:13,1454504653,0
5698da732fb0de2600f22bb2,35241,MRK3480 Forbrukeratferd,1454585437,2016-02-04 12:30:37,1454585443,6
5698da732fb0de2600f22bb2,80165,MRK3480 Forbrukeratferd,1454669083,2016-02-05 11:44:43,1454669134,51
5698da732fb0de2600f22bb2,70397,MRK3480 Forbrukeratferd,1454862953,2016-02-07 17:35:53,1454863071,118
5698da732fb0de2600f22bb2,78593,MRK3480 Forbrukeratferd,1454944476,2016-02-08 16:14:36,1454944539,63
5698da732fb0de2600f22bb2,57179,MRK3480 Forbrukeratferd,1455112496,2016-02-10 14:54:56,1455112497,1
5698da732fb0de2600f22bb2,30657,MRK3480 Forbrukeratferd,1455313258,2016-02-12 22:40:58,1455313446,188
5698da732fb0de2600f22bb3,70220,MRK3480 Forbrukeratferd,1453748046,2016-01-25 19:54:06,1453748153,107
5698da732fb0de2600f22bb3,27209,MRK3480 Forbrukeratferd,1453996751,2016-01-28 16:59:11,1453997592,841
5698da732fb0de2600f22bb3,37132,MRK3480 Forbrukeratferd,1454000321,2016-01-28 17:58:41,1454000323,2
5698da732fb0de2600f22bb3,99554,MRK3480 Forbrukeratferd,1454963226,2016-02-08 21:27:06,1454963288,62
5698da732fb0de2600f22bb4,16737,MRK3480 Forbrukeratferd,1452881848,2016-01-15 19:17:28,1452881950,102
5698da732fb0de2600f22bb4,79460,MRK3480 Forbrukeratferd,1453737685,2016-01-25 17:01:25,1453737687,2
5698da732fb0de2600f22bb4,97779,MRK3480 Forbrukeratferd,1454086203,2016-01-29 17:50:03,1454086267,64
5698da732fb0de2600f22bb4,31005,MRK3480 Forbrukeratferd,1454249266,2016-01-31 15:07:46,1454251308,2042
5698da732fb0de2600f22bb5,86011,MRK3480 Forbrukeratferd,1453377786,2016-01-21 13:03:06,1453378291,505
5698da732fb0de2600f22bb5,25393,MRK3480 Forbrukeratferd,1453757052,2016-01-25 22:24:12,1453757084,32
5698da732fb0de2600f22bb5,22542,MRK3480 Forbrukeratferd,1454603259,2016-02-04 17:27:39,1454604166,907
5698da732fb0de2600f22bb5,45403,MRK3480 Forbrukeratferd,1455278913,2016-02-12 13:08:33,1455280073,1160
5698da732fb0de2600f22bb5,62904,MRK3480 Forbrukeratferd,1455281417,2016-02-12 13:50:17,1455281424,7
5698da732fb0de2600f22bb5,94164,MRK3480 Forbrukeratferd,1455284310,2016-02-12 14:38:30,1455284314,4
5698da732fb0de2600f22bba,12250,MRK3480 Forbrukeratferd,1453335823,2016-01-21 01:23:43,1453335894,71
5698da732fb0de2600f22bba,81823,MRK3480 Forbrukeratferd,1453375605,2016-01-21 12:26:45,1453375635,30
5698da732fb0de2600f22bba,10462,MRK3480 Forbrukeratferd,1453377861,2016-01-21 13:04:21,1453378420,559
5698da732fb0de2600f22bba,92525,MRK3480 Forbrukeratferd,1453991148,2016-01-28 15:25:48,1453991153,5
5698da732fb0de2600f22bba,68987,MRK3480 Forbrukeratferd,1455101104,2016-02-10 11:45:04,1455101165,61
5698da732fb0de2600f22bba,91142,MRK3480 Forbrukeratferd,1455131539,2016-02-10 20:12:19,1455132873,1334
5698da7341a9d72100240999,32958,MRK3480 Forbrukeratferd,1453032836,2016-01-17 13:13:56,1453032836,0
5698da7341a9d72100240999,86957,MRK3480 Forbrukeratferd,1453079839,2016-01-18 02:17:19,1453079897,58
5698da7341a9d72100240999,40390,MRK3480 Forbrukeratferd,1453128474,2016-01-18 15:47:54,1453128475,1
5698da7341a9d72100240999,8857,MRK3480 Forbrukeratferd,1453374751,2016-01-21 12:12:31,1453374763,12
5698da7341a9d72100240999,83565,MRK3480 Forbrukeratferd,1453377562,2016-01-21 12:59:22,1453377562,0
5698da7341a9d72100240999,53183,MRK3480 Forbrukeratferd,1453675767,2016-01-24 23:49:27,1453675785,18
5698da7341a9d72100240999,6613,MRK3480 Forbrukeratferd,1453722639,2016-01-25 12:50:39,1453723835,1196
5698da7341a9d72100240999,69003,MRK3480 Forbrukeratferd,1453809221,2016-01-26 12:53:41,1453809221,0
5698da7341a9d72100240999,39532,MRK3480 Forbrukeratferd,1453911074,2016-01-27 17:11:14,1453911075,1
5698da7341a9d72100240999,51027,MRK3480 Forbrukeratferd,1453923231,2016-01-27 20:33:51,1453923253,22
5698da7341a9d72100240999,59246,MRK3480 Forbrukeratferd,1454001666,2016-01-28 18:21:06,1454001667,1
5698da7341a9d72100240999,36298,MRK3480 Forbrukeratferd,1455490266,2016-02-14 23:51:06,1455490982,716
5698da742fb0de2600f22bbc,41464,MRK3480 Forbrukeratferd,1453309064,2016-01-20 17:57:44,1453309170,106
5698da742fb0de2600f22bbc,7282,MRK3480 Forbrukeratferd,1454345245,2016-02-01 17:47:25,1454345432,187
5698da742fb0de2600f22bbc,67205,MRK3480 Forbrukeratferd,1454368027,2016-02-02 00:07:07,1454368028,1
5698da742fb0de2600f22bbe,97197,MRK3480 Forbrukeratferd,1452867468,2016-01-15 15:17:48,1452867505,37
5698da742fb0de2600f22bbe,75494,MRK3480 Forbrukeratferd,1452999346,2016-01-17 03:55:46,1452999346,0
5698da742fb0de2600f22bbe,16285,MRK3480 Forbrukeratferd,1453675930,2016-01-24 23:52:10,1453675997,67
5698da742fb0de2600f22bbe,67521,MRK3480 Forbrukeratferd,1453745296,2016-01-25 19:08:16,1453746444,1148
5698da742fb0de2600f22bbe,96423,MRK3480 Forbrukeratferd,1453850343,2016-01-27 00:19:03,1453850382,39
5698da742fb0de2600f22bbe,20850,MRK3480 Forbrukeratferd,1453979463,2016-01-28 12:11:03,1453979465,2
5698da742fb0de2600f22bbe,54375,MRK3480 Forbrukeratferd,1454601410,2016-02-04 16:56:50,1454601450,40
5698da742fb0de2600f22bbe,61065,MRK3480 Forbrukeratferd,1454678342,2016-02-05 14:19:02,1454678468,126
5698da742fb0de2600f22bbe,87136,MRK3480 Forbrukeratferd,1454716342,2016-02-06 00:52:22,1454716344,2
5698da742fb0de2600f22bbe,27304,MRK3480 Forbrukeratferd,1455274856,2016-02-12 12:00:56,1455276083,1227
5698da742fb0de2600f22bbe,92871,MRK3480 Forbrukeratferd,1455281168,2016-02-12 13:46:08,1455281188,20
5698da742fb0de2600f22bbe,94231,MRK3480 Forbrukeratferd,1455309715,2016-02-12 21:41:55,1455309716,1
5698da742fb0de2600f22bc1,79930,MRK3480 Forbrukeratferd,1453127199,2016-01-18 15:26:39,1453127225,26
5698da742fb0de2600f22bc1,60571,MRK3480 Forbrukeratferd,1453306104,2016-01-20 17:08:24,1453306573,469
5698da742fb0de2600f22bc1,1577,MRK3480 Forbrukeratferd,1453309833,2016-01-20 18:10:33,1453309860,27
5698da742fb0de2600f22bc1,57798,MRK3480 Forbrukeratferd,1453459899,2016-01-22 11:51:39,1453459899,0
5698da742fb0de2600f22bc1,8128,MRK3480 Forbrukeratferd,1453723732,2016-01-25 13:08:52,1453723765,33
5698da742fb0de2600f22bc1,30373,MRK3480 Forbrukeratferd,1453762863,2016-01-26 00:01:03,1453762888,25
5698da742fb0de2600f22bc1,6396,MRK3480 Forbrukeratferd,1453937419,2016-01-28 00:30:19,1453937492,73
5698da742fb0de2600f22bc1,53659,MRK3480 Forbrukeratferd,1454869187,2016-02-07 19:19:47,1454869202,15
5698da742fb0de2600f22bc2,91497,MRK3480 Forbrukeratferd,1453308987,2016-01-20 17:56:27,1453309054,67
5698da742fb0de2600f22bc2,3662,MRK3480 Forbrukeratferd,1453916256,2016-01-27 18:37:36,1453916377,121
5698da742fb0de2600f22bc2,18538,MRK3480 Forbrukeratferd,1453953229,2016-01-28 04:53:49,1453953262,33
5698da742fb0de2600f22bc2,42790,MRK3480 Forbrukeratferd,1454627372,2016-02-05 00:09:32,1454627511,139
5698da742fb0de2600f22bc2,97845,MRK3480 Forbrukeratferd,1454671214,2016-02-05 12:20:14,1454671225,11
5698da7541a9d7210024099f,13333,MRK3480 Forbrukeratferd,1452861623,2016-01-15 13:40:23,1452861683,60
5698da7541a9d7210024099f,41649,MRK3480 Forbrukeratferd,1453204460,2016-01-19 12:54:20,1453204504,44
5698da7541a9d721002409a0,91485,MRK3480 Forbrukeratferd,1453385403,2016-01-21 15:10:03,1453385496,93
5698da7541a9d721002409a0,19087,MRK3480 Forbrukeratferd,1453905811,2016-01-27 15:43:31,1453906626,815
5698da7541a9d721002409a0,36735,MRK3480 Forbrukeratferd,1453911720,2016-01-27 17:22:00,1453911741,21
5698da7541a9d721002409a0,36371,MRK3480 Forbrukeratferd,1453979018,2016-01-28 12:03:38,1453980303,1285
5698da7541a9d721002409a0,65127,MRK3480 Forbrukeratferd,1453982653,2016-01-28 13:04:13,1453983788,1135
5698da7541a9d721002409a0,15245,MRK3480 Forbrukeratferd,1454324146,2016-02-01 11:55:46,1454325487,1341
5698da7541a9d721002409a0,33422,MRK3480 Forbrukeratferd,1454327673,2016-02-01 12:54:33,1454327673,0
5698da7541a9d721002409a0,58293,MRK3480 Forbrukeratferd,1454332976,2016-02-01 14:22:56,1454332981,5
5698da7541a9d721002409a0,71118,MRK3480 Forbrukeratferd,1454664997,2016-02-05 10:36:37,1454665073,76
5698da7541a9d721002409a0,65922,MRK3480 Forbrukeratferd,1454671617,2016-02-05 12:26:57,1454672216,599
5698da7541a9d721002409a0,3205,MRK3480 Forbrukeratferd,1454703710,2016-02-05 21:21:50,1454703737,27
5698da7541a9d721002409a0,53207,MRK3480 Forbrukeratferd,1455279897,2016-02-12 13:24:57,1455279899,2
5698da7541a9d721002409a0,15914,MRK3480 Forbrukeratferd,1455281181,2016-02-12 13:46:21,1455290560,9379
5698da7541a9d721002409a1,82283,MRK3480 Forbrukeratferd,1453377466,2016-01-21 12:57:46,1453379175,1709
5698da7541a9d721002409a1,30103,MRK3480 Forbrukeratferd,1453386373,2016-01-21 15:26:13,1453386459,86
5698da7541a9d721002409a1,14720,MRK3480 Forbrukeratferd,1453467223,2016-01-22 13:53:43,1453467223,0
5698da7541a9d721002409a1,15677,MRK3480 Forbrukeratferd,1453810905,2016-01-26 13:21:45,1453810955,50
5698da7541a9d721002409a1,7816,MRK3480 Forbrukeratferd,1454413490,2016-02-02 12:44:50,1454413491,1
5698da7541a9d721002409a1,90873,MRK3480 Forbrukeratferd,1455286005,2016-02-12 15:06:45,1455286144,139
5698da7541a9d721002409a2,14417,MRK3480 Forbrukeratferd,1453201814,2016-01-19 12:10:14,1453201814,0
5698da7541a9d721002409a2,12178,MRK3480 Forbrukeratferd,1453723815,2016-01-25 13:10:15,1453723845,30
5698da7541a9d721002409a2,74177,MRK3480 Forbrukeratferd,1453903722,2016-01-27 15:08:42,1453903766,44
5698da7541a9d721002409a2,11002,MRK3480 Forbrukeratferd,1453906105,2016-01-27 15:48:25,1453906115,10
5698da7541a9d721002409a2,92523,MRK3480 Forbrukeratferd,1453909065,2016-01-27 16:37:45,1453909107,42
5698da7541a9d721002409a2,92715,MRK3480 Forbrukeratferd,1453978927,2016-01-28 12:02:07,1453978927,0
5698da7541a9d721002409a2,95742,MRK3480 Forbrukeratferd,1454497273,2016-02-03 12:01:13,1454498376,1103
5698da7541a9d721002409a3,22388,MRK3480 Forbrukeratferd,1452863570,2016-01-15 14:12:50,1452863665,95
5698da7541a9d721002409a3,963,MRK3480 Forbrukeratferd,1452873501,2016-01-15 16:58:21,1452873501,0
5698da7541a9d721002409a3,46417,MRK3480 Forbrukeratferd,1453119927,2016-01-18 13:25:27,1453119927,0
5698da7541a9d721002409a3,40278,MRK3480 Forbrukeratferd,1453548475,2016-01-23 12:27:55,1453548536,61
5698da762fb0de2600f22bda,82526,MRK3480 Forbrukeratferd,1453368425,2016-01-21 10:27:05,1453368984,559
5698da762fb0de2600f22bda,69753,MRK3480 Forbrukeratferd,1453373997,2016-01-21 11:59:57,1453374053,56
5698da762fb0de2600f22bda,17525,MRK3480 Forbrukeratferd,1453978688,2016-01-28 11:58:08,1453978802,114
5698da762fb0de2600f22bda,84452,MRK3480 Forbrukeratferd,1453983951,2016-01-28 13:25:51,1453983951,0
5698da762fb0de2600f22bda,20390,MRK3480 Forbrukeratferd,1453992644,2016-01-28 15:50:44,1453992907,263
5698da762fb0de2600f22bda,14460,MRK3480 Forbrukeratferd,1454684719,2016-02-05 16:05:19,1454684768,49
5698da762fb0de2600f22bda,82807,MRK3480 Forbrukeratferd,1454961657,2016-02-08 21:00:57,1454961657,0
5698da762fb0de2600f22bda,40671,MRK3480 Forbrukeratferd,1455282667,2016-02-12 14:11:07,1455282822,155
5698da762fb0de2600f22bda,92521,MRK3480 Forbrukeratferd,1455296935,2016-02-12 18:08:55,1455296964,29
5698da772fb0de2600f22bde,72343,MRK3480 Forbrukeratferd,1453197439,2016-01-19 10:57:19,1453197440,1
5698da772fb0de2600f22bde,85997,MRK3480 Forbrukeratferd,1453291030,2016-01-20 12:57:10,1453291107,77
5698da772fb0de2600f22bde,70762,MRK3480 Forbrukeratferd,1453292377,2016-01-20 13:19:37,1453292394,17
5698da772fb0de2600f22bde,39673,MRK3480 Forbrukeratferd,1453887060,2016-01-27 10:31:00,1453888312,1252
5698da772fb0de2600f22bdf,72886,MRK3480 Forbrukeratferd,1453306551,2016-01-20 17:15:51,1453306910,359
5698da772fb0de2600f22bdf,33619,MRK3480 Forbrukeratferd,1453986020,2016-01-28 14:00:20,1453986163,143
5698da772fb0de2600f22bdf,10582,MRK3480 Forbrukeratferd,1453988352,2016-01-28 14:39:12,1453990113,1761
5698da772fb0de2600f22bdf,45531,MRK3480 Forbrukeratferd,1453991477,2016-01-28 15:31:17,1453991482,5
5698da772fb0de2600f22bdf,31678,MRK3480 Forbrukeratferd,1453993017,2016-01-28 15:56:57,1453993578,561
5698da772fb0de2600f22bdf,41915,MRK3480 Forbrukeratferd,1454950275,2016-02-08 17:51:15,1454950289,14
5698da772fb0de2600f22be0,90497,MRK3480 Forbrukeratferd,1453147873,2016-01-18 21:11:13,1453147873,0
5698da772fb0de2600f22be0,69531,MRK3480 Forbrukeratferd,1453250385,2016-01-20 01:39:45,1453250385,0
5698da772fb0de2600f22be0,43488,MRK3480 Forbrukeratferd,1453667686,2016-01-24 21:34:46,1453672296,4610
5698da772fb0de2600f22be0,31682,MRK3480 Forbrukeratferd,1453908642,2016-01-27 16:30:42,1453908801,159
5698da772fb0de2600f22be0,47760,MRK3480 Forbrukeratferd,1455124540,2016-02-10 18:15:40,1455125281,741
5698da772fb0de2600f22be4,45159,MRK3480 Forbrukeratferd,1452879339,2016-01-15 18:35:39,1452879443,104
5698da772fb0de2600f22be4,30758,MRK3480 Forbrukeratferd,1452953621,2016-01-16 15:13:41,1452953768,147
5698da772fb0de2600f22be4,92098,MRK3480 Forbrukeratferd,1453144475,2016-01-18 20:14:35,1453144547,72
5698da772fb0de2600f22be4,35097,MRK3480 Forbrukeratferd,1453287926,2016-01-20 12:05:26,1453288054,128
5698da772fb0de2600f22be4,80358,MRK3480 Forbrukeratferd,1453294986,2016-01-20 14:03:06,1453294992,6
5698da772fb0de2600f22be4,60124,MRK3480 Forbrukeratferd,1453306430,2016-01-20 17:13:50,1453306454,24
5698da772fb0de2600f22be4,67377,MRK3480 Forbrukeratferd,1453372581,2016-01-21 11:36:21,1453372892,311
5698da772fb0de2600f22be4,11536,MRK3480 Forbrukeratferd,1453390085,2016-01-21 16:28:05,1453390085,0
5698da772fb0de2600f22be4,27119,MRK3480 Forbrukeratferd,1453507151,2016-01-23 00:59:11,1453507182,31
5698da772fb0de2600f22be4,20704,MRK3480 Forbrukeratferd,1453665247,2016-01-24 20:54:07,1453665310,63
5698da772fb0de2600f22be4,47251,MRK3480 Forbrukeratferd,1453702025,2016-01-25 07:07:05,1453702048,23
5698da772fb0de2600f22be4,82743,MRK3480 Forbrukeratferd,1453727802,2016-01-25 14:16:42,1453727822,20
5698da772fb0de2600f22be4,32127,MRK3480 Forbrukeratferd,1453807073,2016-01-26 12:17:53,1453807076,3
5698da772fb0de2600f22be4,37711,MRK3480 Forbrukeratferd,1453836672,2016-01-26 20:31:12,1453836672,0
5698da772fb0de2600f22be4,52530,MRK3480 Forbrukeratferd,1453922679,2016-01-27 20:24:39,1453922680,1
5698da772fb0de2600f22be4,68841,MRK3480 Forbrukeratferd,1454503958,2016-02-03 13:52:38,1454504001,43
5698da772fb0de2600f22be4,66985,MRK3480 Forbrukeratferd,1454669766,2016-02-05 11:56:06,1454669934,168
5698da772fb0de2600f22be4,92217,MRK3480 Forbrukeratferd,1454671283,2016-02-05 12:21:23,1454671283,0
5698da772fb0de2600f22be4,27759,MRK3480 Forbrukeratferd,1454677554,2016-02-05 14:05:54,1454677598,44
5698da772fb0de2600f22be4,46536,MRK3480 Forbrukeratferd,1455144106,2016-02-10 23:41:46,1455144622,516
5698da772fb0de2600f22be4,69475,MRK3480 Forbrukeratferd,1455278208,2016-02-12 12:56:48,1455278451,243
5698da772fb0de2600f22be4,89133,MRK3480 Forbrukeratferd,1455394175,2016-02-13 21:09:35,1455394194,19
5698da772fb0de2600f22be4,56776,MRK3480 Forbrukeratferd,1455489282,2016-02-14 23:34:42,1455489283,1
5698da7741a9d721002409c2,37511,MRK3480 Forbrukeratferd,1453377008,2016-01-21 12:50:08,1453377008,0
5698da7741a9d721002409c2,73762,MRK3480 Forbrukeratferd,1453382868,2016-01-21 14:27:48,1453382872,4
5698da7741a9d721002409c2,71928,MRK3480 Forbrukeratferd,1453392604,2016-01-21 17:10:04,1453392663,59
5698da7741a9d721002409c2,43838,MRK3480 Forbrukeratferd,1453836104,2016-01-26 20:21:44,1453836142,38
5698da7741a9d721002409c2,60312,MRK3480 Forbrukeratferd,1453912003,2016-01-27 17:26:43,1453912074,71
5698da7741a9d721002409c3,29076,MRK3480 Forbrukeratferd,1453128304,2016-01-18 15:45:04,1453129292,988
5698da7741a9d721002409c3,13242,MRK3480 Forbrukeratferd,1453145815,2016-01-18 20:36:55,1453145815,0
5698da7741a9d721002409c3,93942,MRK3480 Forbrukeratferd,1453371453,2016-01-21 11:17:33,1453372871,1418
5698da7741a9d721002409c3,61442,MRK3480 Forbrukeratferd,1453375628,2016-01-21 12:27:08,1453375815,187
5698da7741a9d721002409c3,63346,MRK3480 Forbrukeratferd,1453377807,2016-01-21 13:03:27,1453378550,743
5698da7741a9d721002409c3,829,MRK3480 Forbrukeratferd,1453403358,2016-01-21 20:09:18,1453403372,14
5698da7741a9d721002409c3,66937,MRK3480 Forbrukeratferd,1453723866,2016-01-25 13:11:06,1453723868,2
5698da7741a9d721002409c3,92953,MRK3480 Forbrukeratferd,1453813240,2016-01-26 14:00:40,1453813241,1
5698da7741a9d721002409c3,98697,MRK3480 Forbrukeratferd,1453890300,2016-01-27 11:25:00,1453890309,9
5698da7741a9d721002409c3,96651,MRK3480 Forbrukeratferd,1453893069,2016-01-27 12:11:09,1453893081,12
5698da7741a9d721002409c3,2632,MRK3480 Forbrukeratferd,1453896884,2016-01-27 13:14:44,1453896901,17
5698da7741a9d721002409c3,54724,MRK3480 Forbrukeratferd,1453899919,2016-01-27 14:05:19,1453899941,22
5698da7741a9d721002409c3,86814,MRK3480 Forbrukeratferd,1454497351,2016-02-03 12:02:31,1454497352,1
5698da7741a9d721002409c3,61613,MRK3480 Forbrukeratferd,1454499820,2016-02-03 12:43:40,1454499821,1
5698da7741a9d721002409c3,33501,MRK3480 Forbrukeratferd,1454851714,2016-02-07 14:28:34,1454851876,162
5698da7741a9d721002409c3,78641,MRK3480 Forbrukeratferd,1455064386,2016-02-10 01:33:06,1455065657,1271
5698da7741a9d721002409c3,48500,MRK3480 Forbrukeratferd,1455110577,2016-02-10 14:22:57,1455110613,36
5698da7741a9d721002409c3,56802,MRK3480 Forbrukeratferd,1455180740,2016-02-11 09:52:20,1455180740,0
5698da7741a9d721002409c3,48656,MRK3480 Forbrukeratferd,1455186415,2016-02-11 11:26:55,1455186416,1
5698da7741a9d721002409c4,30187,MRK3480 Forbrukeratferd,1453046264,2016-01-17 16:57:44,1453046627,363
5698da7741a9d721002409c4,24761,MRK3480 Forbrukeratferd,1453049044,2016-01-17 17:44:04,1453049152,108
5698da7741a9d721002409c4,88652,MRK3480 Forbrukeratferd,1453053378,2016-01-17 18:56:18,1453053387,9
5698da7741a9d721002409c4,71725,MRK3480 Forbrukeratferd,1454067228,2016-01-29 12:33:48,1454067447,219
5698da7741a9d721002409c4,55180,MRK3480 Forbrukeratferd,1454341182,2016-02-01 16:39:42,1454341239,57
5698da7741a9d721002409c5,84024,MRK3480 Forbrukeratferd,1453903912,2016-01-27 15:11:52,1453903913,1
5698da7741a9d721002409c6,51927,MRK3480 Forbrukeratferd,1453370184,2016-01-21 10:56:24,1453370275,91
5698da7741a9d721002409c6,67280,MRK3480 Forbrukeratferd,1453386967,2016-01-21 15:36:07,1453387082,115
5698da7741a9d721002409c6,66796,MRK3480 Forbrukeratferd,1454337982,2016-02-01 15:46:22,1454338349,367
5698da7741a9d721002409c6,33219,MRK3480 Forbrukeratferd,1454543079,2016-02-04 00:44:39,1454543145,66
5698da7741a9d721002409c6,5564,MRK3480 Forbrukeratferd,1454610086,2016-02-04 19:21:26,1454610847,761
5698da7741a9d721002409c6,42777,MRK3480 Forbrukeratferd,1454975159,2016-02-09 00:45:59,1454975232,73
5698da7741a9d721002409c6,25436,MRK3480 Forbrukeratferd,1454983811,2016-02-09 03:10:11,1454983835,24
5698da7741a9d721002409c6,48371,MRK3480 Forbrukeratferd,1455212604,2016-02-11 18:43:24,1455212605,1
5698da7741a9d721002409c6,15896,MRK3480 Forbrukeratferd,1455266307,2016-02-12 09:38:27,1455266457,150
5698da7741a9d721002409c6,19650,MRK3480 Forbrukeratferd,1455286789,2016-02-12 15:19:49,1455286927,138
5698da7741a9d721002409c6,49166,MRK3480 Forbrukeratferd,1455292448,2016-02-12 16:54:08,1455292544,96
5698da7741a9d721002409c6,97405,MRK3480 Forbrukeratferd,1455369253,2016-02-13 14:14:13,1455369253,0
5698da7741a9d721002409ca,50217,MRK3480 Forbrukeratferd,1455020307,2016-02-09 13:18:27,1455020903,596
5698da7741a9d721002409ca,85226,MRK3480 Forbrukeratferd,1455023301,2016-02-09 14:08:21,1455023452,151
5698da782fb0de2600f22bef,87777,MRK3480 Forbrukeratferd,1453149318,2016-01-18 21:35:18,1453149325,7
5698da782fb0de2600f22bef,16168,MRK3480 Forbrukeratferd,1453502112,2016-01-22 23:35:12,1453502129,17
5698da782fb0de2600f22bef,70615,MRK3480 Forbrukeratferd,1453894869,2016-01-27 12:41:09,1453894965,96
5698da782fb0de2600f22bef,28766,MRK3480 Forbrukeratferd,1453920433,2016-01-27 19:47:13,1453920455,22
5698da782fb0de2600f22bef,66234,MRK3480 Forbrukeratferd,1454000658,2016-01-28 18:04:18,1454000682,24
5698da782fb0de2600f22bef,23585,MRK3480 Forbrukeratferd,1454268727,2016-01-31 20:32:07,1454268727,0
5698da782fb0de2600f22bef,95620,MRK3480 Forbrukeratferd,1454517633,2016-02-03 17:40:33,1454518650,1017
5698da782fb0de2600f22bef,58347,MRK3480 Forbrukeratferd,1455231185,2016-02-11 23:53:05,1455231289,104
5698da782fb0de2600f22bef,3327,MRK3480 Forbrukeratferd,1455290727,2016-02-12 16:25:27,1455290746,19
5698da782fb0de2600f22bef,32283,MRK3480 Forbrukeratferd,1455298481,2016-02-12 18:34:41,1455298484,3
5698da782fb0de2600f22bf5,74086,MRK3480 Forbrukeratferd,1453378455,2016-01-21 13:14:15,1453380063,1608
5698da782fb0de2600f22bf5,57092,MRK3480 Forbrukeratferd,1453381498,2016-01-21 14:04:58,1453382297,799
5698da782fb0de2600f22bf5,30732,MRK3480 Forbrukeratferd,1453760976,2016-01-25 23:29:36,1453760976,0
5698da782fb0de2600f22bf5,584,MRK3480 Forbrukeratferd,1453979185,2016-01-28 12:06:25,1453979364,179
5698da782fb0de2600f22bf5,37890,MRK3480 Forbrukeratferd,1453983129,2016-01-28 13:12:09,1453983132,3
5698da782fb0de2600f22bf5,76351,MRK3480 Forbrukeratferd,1453988288,2016-01-28 14:38:08,1453988292,4
5698da782fb0de2600f22bf5,89943,MRK3480 Forbrukeratferd,1454610301,2016-02-04 19:25:01,1454611407,1106
5698da7841a9d721002409d0,94427,MRK3480 Forbrukeratferd,1453309600,2016-01-20 18:06:40,1453309715,115
5698da7841a9d721002409d0,43951,MRK3480 Forbrukeratferd,1454248961,2016-01-31 15:02:41,1454250177,1216
5698da7841a9d721002409d0,35982,MRK3480 Forbrukeratferd,1454264921,2016-01-31 19:28:41,1454265377,456
5698da7841a9d721002409d0,43879,MRK3480 Forbrukeratferd,1454448852,2016-02-02 22:34:12,1454448852,0
5698da7841a9d721002409d2,69242,MRK3480 Forbrukeratferd,1453138841,2016-01-18 18:40:41,1453138930,89
5698da7841a9d721002409d2,16390,MRK3480 Forbrukeratferd,1453203880,2016-01-19 12:44:40,1453205868,1988
5698da7841a9d721002409d2,97596,MRK3480 Forbrukeratferd,1453805608,2016-01-26 11:53:28,1453805670,62
5698da7841a9d721002409d2,48039,MRK3480 Forbrukeratferd,1453906886,2016-01-27 16:01:26,1453907015,129
5698da7841a9d721002409d2,34492,MRK3480 Forbrukeratferd,1453908451,2016-01-27 16:27:31,1453908575,124
5698da7841a9d721002409d2,11664,MRK3480 Forbrukeratferd,1453911346,2016-01-27 17:15:46,1453911349,3
5698da7841a9d721002409d2,42487,MRK3480 Forbrukeratferd,1453912672,2016-01-27 17:37:52,1453912672,0
5698da7841a9d721002409d2,80292,MRK3480 Forbrukeratferd,1454932181,2016-02-08 12:49:41,1454932696,515
5698da792fb0de2600f22c02,72739,MRK3480 Forbrukeratferd,1453109718,2016-01-18 10:35:18,1453109718,0
5698da792fb0de2600f22c02,35891,MRK3480 Forbrukeratferd,1453316092,2016-01-20 19:54:52,1453316145,53
5698da792fb0de2600f22c02,32875,MRK3480 Forbrukeratferd,1453722515,2016-01-25 12:48:35,1453722649,134
5698da792fb0de2600f22c02,23780,MRK3480 Forbrukeratferd,1454000368,2016-01-28 17:59:28,1454000432,64
5698da792fb0de2600f22c02,14681,MRK3480 Forbrukeratferd,1454002888,2016-01-28 18:41:28,1454002891,3
5698da792fb0de2600f22c02,27180,MRK3480 Forbrukeratferd,1454004648,2016-01-28 19:10:48,1454004651,3
5698da792fb0de2600f22c02,77050,MRK3480 Forbrukeratferd,1454601032,2016-02-04 16:50:32,1454601033,1
5698da7a2fb0de2600f22c06,86224,MRK3480 Forbrukeratferd,1453285921,2016-01-20 11:32:01,1453286037,116
5698da7a2fb0de2600f22c06,97418,MRK3480 Forbrukeratferd,1453376622,2016-01-21 12:43:42,1453376626,4
5698da7a2fb0de2600f22c06,17128,MRK3480 Forbrukeratferd,1453378115,2016-01-21 13:08:35,1453378504,389
5698da7a2fb0de2600f22c06,42729,MRK3480 Forbrukeratferd,1453980652,2016-01-28 12:30:52,1453980665,13
5698da7a2fb0de2600f22c06,90538,MRK3480 Forbrukeratferd,1453982936,2016-01-28 13:08:56,1453984649,1713
5698da7a2fb0de2600f22c06,88198,MRK3480 Forbrukeratferd,1454064028,2016-01-29 11:40:28,1454064159,131
5698da7a2fb0de2600f22c06,92271,MRK3480 Forbrukeratferd,1454065547,2016-01-29 12:05:47,1454066455,908
5698da7a2fb0de2600f22c06,77362,MRK3480 Forbrukeratferd,1454881318,2016-02-07 22:41:58,1454881379,61
5698da7a2fb0de2600f22c06,89994,MRK3480 Forbrukeratferd,1455103667,2016-02-10 12:27:47,1455103864,197
5698da7a2fb0de2600f22c06,17296,MRK3480 Forbrukeratferd,1455118255,2016-02-10 16:30:55,1455118341,86
5698da7a2fb0de2600f22c07,84530,MRK3480 Forbrukeratferd,1453727130,2016-01-25 14:05:30,1453727153,23
5698da7a2fb0de2600f22c07,37425,MRK3480 Forbrukeratferd,1454317599,2016-02-01 10:06:39,1454317738,139
5698da7a2fb0de2600f22c07,28816,MRK3480 Forbrukeratferd,1454529205,2016-02-03 20:53:25,1454529205,0
5698da7a2fb0de2600f22c07,25994,MRK3480 Forbrukeratferd,1454882743,2016-02-07 23:05:43,1454882856,113
5698da7a2fb0de2600f22c08,85417,MRK3480 Forbrukeratferd,1453190390,2016-01-19 08:59:50,1453190427,37
5698da7a2fb0de2600f22c08,74382,MRK3480 Forbrukeratferd,1453301284,2016-01-20 15:48:04,1453303356,2072
5698da7a2fb0de2600f22c08,45291,MRK3480 Forbrukeratferd,1455107134,2016-02-10 13:25:34,1455107294,160
5698da7a2fb0de2600f22c08,82475,MRK3480 Forbrukeratferd,1455185764,2016-02-11 11:16:04,1455185781,17
5698da7a2fb0de2600f22c09,13605,MRK3480 Forbrukeratferd,1453228252,2016-01-19 19:30:52,1453228931,679
5698da7a2fb0de2600f22c09,40176,MRK3480 Forbrukeratferd,1453233185,2016-01-19 20:53:05,1453233263,78
5698da7a2fb0de2600f22c09,65188,MRK3480 Forbrukeratferd,1453473806,2016-01-22 15:43:26,1453474104,298
5698da7a2fb0de2600f22c09,77336,MRK3480 Forbrukeratferd,1453480446,2016-01-22 17:34:06,1453480447,1
5698da7a2fb0de2600f22c09,7107,MRK3480 Forbrukeratferd,1453818509,2016-01-26 15:28:29,1453818599,90
5698da7a2fb0de2600f22c09,93925,MRK3480 Forbrukeratferd,1454024468,2016-01-29 00:41:08,1454024499,31
5698da7a2fb0de2600f22c09,94150,MRK3480 Forbrukeratferd,1454027103,2016-01-29 01:25:03,1454027103,0
5698da7a2fb0de2600f22c09,75812,MRK3480 Forbrukeratferd,1454774814,2016-02-06 17:06:54,1454774833,19
5698da7a2fb0de2600f22c09,76188,MRK3480 Forbrukeratferd,1455475519,2016-02-14 19:45:19,1455475840,321
5698da7a2fb0de2600f22c0a,91634,MRK3480 Forbrukeratferd,1453896542,2016-01-27 13:09:02,1453896542,0
5698da7a2fb0de2600f22c0a,33739,MRK3480 Forbrukeratferd,1454251528,2016-01-31 15:45:28,1454251538,10
5698da7a41a9d721002409e7,57942,MRK3480 Forbrukeratferd,1453148490,2016-01-18 21:21:30,1453148545,55
5698da7a41a9d721002409e7,54195,MRK3480 Forbrukeratferd,1453379338,2016-01-21 13:28:58,1453379838,500
5698da7a41a9d721002409e7,92312,MRK3480 Forbrukeratferd,1453382527,2016-01-21 14:22:07,1453382535,8
5698da7a41a9d721002409e7,77867,MRK3480 Forbrukeratferd,1453389836,2016-01-21 16:23:56,1453389836,0
5698da7a41a9d721002409e7,54150,MRK3480 Forbrukeratferd,1453393500,2016-01-21 17:25:00,1453395381,1881
5698da7a41a9d721002409e7,6310,MRK3480 Forbrukeratferd,1453396915,2016-01-21 18:21:55,1453398169,1254
5698da7a41a9d721002409e7,16134,MRK3480 Forbrukeratferd,1453399691,2016-01-21 19:08:11,1453399693,2
5698da7a41a9d721002409e7,98513,MRK3480 Forbrukeratferd,1453494949,2016-01-22 21:35:49,1453494953,4
5698da7a41a9d721002409e7,95136,MRK3480 Forbrukeratferd,1453979055,2016-01-28 12:04:15,1453979718,663
5698da7a41a9d721002409e7,63625,MRK3480 Forbrukeratferd,1454333114,2016-02-01 14:25:14,1454333143,29
5698da7a41a9d721002409e7,70197,MRK3480 Forbrukeratferd,1454512227,2016-02-03 16:10:27,1454512268,41
5698da7a41a9d721002409e7,62554,MRK3480 Forbrukeratferd,1454514735,2016-02-03 16:52:15,1454514766,31
5698da7a41a9d721002409e7,42902,MRK3480 Forbrukeratferd,1454787443,2016-02-06 20:37:23,1454787504,61
5698da7a41a9d721002409e7,17646,MRK3480 Forbrukeratferd,1455275523,2016-02-12 12:12:03,1455275543,20
5698da7a41a9d721002409e7,66599,MRK3480 Forbrukeratferd,1455282626,2016-02-12 14:10:26,1455282672,46
5698da7a41a9d721002409e7,60913,MRK3480 Forbrukeratferd,1455472724,2016-02-14 18:58:44,1455472996,272
5698da7a41a9d721002409e8,88620,MRK3480 Forbrukeratferd,1455287798,2016-02-12 15:36:38,1455287869,71
5698da7a41a9d721002409e9,71496,MRK3480 Forbrukeratferd,1455119375,2016-02-10 16:49:35,1455121840,2465
5698da7a41a9d721002409ea,33144,MRK3480 Forbrukeratferd,1453122556,2016-01-18 14:09:16,1453122590,34
5698da7a41a9d721002409ea,27823,MRK3480 Forbrukeratferd,1453554565,2016-01-23 14:09:25,1453554566,1
5698da7a41a9d721002409ea,87927,MRK3480 Forbrukeratferd,1453653411,2016-01-24 17:36:51,1453653412,1
5698da7a41a9d721002409ea,91453,MRK3480 Forbrukeratferd,1453887086,2016-01-27 10:31:26,1453887134,48
5698da7a41a9d721002409ea,65643,MRK3480 Forbrukeratferd,1453975086,2016-01-28 10:58:06,1453975189,103
5698da7a41a9d721002409ea,8421,MRK3480 Forbrukeratferd,1453979921,2016-01-28 12:18:41,1453979939,18
5698da7a41a9d721002409ea,8198,MRK3480 Forbrukeratferd,1453983991,2016-01-28 13:26:31,1453983993,2
5698da7a41a9d721002409ea,45228,MRK3480 Forbrukeratferd,1454022657,2016-01-29 00:10:57,1454022661,4
5698da7a41a9d721002409ea,12909,MRK3480 Forbrukeratferd,1454249715,2016-01-31 15:15:15,1454249767,52
5698da7a41a9d721002409ea,37787,MRK3480 Forbrukeratferd,1454326642,2016-02-01 12:37:22,1454326644,2
5698da7a41a9d721002409ea,7652,MRK3480 Forbrukeratferd,1454670121,2016-02-05 12:02:01,1454670215,94
5698da7a41a9d721002409ea,20544,MRK3480 Forbrukeratferd,1455007266,2016-02-09 09:41:06,1455007267,1
5698da7a41a9d721002409ea,99779,MRK3480 Forbrukeratferd,1455099862,2016-02-10 11:24:22,1455099863,1
5698da7a41a9d721002409ea,84216,MRK3480 Forbrukeratferd,1455103316,2016-02-10 12:21:56,1455103967,651
5698da7a41a9d721002409ed,4850,MRK3480 Forbrukeratferd,1452863359,2016-01-15 14:09:19,1452863633,274
5698da7a41a9d721002409ed,21780,MRK3480 Forbrukeratferd,1452878427,2016-01-15 18:20:27,1452878850,423
5698da7a41a9d721002409ed,96459,MRK3480 Forbrukeratferd,1453125499,2016-01-18 14:58:19,1453125596,97
5698da7a41a9d721002409ed,55304,MRK3480 Forbrukeratferd,1453230002,2016-01-19 20:00:02,1453230243,241
5698da7a41a9d721002409ed,57309,MRK3480 Forbrukeratferd,1453282257,2016-01-20 10:30:57,1453282258,1
5698da7a41a9d721002409ed,21457,MRK3480 Forbrukeratferd,1453321040,2016-01-20 21:17:20,1453321935,895
5698da7a41a9d721002409ed,42765,MRK3480 Forbrukeratferd,1453325567,2016-01-20 22:32:47,1453325645,78
5698da7a41a9d721002409ed,39266,MRK3480 Forbrukeratferd,1453373784,2016-01-21 11:56:24,1453373785,1
5698da7a41a9d721002409ed,18737,MRK3480 Forbrukeratferd,1453376149,2016-01-21 12:35:49,1453377324,1175
5698da7a41a9d721002409ed,87701,MRK3480 Forbrukeratferd,1453413320,2016-01-21 22:55:20,1453413320,0
5698da7a41a9d721002409ed,34028,MRK3480 Forbrukeratferd,1453589238,2016-01-23 23:47:18,1453589377,139
5698da7a41a9d721002409ed,25692,MRK3480 Forbrukeratferd,1453730335,2016-01-25 14:58:55,1453730343,8
5698da7a41a9d721002409ed,75693,MRK3480 Forbrukeratferd,1453805842,2016-01-26 11:57:22,1453805883,41
5698da7a41a9d721002409ed,53603,MRK3480 Forbrukeratferd,1453941277,2016-01-28 01:34:37,1453941279,2
5698da7a41a9d721002409ed,8459,MRK3480 Forbrukeratferd,1453977876,2016-01-28 11:44:36,1453977998,122
5698da7a41a9d721002409ed,50076,MRK3480 Forbrukeratferd,1454278232,2016-01-31 23:10:32,1454278232,0
5698da7a41a9d721002409ed,79577,MRK3480 Forbrukeratferd,1454333691,2016-02-01 14:34:51,1454333692,1
5698da7a41a9d721002409ed,33368,MRK3480 Forbrukeratferd,1454498757,2016-02-03 12:25:57,1454498793,36
5698da7a41a9d721002409ed,83851,MRK3480 Forbrukeratferd,1454616330,2016-02-04 21:05:30,1454616332,2
5698da7a41a9d721002409ed,20634,MRK3480 Forbrukeratferd,1454629186,2016-02-05 00:39:46,1454629192,6
5698da7a41a9d721002409ed,97654,MRK3480 Forbrukeratferd,1454668705,2016-02-05 11:38:25,1454668725,20
5698da7a41a9d721002409ed,33834,MRK3480 Forbrukeratferd,1454670137,2016-02-05 12:02:17,1454670192,55
5698da7a41a9d721002409ed,29165,MRK3480 Forbrukeratferd,1454679201,2016-02-05 14:33:21,1454679209,8
5698da7a41a9d721002409ed,1684,MRK3480 Forbrukeratferd,1455274704,2016-02-12 11:58:24,1455274763,59
5698da7a41a9d721002409ed,63411,MRK3480 Forbrukeratferd,1455280008,2016-02-12 13:26:48,1455280023,15
5698da7a41a9d721002409ed,64769,MRK3480 Forbrukeratferd,1455281522,2016-02-12 13:52:02,1455281525,3
5698da7a41a9d721002409ed,66147,MRK3480 Forbrukeratferd,1455326778,2016-02-13 02:26:18,1455326778,0
5698da7a41a9d721002409ed,84660,MRK3480 Forbrukeratferd,1455377353,2016-02-13 16:29:13,1455377353,0
5698da7b2fb0de2600f22c15,94275,MRK3480 Forbrukeratferd,1453137667,2016-01-18 18:21:07,1453137683,16
5698da7b2fb0de2600f22c15,10424,MRK3480 Forbrukeratferd,1453980080,2016-01-28 12:21:20,1453980260,180
5698da7b2fb0de2600f22c15,49018,MRK3480 Forbrukeratferd,1453983311,2016-01-28 13:15:11,1453983331,20
5698da7b2fb0de2600f22c15,22971,MRK3480 Forbrukeratferd,1454450225,2016-02-02 22:57:05,1454450280,55
5698da7b2fb0de2600f22c15,56563,MRK3480 Forbrukeratferd,1454947590,2016-02-08 17:06:30,1454947702,112
5698da7b41a9d721002409f3,50808,MRK3480 Forbrukeratferd,1453386679,2016-01-21 15:31:19,1453387000,321
5698da7b41a9d721002409f3,34291,MRK3480 Forbrukeratferd,1453905287,2016-01-27 15:34:47,1453905360,73
5698da7b41a9d721002409f6,14699,MRK3480 Forbrukeratferd,1452861789,2016-01-15 13:43:09,1452861819,30
5698da7b41a9d721002409f6,19133,MRK3480 Forbrukeratferd,1453293597,2016-01-20 13:39:57,1453295904,2307
5698da7b41a9d721002409f6,37648,MRK3480 Forbrukeratferd,1453299263,2016-01-20 15:14:23,1453299265,2
5698da7b41a9d721002409f6,52317,MRK3480 Forbrukeratferd,1453303102,2016-01-20 16:18:22,1453303108,6
5698da7b41a9d721002409f6,84507,MRK3480 Forbrukeratferd,1453323554,2016-01-20 21:59:14,1453323555,1
5698da7b41a9d721002409f6,60114,MRK3480 Forbrukeratferd,1453374552,2016-01-21 12:09:12,1453375886,1334
5698da7b41a9d721002409f6,64279,MRK3480 Forbrukeratferd,1453380217,2016-01-21 13:43:37,1453380240,23
5698da7b41a9d721002409f6,19404,MRK3480 Forbrukeratferd,1453392322,2016-01-21 17:05:22,1453392322,0
5698da7b41a9d721002409f6,61428,MRK3480 Forbrukeratferd,1453463701,2016-01-22 12:55:01,1453463704,3
5698da7b41a9d721002409f6,56415,MRK3480 Forbrukeratferd,1453573164,2016-01-23 19:19:24,1453573165,1
5698da7b41a9d721002409f6,45657,MRK3480 Forbrukeratferd,1453713522,2016-01-25 10:18:42,1453713563,41
5698da7b41a9d721002409f6,25735,MRK3480 Forbrukeratferd,1453728697,2016-01-25 14:31:37,1453728730,33
5698da7b41a9d721002409f6,33415,MRK3480 Forbrukeratferd,1453912726,2016-01-27 17:38:46,1453912785,59
5698da7b41a9d721002409f6,78842,MRK3480 Forbrukeratferd,1454441908,2016-02-02 20:38:28,1454441966,58
5698da7b41a9d721002409f6,96903,MRK3480 Forbrukeratferd,1454586730,2016-02-04 12:52:10,1454586805,75
5698da7b41a9d721002409f6,82684,MRK3480 Forbrukeratferd,1454588164,2016-02-04 13:16:04,1454588165,1
5698da7b41a9d721002409f6,92946,MRK3480 Forbrukeratferd,1454670001,2016-02-05 12:00:01,1454670053,52
5698db5f2fb0de2600f22d4e,90451,ORG3402 Organisasjonsatferd og ledelse,1452863243,2016-01-15 14:07:23,1452863483,240
5698db5f2fb0de2600f22d4e,52353,ORG3402 Organisasjonsatferd og ledelse,1453050375,2016-01-17 18:06:15,1453050894,519
5698db5f2fb0de2600f22d4e,8529,ORG3402 Organisasjonsatferd og ledelse,1453060107,2016-01-17 20:48:27,1453060107,0
5698db5f2fb0de2600f22d4e,48860,ORG3402 Organisasjonsatferd og ledelse,1453075939,2016-01-18 01:12:19,1453076060,121
5698db5f2fb0de2600f22d4e,40997,ORG3402 Organisasjonsatferd og ledelse,1453676690,2016-01-25 00:04:50,1453676691,1
5698db5f2fb0de2600f22d4e,28898,ORG3402 Organisasjonsatferd og ledelse,1454062151,2016-01-29 11:09:11,1454062227,76
5698db5f2fb0de2600f22d4e,66564,ORG3402 Organisasjonsatferd og ledelse,1454070332,2016-01-29 13:25:32,1454070347,15
5698db5f2fb0de2600f22d4e,36138,ORG3402 Organisasjonsatferd og ledelse,1454333617,2016-02-01 14:33:37,1454333849,232
5698db5f2fb0de2600f22d4e,36579,ORG3402 Organisasjonsatferd og ledelse,1454347115,2016-02-01 18:18:35,1454347121,6
5698db5f2fb0de2600f22d4e,81109,ORG3402 Organisasjonsatferd og ledelse,1454922474,2016-02-08 10:07:54,1454922604,130
5698db5f2fb0de2600f22d4e,13564,ORG3402 Organisasjonsatferd og ledelse,1455029078,2016-02-09 15:44:38,1455029079,1
5698db5f2fb0de2600f22d4e,84787,ORG3402 Organisasjonsatferd og ledelse,1455210975,2016-02-11 18:16:15,1455211003,28
5698db5f2fb0de2600f22d4e,62178,ORG3402 Organisasjonsatferd og ledelse,1455393748,2016-02-13 21:02:28,1455393936,188
5698db5f2fb0de2600f22d4e,74419,ORG3402 Organisasjonsatferd og ledelse,1455397914,2016-02-13 22:11:54,1455397936,22
5698db6041a9d72100240bf1,75249,ORG3402 Organisasjonsatferd og ledelse,1453128391,2016-01-18 15:46:31,1453128391,0
5698db6041a9d72100240bf1,52404,ORG3402 Organisasjonsatferd og ledelse,1453129623,2016-01-18 16:07:03,1453130428,805
5698db6041a9d72100240bf1,23672,ORG3402 Organisasjonsatferd og ledelse,1455276862,2016-02-12 12:34:22,1455276967,105
5698db6041a9d72100240bf2,61955,ORG3402 Organisasjonsatferd og ledelse,1454327569,2016-02-01 12:52:49,1454328429,860
5698db6041a9d72100240bf2,92372,ORG3402 Organisasjonsatferd og ledelse,1455211348,2016-02-11 18:22:28,1455213021,1673
5698db6041a9d72100240bf3,63891,ORG3402 Organisasjonsatferd og ledelse,1453725454,2016-01-25 13:37:34,1453725536,82
5698db6041a9d72100240bf3,68140,ORG3402 Organisasjonsatferd og ledelse,1453747252,2016-01-25 19:40:52,1453747252,0
5698db6041a9d72100240bf3,85822,ORG3402 Organisasjonsatferd og ledelse,1453914801,2016-01-27 18:13:21,1453914909,108
5698db6041a9d72100240bf3,96832,ORG3402 Organisasjonsatferd og ledelse,1455051946,2016-02-09 22:05:46,1455052086,140
5698db6041a9d72100240bf4,39476,ORG3402 Organisasjonsatferd og ledelse,1454324620,2016-02-01 12:03:40,1454324620,0
5698db6041a9d72100240bf5,78105,ORG3402 Organisasjonsatferd og ledelse,1454326526,2016-02-01 12:35:26,1454326649,123
5698db6041a9d72100240bf5,34108,ORG3402 Organisasjonsatferd og ledelse,1454327988,2016-02-01 12:59:48,1454328023,35
5698db6041a9d72100240bf6,87639,ORG3402 Organisasjonsatferd og ledelse,1453720077,2016-01-25 12:07:57,1453720213,136
5698db6041a9d72100240bf6,60634,ORG3402 Organisasjonsatferd og ledelse,1453843078,2016-01-26 22:17:58,1453843352,274
5698db6041a9d72100240bf6,55777,ORG3402 Organisasjonsatferd og ledelse,1454850347,2016-02-07 14:05:47,1454850357,10
5698db6041a9d72100240bf6,33009,ORG3402 Organisasjonsatferd og ledelse,1454872804,2016-02-07 20:20:04,1454872804,0
5698db6041a9d72100240bf6,37954,ORG3402 Organisasjonsatferd og ledelse,1455026287,2016-02-09 14:58:07,1455026288,1
5698db6041a9d72100240bf6,44560,ORG3402 Organisasjonsatferd og ledelse,1455029287,2016-02-09 15:48:07,1455030293,1006
5698db6041a9d72100240bf6,99402,ORG3402 Organisasjonsatferd og ledelse,1455039572,2016-02-09 18:39:32,1455039573,1
5698db612fb0de2600f22d51,51057,ORG3402 Organisasjonsatferd og ledelse,1454938837,2016-02-08 14:40:37,1454938838,1
5698db612fb0de2600f22d52,40397,ORG3402 Organisasjonsatferd og ledelse,1453719722,2016-01-25 12:02:02,1453720133,411
5698db612fb0de2600f22d52,64058,ORG3402 Organisasjonsatferd og ledelse,1454324621,2016-02-01 12:03:41,1454324621,0
5698db612fb0de2600f22d52,51072,ORG3402 Organisasjonsatferd og ledelse,1455267329,2016-02-12 09:55:29,1455267330,1
5698db612fb0de2600f22d53,75683,ORG3402 Organisasjonsatferd og ledelse,1453953430,2016-01-28 04:57:10,1453953534,104
5698db612fb0de2600f22d54,86744,ORG3402 Organisasjonsatferd og ledelse,1453195847,2016-01-19 10:30:47,1453196533,686
5698db612fb0de2600f22d54,18765,ORG3402 Organisasjonsatferd og ledelse,1453220367,2016-01-19 17:19:27,1453220375,8
5698db612fb0de2600f22d54,96390,ORG3402 Organisasjonsatferd og ledelse,1453574946,2016-01-23 19:49:06,1453575011,65
5698db612fb0de2600f22d55,85579,ORG3402 Organisasjonsatferd og ledelse,1455177932,2016-02-11 09:05:32,1455178943,1011
5698db612fb0de2600f22d55,4472,ORG3402 Organisasjonsatferd og ledelse,1455370983,2016-02-13 14:43:03,1455370989,6
5698db612fb0de2600f22d59,90813,ORG3402 Organisasjonsatferd og ledelse,1453237371,2016-01-19 22:02:51,1453237458,87
5698db612fb0de2600f22d59,94094,ORG3402 Organisasjonsatferd og ledelse,1454330655,2016-02-01 13:44:15,1454330750,95
5698db612fb0de2600f22d5a,16401,ORG3402 Organisasjonsatferd og ledelse,1453719881,2016-01-25 12:04:41,1453720366,485
5698db6141a9d72100240bf7,65750,ORG3402 Organisasjonsatferd og ledelse,1453120457,2016-01-18 13:34:17,1453120777,320
5698db6141a9d72100240bf7,46021,ORG3402 Organisasjonsatferd og ledelse,1453808150,2016-01-26 12:35:50,1453808182,32
5698db6241a9d72100240c19,4540,ORG3402 Organisasjonsatferd og ledelse,1454328764,2016-02-01 13:12:44,1454328764,0
5698db6241a9d72100240c19,60261,ORG3402 Organisasjonsatferd og ledelse,1454336487,2016-02-01 15:21:27,1454336540,53
5698db632fb0de2600f22d78,5769,ORG3402 Organisasjonsatferd og ledelse,1453144409,2016-01-18 20:13:29,1453144451,42
5698db632fb0de2600f22d78,97679,ORG3402 Organisasjonsatferd og ledelse,1453498464,2016-01-22 22:34:24,1453498465,1
5698db632fb0de2600f22d79,93057,ORG3402 Organisasjonsatferd og ledelse,1452863084,2016-01-15 14:04:44,1452863163,79
5698db632fb0de2600f22d79,54814,ORG3402 Organisasjonsatferd og ledelse,1453050804,2016-01-17 18:13:24,1453050844,40
5698db632fb0de2600f22d79,95003,ORG3402 Organisasjonsatferd og ledelse,1453128323,2016-01-18 15:45:23,1453128326,3
5698db632fb0de2600f22d79,28263,ORG3402 Organisasjonsatferd og ledelse,1453287349,2016-01-20 11:55:49,1453287353,4
5698db632fb0de2600f22d79,29913,ORG3402 Organisasjonsatferd og ledelse,1453294249,2016-01-20 13:50:49,1453294250,1
5698db632fb0de2600f22d79,74117,ORG3402 Organisasjonsatferd og ledelse,1453668559,2016-01-24 21:49:19,1453668565,6
5698db632fb0de2600f22d79,46750,ORG3402 Organisasjonsatferd og ledelse,1453709563,2016-01-25 09:12:43,1453709565,2
5698db632fb0de2600f22d79,34593,ORG3402 Organisasjonsatferd og ledelse,1454255232,2016-01-31 16:47:12,1454255693,461
5698db632fb0de2600f22d7b,91293,ORG3402 Organisasjonsatferd og ledelse,1453720215,2016-01-25 12:10:15,1453720259,44
5698db632fb0de2600f22d7b,89471,ORG3402 Organisasjonsatferd og ledelse,1454527359,2016-02-03 20:22:39,1454527831,472
5698db632fb0de2600f22d7b,68361,ORG3402 Organisasjonsatferd og ledelse,1455051497,2016-02-09 21:58:17,1455051498,1
5698db632fb0de2600f22d7c,18145,ORG3402 Organisasjonsatferd og ledelse,1453720075,2016-01-25 12:07:55,1453720534,459
5698db632fb0de2600f22d7c,58660,ORG3402 Organisasjonsatferd og ledelse,1455093693,2016-02-10 09:41:33,1455093693,0
5698db6341a9d72100240c1b,15892,ORG3402 Organisasjonsatferd og ledelse,1453646973,2016-01-24 15:49:33,1453647123,150
5698db6341a9d72100240c1b,58312,ORG3402 Organisasjonsatferd og ledelse,1454972837,2016-02-09 00:07:17,1454973056,219
5698db6341a9d72100240c1d,69605,ORG3402 Organisasjonsatferd og ledelse,1454606714,2016-02-04 18:25:14,1454606906,192
5698db6341a9d72100240c1d,880,ORG3402 Organisasjonsatferd og ledelse,1454931113,2016-02-08 12:31:53,1454931460,347
5698db6341a9d72100240c1d,51135,ORG3402 Organisasjonsatferd og ledelse,1454938087,2016-02-08 14:28:07,1454938191,104
5698db6341a9d72100240c1d,65954,nan,1455021085,2016-02-09 13:31:25,1455021086,1
5698db6341a9d72100240c1d,26748,ORG3402 Organisasjonsatferd og ledelse,1455054579,2016-02-09 22:49:39,1455054693,114
5698db6341a9d72100240c1d,60909,ORG3402 Organisasjonsatferd og ledelse,1455283163,2016-02-12 14:19:23,1455283178,15
5698db6341a9d72100240c1e,1079,ORG3402 Organisasjonsatferd og ledelse,1453148772,2016-01-18 21:26:12,1453148939,167
5698db6341a9d72100240c1e,76692,ORG3402 Organisasjonsatferd og ledelse,1453719521,2016-01-25 11:58:41,1453720781,1260
5698db6341a9d72100240c1e,16304,ORG3402 Organisasjonsatferd og ledelse,1453723968,2016-01-25 13:12:48,1453723971,3
5698db6341a9d72100240c1e,32367,ORG3402 Organisasjonsatferd og ledelse,1454314177,2016-02-01 09:09:37,1454314193,16
5698db6341a9d72100240c1e,60193,ORG3402 Organisasjonsatferd og ledelse,1455015484,2016-02-09 11:58:04,1455015559,75
5698db642fb0de2600f22d7d,25180,ORG3402 Organisasjonsatferd og ledelse,1453108190,2016-01-18 10:09:50,1453108244,54
5698db642fb0de2600f22d7d,99856,ORG3402 Organisasjonsatferd og ledelse,1453115109,2016-01-18 12:05:09,1453115171,62
5698db642fb0de2600f22d7d,97000,ORG3402 Organisasjonsatferd og ledelse,1453654550,2016-01-24 17:55:50,1453655890,1340
5698db642fb0de2600f22d7d,69116,ORG3402 Organisasjonsatferd og ledelse,1453669974,2016-01-24 22:12:54,1453669974,0
5698db642fb0de2600f22d7d,30264,ORG3402 Organisasjonsatferd og ledelse,1454252375,2016-01-31 15:59:35,1454252439,64
5698db642fb0de2600f22d7d,33242,ORG3402 Organisasjonsatferd og ledelse,1454855245,2016-02-07 15:27:25,1454855255,10
5698db642fb0de2600f22d7e,66587,ORG3402 Organisasjonsatferd og ledelse,1452865107,2016-01-15 14:38:27,1452865152,45
5698db642fb0de2600f22d7e,67111,ORG3402 Organisasjonsatferd og ledelse,1453129259,2016-01-18 16:00:59,1453129291,32
5698db642fb0de2600f22d7e,23778,ORG3402 Organisasjonsatferd og ledelse,1453202461,2016-01-19 12:21:01,1453202758,297
5698db642fb0de2600f22d7e,73352,ORG3402 Organisasjonsatferd og ledelse,1453212558,2016-01-19 15:09:18,1453212560,2
5698db642fb0de2600f22d7e,69533,ORG3402 Organisasjonsatferd og ledelse,1453659349,2016-01-24 19:15:49,1453659385,36
5698db642fb0de2600f22d7e,85538,ORG3402 Organisasjonsatferd og ledelse,1453670681,2016-01-24 22:24:41,1453670685,4
5698db642fb0de2600f22d7e,45771,ORG3402 Organisasjonsatferd og ledelse,1453680767,2016-01-25 01:12:47,1453680767,0
5698db642fb0de2600f22d7e,31174,ORG3402 Organisasjonsatferd og ledelse,1453918014,2016-01-27 19:06:54,1453918069,55
5698db642fb0de2600f22d7e,87739,ORG3402 Organisasjonsatferd og ledelse,1454330722,2016-02-01 13:45:22,1454330799,77
5698db642fb0de2600f22d7e,79407,ORG3402 Organisasjonsatferd og ledelse,1454346120,2016-02-01 18:02:00,1454346123,3
5698db642fb0de2600f22d7e,92771,ORG3402 Organisasjonsatferd og ledelse,1454520253,2016-02-03 18:24:13,1454520386,133
5698db642fb0de2600f22d7e,49431,ORG3402 Organisasjonsatferd og ledelse,1454880960,2016-02-07 22:36:00,1454880999,39
5698db642fb0de2600f22d7e,98126,ORG3402 Organisasjonsatferd og ledelse,1454938556,2016-02-08 14:35:56,1454938570,14
5698db642fb0de2600f22d7e,67450,ORG3402 Organisasjonsatferd og ledelse,1455016884,2016-02-09 12:21:24,1455016984,100
5698db642fb0de2600f22d83,34919,ORG3402 Organisasjonsatferd og ledelse,1455032403,2016-02-09 16:40:03,1455032855,452
5698db642fb0de2600f22d83,46682,ORG3402 Organisasjonsatferd og ledelse,1455104442,2016-02-10 12:40:42,1455104444,2
5698db642fb0de2600f22d85,35884,ORG3402 Organisasjonsatferd og ledelse,1454273673,2016-01-31 21:54:33,1454273783,110
5698db642fb0de2600f22d85,23605,ORG3402 Organisasjonsatferd og ledelse,1454288657,2016-02-01 02:04:17,1454288657,0
5698db642fb0de2600f22d85,40265,ORG3402 Organisasjonsatferd og ledelse,1454496062,2016-02-03 11:41:02,1454496291,229
5698db642fb0de2600f22d85,18460,ORG3402 Organisasjonsatferd og ledelse,1455452965,2016-02-14 13:29:25,1455453267,302
5698db6441a9d72100240c20,46508,ORG3402 Organisasjonsatferd og ledelse,1453794681,2016-01-26 08:51:21,1453794787,106
5698db6441a9d72100240c20,57009,ORG3402 Organisasjonsatferd og ledelse,1454923745,2016-02-08 10:29:05,1454923850,105
5698db6441a9d72100240c20,7775,ORG3402 Organisasjonsatferd og ledelse,1455022228,2016-02-09 13:50:28,1455022228,0
5698db6441a9d72100240c21,16038,ORG3402 Organisasjonsatferd og ledelse,1453650928,2016-01-24 16:55:28,1453651258,330
5698db6441a9d72100240c21,38511,ORG3402 Organisasjonsatferd og ledelse,1453719694,2016-01-25 12:01:34,1453720126,432
5698db6441a9d72100240c21,71890,ORG3402 Organisasjonsatferd og ledelse,1453728126,2016-01-25 14:22:06,1453728157,31
5698db6441a9d72100240c21,37808,ORG3402 Organisasjonsatferd og ledelse,1454324436,2016-02-01 12:00:36,1454325623,1187
5698db6441a9d72100240c21,68000,ORG3402 Organisasjonsatferd og ledelse,1455471230,2016-02-14 18:33:50,1455471230,0
5698db6441a9d72100240c21,4943,ORG3402 Organisasjonsatferd og ledelse,1455484859,2016-02-14 22:20:59,1455484884,25
5698db6441a9d72100240c2b,15504,ORG3402 Organisasjonsatferd og ledelse,1452865970,2016-01-15 14:52:50,1452866015,45
5698db6441a9d72100240c2b,35359,ORG3402 Organisasjonsatferd og ledelse,1453115104,2016-01-18 12:05:04,1453115496,392
5698db6441a9d72100240c2b,98238,ORG3402 Organisasjonsatferd og ledelse,1453119318,2016-01-18 13:15:18,1453119374,56
5698db6441a9d72100240c2b,92228,ORG3402 Organisasjonsatferd og ledelse,1454337482,2016-02-01 15:38:02,1454337507,25
5698db6541a9d72100240c42,11151,ORG3402 Organisasjonsatferd og ledelse,1453070072,2016-01-17 23:34:32,1453070082,10
5698db6541a9d72100240c42,82963,ORG3402 Organisasjonsatferd og ledelse,1453720204,2016-01-25 12:10:04,1453720249,45
5698db6541a9d72100240c42,77495,ORG3402 Organisasjonsatferd og ledelse,1453723464,2016-01-25 13:04:24,1453723748,284
5698db6541a9d72100240c42,45015,ORG3402 Organisasjonsatferd og ledelse,1453728235,2016-01-25 14:23:55,1453729385,1150
5698db6541a9d72100240c42,86792,ORG3402 Organisasjonsatferd og ledelse,1454376480,2016-02-02 02:28:00,1454376561,81
5698db6541a9d72100240c42,11278,ORG3402 Organisasjonsatferd og ledelse,1454944499,2016-02-08 16:14:59,1454944513,14
5698db6541a9d72100240c42,65908,ORG3402 Organisasjonsatferd og ledelse,1455101598,2016-02-10 11:53:18,1455101613,15
5698db6541a9d72100240c42,16076,ORG3402 Organisasjonsatferd og ledelse,1455215219,2016-02-11 19:26:59,1455215577,358
5698db6541a9d72100240c42,7430,ORG3402 Organisasjonsatferd og ledelse,1455285871,2016-02-12 15:04:31,1455285879,8
5698db662fb0de2600f22da1,62347,ORG3402 Organisasjonsatferd og ledelse,1453116022,2016-01-18 12:20:22,1453116846,824
5698db662fb0de2600f22da1,6700,ORG3402 Organisasjonsatferd og ledelse,1453119295,2016-01-18 13:14:55,1453119370,75
5698db662fb0de2600f22da1,26007,ORG3402 Organisasjonsatferd og ledelse,1453123115,2016-01-18 14:18:35,1453123854,739
5698db662fb0de2600f22da1,63326,ORG3402 Organisasjonsatferd og ledelse,1453151758,2016-01-18 22:15:58,1453151758,0
5698db662fb0de2600f22da2,32776,ORG3402 Organisasjonsatferd og ledelse,1453124490,2016-01-18 14:41:30,1453124614,124
5698db662fb0de2600f22da2,96137,ORG3402 Organisasjonsatferd og ledelse,1453239493,2016-01-19 22:38:13,1453239497,4
5698db662fb0de2600f22da2,61032,ORG3402 Organisasjonsatferd og ledelse,1455049510,2016-02-09 21:25:10,1455049540,30
5698db662fb0de2600f22da3,15040,ORG3402 Organisasjonsatferd og ledelse,1453120296,2016-01-18 13:31:36,1453120487,191
5698db662fb0de2600f22da3,10968,ORG3402 Organisasjonsatferd og ledelse,1453122364,2016-01-18 14:06:04,1453122836,472
5698db662fb0de2600f22da3,27552,ORG3402 Organisasjonsatferd og ledelse,1453720041,2016-01-25 12:07:21,1453721563,1522
5698db662fb0de2600f22da3,97837,ORG3402 Organisasjonsatferd og ledelse,1453728365,2016-01-25 14:26:05,1453728369,4
5698db662fb0de2600f22da3,10809,ORG3402 Organisasjonsatferd og ledelse,1454330686,2016-02-01 13:44:46,1454330687,1
5698db662fb0de2600f22da3,27109,ORG3402 Organisasjonsatferd og ledelse,1454332228,2016-02-01 14:10:28,1454332656,428
5698db6641a9d72100240c43,3069,ORG3402 Organisasjonsatferd og ledelse,1453052943,2016-01-17 18:49:03,1453053167,224
5698db6641a9d72100240c43,24813,ORG3402 Organisasjonsatferd og ledelse,1453393753,2016-01-21 17:29:13,1453393774,21
5698db6641a9d72100240c43,73092,ORG3402 Organisasjonsatferd og ledelse,1453665774,2016-01-24 21:02:54,1453665798,24
5698db6641a9d72100240c43,52660,ORG3402 Organisasjonsatferd og ledelse,1453983439,2016-01-28 13:17:19,1453983651,212
5698db6641a9d72100240c43,28936,ORG3402 Organisasjonsatferd og ledelse,1454018567,2016-01-28 23:02:47,1454018600,33
5698db6641a9d72100240c44,10778,ORG3402 Organisasjonsatferd og ledelse,1453053963,2016-01-17 19:06:03,1453054220,257
5698db6641a9d72100240c44,36832,ORG3402 Organisasjonsatferd og ledelse,1454317330,2016-02-01 10:02:10,1454317918,588
5698db6641a9d72100240c44,11661,ORG3402 Organisasjonsatferd og ledelse,1455016832,2016-02-09 12:20:32,1455016889,57
5698db6641a9d72100240c46,57132,ORG3402 Organisasjonsatferd og ledelse,1452989750,2016-01-17 01:15:50,1452990064,314
5698db6641a9d72100240c46,8376,ORG3402 Organisasjonsatferd og ledelse,1454090186,2016-01-29 18:56:26,1454092246,2060
5698db6641a9d72100240c46,4011,ORG3402 Organisasjonsatferd og ledelse,1454093750,2016-01-29 19:55:50,1454093750,0
5698db6641a9d72100240c46,93460,ORG3402 Organisasjonsatferd og ledelse,1454335681,2016-02-01 15:08:01,1454335936,255
5698db6641a9d72100240c47,91133,ORG3402 Organisasjonsatferd og ledelse,1454354108,2016-02-01 20:15:08,1454354172,64
5698db6641a9d72100240c47,26525,ORG3402 Organisasjonsatferd og ledelse,1454357725,2016-02-01 21:15:25,1454357758,33
5698db672fb0de2600f22da4,43362,ORG3402 Organisasjonsatferd og ledelse,1452862815,2016-01-15 14:00:15,1452862882,67
5698db672fb0de2600f22da4,48415,ORG3402 Organisasjonsatferd og ledelse,1452870850,2016-01-15 16:14:10,1452870852,2
5698db672fb0de2600f22da4,46911,ORG3402 Organisasjonsatferd og ledelse,1453065164,2016-01-17 22:12:44,1453065172,8
5698db672fb0de2600f22da4,42758,ORG3402 Organisasjonsatferd og ledelse,1453126950,2016-01-18 15:22:30,1453126951,1
5698db672fb0de2600f22da4,99583,ORG3402 Organisasjonsatferd og ledelse,1453220227,2016-01-19 17:17:07,1453220263,36
5698db672fb0de2600f22da4,49200,ORG3402 Organisasjonsatferd og ledelse,1453289977,2016-01-20 12:39:37,1453289985,8
5698db672fb0de2600f22da4,15419,ORG3402 Organisasjonsatferd og ledelse,1453639694,2016-01-24 13:48:14,1453639704,10
5698db672fb0de2600f22da4,24039,ORG3402 Organisasjonsatferd og ledelse,1453670268,2016-01-24 22:17:48,1453670274,6
5698db672fb0de2600f22da4,28059,ORG3402 Organisasjonsatferd og ledelse,1453676849,2016-01-25 00:07:29,1453676850,1
5698db672fb0de2600f22da4,40609,ORG3402 Organisasjonsatferd og ledelse,1453720893,2016-01-25 12:21:33,1453720901,8
5698db672fb0de2600f22da4,83248,ORG3402 Organisasjonsatferd og ledelse,1453730193,2016-01-25 14:56:33,1453730194,1
5698db672fb0de2600f22da4,35881,ORG3402 Organisasjonsatferd og ledelse,1454081614,2016-01-29 16:33:34,1454081628,14
5698db672fb0de2600f22da4,70571,ORG3402 Organisasjonsatferd og ledelse,1454423400,2016-02-02 15:30:00,1454423400,0
5698db672fb0de2600f22da4,30198,ORG3402 Organisasjonsatferd og ledelse,1454847248,2016-02-07 13:14:08,1454847248,0
5698db672fb0de2600f22da4,39023,ORG3402 Organisasjonsatferd og ledelse,1455015276,2016-02-09 11:54:36,1455016339,1063
5698db672fb0de2600f22da4,77063,ORG3402 Organisasjonsatferd og ledelse,1455108784,2016-02-10 13:53:04,1455109742,958
5698db672fb0de2600f22da4,4858,ORG3402 Organisasjonsatferd og ledelse,1455111137,2016-02-10 14:32:17,1455111189,52
5698db672fb0de2600f22da4,12110,ORG3402 Organisasjonsatferd og ledelse,1455117297,2016-02-10 16:14:57,1455117332,35
5698db672fb0de2600f22da4,88105,ORG3402 Organisasjonsatferd og ledelse,1455280919,2016-02-12 13:41:59,1455280919,0
5698db672fb0de2600f22da4,45739,ORG3402 Organisasjonsatferd og ledelse,1455291375,2016-02-12 16:36:15,1455291397,22
5698db672fb0de2600f22da4,46556,ORG3402 Organisasjonsatferd og ledelse,1455297441,2016-02-12 18:17:21,1455297712,271
5698db672fb0de2600f22da5,62463,ORG3402 Organisasjonsatferd og ledelse,1453125682,2016-01-18 15:01:22,1453125720,38
5698db672fb0de2600f22da5,71009,ORG3402 Organisasjonsatferd og ledelse,1454929150,2016-02-08 11:59:10,1454930168,1018
5698db672fb0de2600f22da5,76773,ORG3402 Organisasjonsatferd og ledelse,1454931722,2016-02-08 12:42:02,1454931722,0
5698db672fb0de2600f22da6,98309,ORG3402 Organisasjonsatferd og ledelse,1454776910,2016-02-06 17:41:50,1454777230,320
5698db6741a9d72100240c4c,29698,ORG3402 Organisasjonsatferd og ledelse,1454322783,2016-02-01 11:33:03,1454322830,47
5698db6741a9d72100240c4c,97365,ORG3402 Organisasjonsatferd og ledelse,1454324451,2016-02-01 12:00:51,1454324453,2
5698db6741a9d72100240c4c,10316,ORG3402 Organisasjonsatferd og ledelse,1454503996,2016-02-03 13:53:16,1454504053,57
5698db6741a9d72100240c4c,1070,ORG3402 Organisasjonsatferd og ledelse,1455196376,2016-02-11 14:12:56,1455196484,108
5698db6741a9d72100240c4c,63759,ORG3402 Organisasjonsatferd og ledelse,1455229543,2016-02-11 23:25:43,1455229621,78
5698db6741a9d72100240c4c,36931,ORG3402 Organisasjonsatferd og ledelse,1455360236,2016-02-13 11:43:56,1455360236,0
5698db6741a9d72100240c4c,22139,ORG3402 Organisasjonsatferd og ledelse,1455471902,2016-02-14 18:45:02,1455472941,1039
5698db6741a9d72100240c4c,18240,ORG3402 Organisasjonsatferd og ledelse,1455486993,2016-02-14 22:56:33,1455486993,0
5698db6741a9d72100240c4c,17871,ORG3402 Organisasjonsatferd og ledelse,1455488308,2016-02-14 23:18:28,1455488347,39
5698db6741a9d72100240c4c,9433,ORG3402 Organisasjonsatferd og ledelse,1455490889,2016-02-15 00:01:29,1455490901,12
5698db6741a9d72100240c4f,77219,ORG3402 Organisasjonsatferd og ledelse,1453923602,2016-01-27 20:40:02,1453923690,88
5698db6741a9d72100240c4f,76949,ORG3402 Organisasjonsatferd og ledelse,1453982018,2016-01-28 12:53:38,1453982018,0
5698db6741a9d72100240c4f,72997,ORG3402 Organisasjonsatferd og ledelse,1454270565,2016-01-31 21:02:45,1454270565,0
5698db6741a9d72100240c4f,19256,ORG3402 Organisasjonsatferd og ledelse,1454316952,2016-02-01 09:55:52,1454316954,2
5698db6741a9d72100240c4f,94461,ORG3402 Organisasjonsatferd og ledelse,1454330658,2016-02-01 13:44:18,1454330663,5
5698db6741a9d72100240c4f,75272,ORG3402 Organisasjonsatferd og ledelse,1455053942,2016-02-09 22:39:02,1455053943,1
5698db6741a9d72100240c4f,25878,ORG3402 Organisasjonsatferd og ledelse,1455095741,2016-02-10 10:15:41,1455095741,0
5698db682fb0de2600f22da9,18206,ORG3402 Organisasjonsatferd og ledelse,1453039680,2016-01-17 15:08:00,1453041019,1339
5698db682fb0de2600f22da9,57103,ORG3402 Organisasjonsatferd og ledelse,1453148385,2016-01-18 21:19:45,1453148689,304
5698db682fb0de2600f22da9,15454,ORG3402 Organisasjonsatferd og ledelse,1453377362,2016-01-21 12:56:02,1453377363,1
5698db682fb0de2600f22da9,74465,ORG3402 Organisasjonsatferd og ledelse,1453653621,2016-01-24 17:40:21,1453653629,8
5698db682fb0de2600f22da9,29596,ORG3402 Organisasjonsatferd og ledelse,1453670288,2016-01-24 22:18:08,1453670301,13
5698db682fb0de2600f22da9,66366,ORG3402 Organisasjonsatferd og ledelse,1453910622,2016-01-27 17:03:42,1453910622,0
5698db682fb0de2600f22da9,83555,ORG3402 Organisasjonsatferd og ledelse,1453982477,2016-01-28 13:01:17,1453982477,0
5698db682fb0de2600f22da9,73859,ORG3402 Organisasjonsatferd og ledelse,1454002231,2016-01-28 18:30:31,1454002232,1
5698db682fb0de2600f22da9,62155,ORG3402 Organisasjonsatferd og ledelse,1454084196,2016-01-29 17:16:36,1454084196,0
5698db682fb0de2600f22da9,28254,ORG3402 Organisasjonsatferd og ledelse,1454091119,2016-01-29 19:11:59,1454091119,0
5698db682fb0de2600f22da9,44786,ORG3402 Organisasjonsatferd og ledelse,1454277089,2016-01-31 22:51:29,1454277128,39
5698db682fb0de2600f22da9,53964,ORG3402 Organisasjonsatferd og ledelse,1454967773,2016-02-08 22:42:53,1454967780,7
5698db682fb0de2600f22da9,63115,ORG3402 Organisasjonsatferd og ledelse,1455018104,2016-02-09 12:41:44,1455019703,1599
5698db682fb0de2600f22da9,85790,ORG3402 Organisasjonsatferd og ledelse,1455202320,2016-02-11 15:52:00,1455203151,831
5698db682fb0de2600f22daa,17014,ORG3402 Organisasjonsatferd og ledelse,1453113467,2016-01-18 11:37:47,1453113554,87
5698db682fb0de2600f22daa,42996,ORG3402 Organisasjonsatferd og ledelse,1455183373,2016-02-11 10:36:13,1455183393,20
5698db6841a9d72100240c53,30803,ORG3402 Organisasjonsatferd og ledelse,1452876007,2016-01-15 17:40:07,1452876007,0
5698db6841a9d72100240c53,2008,ORG3402 Organisasjonsatferd og ledelse,1453115071,2016-01-18 12:04:31,1453115423,352
5698db6841a9d72100240c53,24803,ORG3402 Organisasjonsatferd og ledelse,1453575906,2016-01-23 20:05:06,1453576199,293
5698db6841a9d72100240c53,8358,ORG3402 Organisasjonsatferd og ledelse,1453718058,2016-01-25 11:34:18,1453718085,27
5698db6841a9d72100240c53,80900,ORG3402 Organisasjonsatferd og ledelse,1453749060,2016-01-25 20:11:00,1453749060,0
5698db6841a9d72100240c53,10748,ORG3402 Organisasjonsatferd og ledelse,1454087630,2016-01-29 18:13:50,1454089648,2018
5698db6841a9d72100240c53,65975,ORG3402 Organisasjonsatferd og ledelse,1455048512,2016-02-09 21:08:32,1455049470,958
5698db6941a9d72100240c6c,81450,ORG3402 Organisasjonsatferd og ledelse,1455026288,2016-02-09 14:58:08,1455026577,289
5698db6941a9d72100240c6d,69004,ORG3402 Organisasjonsatferd og ledelse,1453239552,2016-01-19 22:39:12,1453239632,80
5698db6941a9d72100240c6d,59771,ORG3402 Organisasjonsatferd og ledelse,1453922303,2016-01-27 20:18:23,1453922481,178
5698db6941a9d72100240c6d,90705,ORG3402 Organisasjonsatferd og ledelse,1454029864,2016-01-29 02:11:04,1454029865,1
5698db6941a9d72100240c6d,34786,ORG3402 Organisasjonsatferd og ledelse,1454455910,2016-02-03 00:31:50,1454456846,936
5698db6941a9d72100240c6d,75419,ORG3402 Organisasjonsatferd og ledelse,1454517921,2016-02-03 17:45:21,1454517921,0
5698db6941a9d72100240c6d,39687,ORG3402 Organisasjonsatferd og ledelse,1455464704,2016-02-14 16:45:04,1455464704,0
5698db6941a9d72100240c6d,59403,ORG3402 Organisasjonsatferd og ledelse,1455468233,2016-02-14 17:43:53,1455468233,0
5698db6a2fb0de2600f22dc9,16748,ORG3402 Organisasjonsatferd og ledelse,1453117602,2016-01-18 12:46:42,1453117759,157
5698db6a2fb0de2600f22dc9,68694,ORG3402 Organisasjonsatferd og ledelse,1453123845,2016-01-18 14:30:45,1453123876,31
5698db6a2fb0de2600f22dc9,11670,ORG3402 Organisasjonsatferd og ledelse,1453719823,2016-01-25 12:03:43,1453720034,211
5698db6a2fb0de2600f22dc9,26326,ORG3402 Organisasjonsatferd og ledelse,1454329628,2016-02-01 13:27:08,1454329637,9
5698db6a2fb0de2600f22dc9,21401,ORG3402 Organisasjonsatferd og ledelse,1454333107,2016-02-01 14:25:07,1454333722,615
5698db6a2fb0de2600f22dc9,72416,ORG3402 Organisasjonsatferd og ledelse,1454929863,2016-02-08 12:11:03,1454930102,239
5698db6a2fb0de2600f22dc9,59696,ORG3402 Organisasjonsatferd og ledelse,1454936262,2016-02-08 13:57:42,1454936277,15
5698db6a2fb0de2600f22dc9,17832,ORG3402 Organisasjonsatferd og ledelse,1455115746,2016-02-10 15:49:06,1455115851,105
5698db6a2fb0de2600f22dc9,32280,ORG3402 Organisasjonsatferd og ledelse,1455204689,2016-02-11 16:31:29,1455204751,62
5698db6a2fb0de2600f22dcc,52819,ORG3402 Organisasjonsatferd og ledelse,1453310482,2016-01-20 18:21:22,1453310576,94
5698db6a2fb0de2600f22dcc,6338,ORG3402 Organisasjonsatferd og ledelse,1453475925,2016-01-22 16:18:45,1453476013,88
5698db6a2fb0de2600f22dcc,679,ORG3402 Organisasjonsatferd og ledelse,1453660354,2016-01-24 19:32:34,1453661217,863
5698db6a2fb0de2600f22dcc,5551,ORG3402 Organisasjonsatferd og ledelse,1454070466,2016-01-29 13:27:46,1454070523,57
5698db6a2fb0de2600f22dcc,93147,ORG3402 Organisasjonsatferd og ledelse,1454358551,2016-02-01 21:29:11,1454358551,0
5698db6a2fb0de2600f22dcc,74355,ORG3402 Organisasjonsatferd og ledelse,1454623340,2016-02-04 23:02:20,1454623348,8
5698db6a2fb0de2600f22dcc,33709,ORG3402 Organisasjonsatferd og ledelse,1454762944,2016-02-06 13:49:04,1454762961,17
5698db6a2fb0de2600f22dcc,35042,ORG3402 Organisasjonsatferd og ledelse,1455363492,2016-02-13 12:38:12,1455364954,1462
5698db6a2fb0de2600f22dcd,28869,ORG3402 Organisasjonsatferd og ledelse,1452862413,2016-01-15 13:53:33,1452862414,1
5698db6a2fb0de2600f22dce,99305,ORG3402 Organisasjonsatferd og ledelse,1453148524,2016-01-18 21:22:04,1453148579,55
5698db6a2fb0de2600f22dce,16154,ORG3402 Organisasjonsatferd og ledelse,1453806046,2016-01-26 12:00:46,1453806084,38
5698db6a2fb0de2600f22dce,69928,ORG3402 Organisasjonsatferd og ledelse,1453812885,2016-01-26 13:54:45,1453813987,1102
5698db6a2fb0de2600f22dce,28382,ORG3402 Organisasjonsatferd og ledelse,1454539530,2016-02-03 23:45:30,1454539568,38
5698db6a2fb0de2600f22dce,12094,ORG3402 Organisasjonsatferd og ledelse,1454961259,2016-02-08 20:54:19,1454961363,104
5698db6a2fb0de2600f22dce,14355,ORG3402 Organisasjonsatferd og ledelse,1455110918,2016-02-10 14:28:38,1455111395,477
5698db6a41a9d72100240c6f,69207,ORG3402 Organisasjonsatferd og ledelse,1453210592,2016-01-19 14:36:32,1453210742,150
5698db6a41a9d72100240c6f,9954,ORG3402 Organisasjonsatferd og ledelse,1453459364,2016-01-22 11:42:44,1453459372,8
5698db6a41a9d72100240c6f,89484,ORG3402 Organisasjonsatferd og ledelse,1453643665,2016-01-24 14:54:25,1453644988,1323
5698db6a41a9d72100240c6f,78753,ORG3402 Organisasjonsatferd og ledelse,1453900273,2016-01-27 14:11:13,1453900302,29
5698db6a41a9d72100240c6f,92665,ORG3402 Organisasjonsatferd og ledelse,1453914395,2016-01-27 18:06:35,1453914459,64
5698db6a41a9d72100240c6f,19636,ORG3402 Organisasjonsatferd og ledelse,1454331584,2016-02-01 13:59:44,1454331847,263
5698db6a41a9d72100240c6f,2979,ORG3402 Organisasjonsatferd og ledelse,1455104202,2016-02-10 12:36:42,1455104223,21
5698db6a41a9d72100240c70,22881,ORG3402 Organisasjonsatferd og ledelse,1452876890,2016-01-15 17:54:50,1452877232,342
5698db6a41a9d72100240c70,30177,ORG3402 Organisasjonsatferd og ledelse,1453158130,2016-01-19 00:02:10,1453158721,591
5698db6a41a9d72100240c70,27055,ORG3402 Organisasjonsatferd og ledelse,1453161660,2016-01-19 01:01:00,1453161660,0
5698db6a41a9d72100240c70,82449,ORG3402 Organisasjonsatferd og ledelse,1453672744,2016-01-24 22:59:04,1453672943,199
5698db6a41a9d72100240c71,17913,ORG3402 Organisasjonsatferd og ledelse,1453717858,2016-01-25 11:30:58,1453719100,1242
5698db6a41a9d72100240c71,47954,ORG3402 Organisasjonsatferd og ledelse,1454031325,2016-01-29 02:35:25,1454031326,1
5698db6a41a9d72100240c71,9847,ORG3402 Organisasjonsatferd og ledelse,1454202964,2016-01-31 02:16:04,1454203050,86
5698db6a41a9d72100240c71,88314,ORG3402 Organisasjonsatferd og ledelse,1454378209,2016-02-02 02:56:49,1454378263,54
5698db6a41a9d72100240c71,47555,ORG3402 Organisasjonsatferd og ledelse,1454869047,2016-02-07 19:17:27,1454869100,53
5698db6a41a9d72100240c71,50981,ORG3402 Organisasjonsatferd og ledelse,1454932660,2016-02-08 12:57:40,1454932684,24
5698db6a41a9d72100240c71,29177,ORG3402 Organisasjonsatferd og ledelse,1454938651,2016-02-08 14:37:31,1454938653,2
5698db6a41a9d72100240c71,80323,ORG3402 Organisasjonsatferd og ledelse,1455033329,2016-02-09 16:55:29,1455033334,5
5698db6a41a9d72100240c71,74676,ORG3402 Organisasjonsatferd og ledelse,1455061405,2016-02-10 00:43:25,1455062184,779
5698db6a41a9d72100240c72,79494,ORG3402 Organisasjonsatferd og ledelse,1453723638,2016-01-25 13:07:18,1453724101,463
5698db6a41a9d72100240c72,89091,ORG3402 Organisasjonsatferd og ledelse,1453805382,2016-01-26 11:49:42,1453805383,1
5698db6a41a9d72100240c72,94290,ORG3402 Organisasjonsatferd og ledelse,1453894848,2016-01-27 12:40:48,1453895416,568
5698db6a41a9d72100240c72,21566,ORG3402 Organisasjonsatferd og ledelse,1454066217,2016-01-29 12:16:57,1454066449,232
5698db6a41a9d72100240c72,3256,ORG3402 Organisasjonsatferd og ledelse,1454485580,2016-02-03 08:46:20,1454485694,114
5698db6a41a9d72100240c72,43770,ORG3402 Organisasjonsatferd og ledelse,1454587042,2016-02-04 12:57:22,1454587543,501
5698db6b2fb0de2600f22dd9,62504,ORG3402 Organisasjonsatferd og ledelse,1453228367,2016-01-19 19:32:47,1453228548,181
5698db6b2fb0de2600f22dd9,73157,ORG3402 Organisasjonsatferd og ledelse,1453310844,2016-01-20 18:27:24,1453310851,7
5698db6b2fb0de2600f22dd9,47315,ORG3402 Organisasjonsatferd og ledelse,1453668585,2016-01-24 21:49:45,1453668596,11
5698db6b2fb0de2600f22dd9,16359,ORG3402 Organisasjonsatferd og ledelse,1453671032,2016-01-24 22:30:32,1453671034,2
5698db6b2fb0de2600f22dd9,2399,ORG3402 Organisasjonsatferd og ledelse,1454074124,2016-01-29 14:28:44,1454074153,29
5698db6b2fb0de2600f22dd9,57049,ORG3402 Organisasjonsatferd og ledelse,1454582544,2016-02-04 11:42:24,1454582565,21
5698db6b2fb0de2600f22dd9,40273,ORG3402 Organisasjonsatferd og ledelse,1455015448,2016-02-09 11:57:28,1455015547,99
5698db6b2fb0de2600f22dee,35099,ORG3402 Organisasjonsatferd og ledelse,1453124885,2016-01-18 14:48:05,1453125410,525
5698db6b41a9d72100240c75,12420,ORG3402 Organisasjonsatferd og ledelse,1454694269,2016-02-05 18:44:29,1454694287,18
5698db6b41a9d72100240c75,52031,ORG3402 Organisasjonsatferd og ledelse,1454941681,2016-02-08 15:28:01,1454941681,0
5698db6c2fb0de2600f22df1,57919,ORG3402 Organisasjonsatferd og ledelse,1453719967,2016-01-25 12:06:07,1453720713,746
5698db6c2fb0de2600f22df1,75450,ORG3402 Organisasjonsatferd og ledelse,1454325504,2016-02-01 12:18:24,1454325522,18
5698db6c2fb0de2600f22df1,98554,ORG3402 Organisasjonsatferd og ledelse,1454941868,2016-02-08 15:31:08,1454941902,34
5698db6c2fb0de2600f22df3,8068,ORG3402 Organisasjonsatferd og ledelse,1453115128,2016-01-18 12:05:28,1453116392,1264
5698db6c2fb0de2600f22df3,94036,ORG3402 Organisasjonsatferd og ledelse,1453117646,2016-01-18 12:47:26,1453117647,1
5698db6c2fb0de2600f22df3,72727,ORG3402 Organisasjonsatferd og ledelse,1453119772,2016-01-18 13:22:52,1453120999,1227
5698db6c2fb0de2600f22df3,35804,ORG3402 Organisasjonsatferd og ledelse,1453124448,2016-01-18 14:40:48,1453124449,1
5698db6c2fb0de2600f22df3,60000,ORG3402 Organisasjonsatferd og ledelse,1455102668,2016-02-10 12:11:08,1455102777,109
5698db6c2fb0de2600f22df4,65257,ORG3402 Organisasjonsatferd og ledelse,1453677837,2016-01-25 00:23:57,1453677901,64
5698db6c2fb0de2600f22df4,83355,ORG3402 Organisasjonsatferd og ledelse,1453687252,2016-01-25 03:00:52,1453687252,0
5698db6c2fb0de2600f22df4,26831,ORG3402 Organisasjonsatferd og ledelse,1454429006,2016-02-02 17:03:26,1454429045,39
5698db6c41a9d72100240c92,29849,ORG3402 Organisasjonsatferd og ledelse,1452977640,2016-01-16 21:54:00,1452977642,2
5698db6c41a9d72100240c92,73835,ORG3402 Organisasjonsatferd og ledelse,1452985612,2016-01-17 00:06:52,1452985612,0
5698db6c41a9d72100240c92,94640,ORG3402 Organisasjonsatferd og ledelse,1453114417,2016-01-18 11:53:37,1453115362,945
5698db6c41a9d72100240c92,79120,ORG3402 Organisasjonsatferd og ledelse,1453127302,2016-01-18 15:28:22,1453127302,0
5698db6c41a9d72100240c92,12471,ORG3402 Organisasjonsatferd og ledelse,1453474860,2016-01-22 16:01:00,1453475768,908
5698db6c41a9d72100240c92,42991,ORG3402 Organisasjonsatferd og ledelse,1453646299,2016-01-24 15:38:19,1453646321,22
5698db6c41a9d72100240c92,75132,ORG3402 Organisasjonsatferd og ledelse,1453648202,2016-01-24 16:10:02,1453648267,65
5698db6c41a9d72100240c92,5346,ORG3402 Organisasjonsatferd og ledelse,1453720097,2016-01-25 12:08:17,1453720123,26
5698db6c41a9d72100240c92,76242,ORG3402 Organisasjonsatferd og ledelse,1454420433,2016-02-02 14:40:33,1454420514,81
5698db6c41a9d72100240c92,59919,ORG3402 Organisasjonsatferd og ledelse,1454423387,2016-02-02 15:29:47,1454423393,6
5698db6c41a9d72100240c92,35921,ORG3402 Organisasjonsatferd og ledelse,1454765657,2016-02-06 14:34:17,1454765679,22
5698db6c41a9d72100240c92,59659,ORG3402 Organisasjonsatferd og ledelse,1454770135,2016-02-06 15:48:55,1454770136,1
5698db6c41a9d72100240c93,2872,ORG3402 Organisasjonsatferd og ledelse,1453117899,2016-01-18 12:51:39,1453118553,654
5698db6c41a9d72100240c93,47385,ORG3402 Organisasjonsatferd og ledelse,1453122347,2016-01-18 14:05:47,1453123239,892
5698db6c41a9d72100240c93,86514,nan,1453124655,2016-01-18 14:44:15,1453124655,0
5698db6c41a9d72100240c93,83038,ORG3402 Organisasjonsatferd og ledelse,1453126913,2016-01-18 15:21:53,1453126926,13
5698db6c41a9d72100240c93,59668,ORG3402 Organisasjonsatferd og ledelse,1453680507,2016-01-25 01:08:27,1453680537,30
5698db6c41a9d72100240c93,65060,ORG3402 Organisasjonsatferd og ledelse,1453685541,2016-01-25 02:32:21,1453685558,17
5698db6c41a9d72100240c93,1062,ORG3402 Organisasjonsatferd og ledelse,1453744331,2016-01-25 18:52:11,1453744898,567
5698db6c41a9d72100240c93,5014,ORG3402 Organisasjonsatferd og ledelse,1453816813,2016-01-26 15:00:13,1453816813,0
5698db6c41a9d72100240c93,76646,ORG3402 Organisasjonsatferd og ledelse,1454326308,2016-02-01 12:31:48,1454326423,115
5698db6c41a9d72100240c93,97166,ORG3402 Organisasjonsatferd og ledelse,1454330657,2016-02-01 13:44:17,1454330847,190
5698db6c41a9d72100240c93,39856,ORG3402 Organisasjonsatferd og ledelse,1455050523,2016-02-09 21:42:03,1455051950,1427
5698db6c41a9d72100240c93,31751,ORG3402 Organisasjonsatferd og ledelse,1455062715,2016-02-10 01:05:15,1455062715,0
5698db6c41a9d72100240c93,98506,ORG3402 Organisasjonsatferd og ledelse,1455111679,2016-02-10 14:41:19,1455111681,2
5698db6c41a9d72100240c93,72571,ORG3402 Organisasjonsatferd og ledelse,1455271861,2016-02-12 11:11:01,1455271861,0
5698db6c41a9d72100240c93,80137,ORG3402 Organisasjonsatferd og ledelse,1455391062,2016-02-13 20:17:42,1455391063,1
5698db6d2fb0de2600f22df5,850,ORG3402 Organisasjonsatferd og ledelse,1453033449,2016-01-17 13:24:09,1453033875,426
5698db6d2fb0de2600f22df5,32560,ORG3402 Organisasjonsatferd og ledelse,1453035495,2016-01-17 13:58:15,1453035911,416
5698db6d2fb0de2600f22df5,68780,ORG3402 Organisasjonsatferd og ledelse,1453040138,2016-01-17 15:15:38,1453040197,59
5698db6d2fb0de2600f22df5,74557,ORG3402 Organisasjonsatferd og ledelse,1453115054,2016-01-18 12:04:14,1453116017,963
5698db6d2fb0de2600f22df5,90902,ORG3402 Organisasjonsatferd og ledelse,1453119299,2016-01-18 13:14:59,1453119306,7
5698db6d2fb0de2600f22df5,15716,ORG3402 Organisasjonsatferd og ledelse,1453121990,2016-01-18 13:59:50,1453122767,777
5698db6d2fb0de2600f22df5,92807,ORG3402 Organisasjonsatferd og ledelse,1453810503,2016-01-26 13:15:03,1453810615,112
5698db6d2fb0de2600f22df5,86345,ORG3402 Organisasjonsatferd og ledelse,1453812327,2016-01-26 13:45:27,1453812355,28
5698db6d2fb0de2600f22df5,31742,ORG3402 Organisasjonsatferd og ledelse,1453815768,2016-01-26 14:42:48,1453815768,0
5698db6d2fb0de2600f22df5,50254,ORG3402 Organisasjonsatferd og ledelse,1453817587,2016-01-26 15:13:07,1453817587,0
5698db6d2fb0de2600f22df5,44013,ORG3402 Organisasjonsatferd og ledelse,1454324505,2016-02-01 12:01:45,1454324752,247
5698db6d2fb0de2600f22df5,52583,ORG3402 Organisasjonsatferd og ledelse,1454328085,2016-02-01 13:01:25,1454328415,330
5698db6d2fb0de2600f22df5,30411,ORG3402 Organisasjonsatferd og ledelse,1454332256,2016-02-01 14:10:56,1454332270,14
5698db6d2fb0de2600f22df5,79458,ORG3402 Organisasjonsatferd og ledelse,1454333657,2016-02-01 14:34:17,1454333660,3
5698db6d2fb0de2600f22df5,86993,ORG3402 Organisasjonsatferd og ledelse,1455101706,2016-02-10 11:55:06,1455102141,435
5698db6d2fb0de2600f22df6,67704,ORG3402 Organisasjonsatferd og ledelse,1453293705,2016-01-20 13:41:45,1453293901,196
5698db6d2fb0de2600f22df6,2523,ORG3402 Organisasjonsatferd og ledelse,1453764944,2016-01-26 00:35:44,1453764954,10
5698db6d2fb0de2600f22df6,91186,ORG3402 Organisasjonsatferd og ledelse,1453914881,2016-01-27 18:14:41,1453914913,32
5698db6d2fb0de2600f22df6,16552,ORG3402 Organisasjonsatferd og ledelse,1453979064,2016-01-28 12:04:24,1453979096,32
5698db6d2fb0de2600f22df6,33648,ORG3402 Organisasjonsatferd og ledelse,1454688238,2016-02-05 17:03:58,1454688339,101
5698db6d2fb0de2600f22df6,34331,ORG3402 Organisasjonsatferd og ledelse,1455031752,2016-02-09 16:29:12,1455031752,0
5698db6d2fb0de2600f22df6,25389,ORG3402 Organisasjonsatferd og ledelse,1455110010,2016-02-10 14:13:30,1455110086,76
5698db6e2fb0de2600f22dfb,55362,ORG3402 Organisasjonsatferd og ledelse,1454412315,2016-02-02 12:25:15,1454412590,275
5698db6e2fb0de2600f22dfc,96383,ORG3402 Organisasjonsatferd og ledelse,1453031182,2016-01-17 12:46:22,1453032044,862
5698db6e41a9d72100240c9d,54114,ORG3402 Organisasjonsatferd og ledelse,1452870453,2016-01-15 16:07:33,1452870577,124
5698db6e41a9d72100240c9d,90474,ORG3402 Organisasjonsatferd og ledelse,1453120037,2016-01-18 13:27:17,1453120124,87
5698db6e41a9d72100240c9d,98455,ORG3402 Organisasjonsatferd og ledelse,1453148388,2016-01-18 21:19:48,1453148605,217
5698db6e41a9d72100240c9d,12382,ORG3402 Organisasjonsatferd og ledelse,1453641879,2016-01-24 14:24:39,1453641882,3
5698db6e41a9d72100240c9e,72900,ORG3402 Organisasjonsatferd og ledelse,1453720524,2016-01-25 12:15:24,1453720525,1
5698db6e41a9d72100240c9e,95115,ORG3402 Organisasjonsatferd og ledelse,1454042771,2016-01-29 05:46:11,1454042777,6
5698db6e41a9d72100240c9f,93058,ORG3402 Organisasjonsatferd og ledelse,1453055120,2016-01-17 19:25:20,1453055720,600
5698db6e41a9d72100240c9f,16303,ORG3402 Organisasjonsatferd og ledelse,1453108988,2016-01-18 10:23:08,1453108999,11
5698db6e41a9d72100240c9f,44712,ORG3402 Organisasjonsatferd og ledelse,1453110581,2016-01-18 10:49:41,1453110581,0
5698db6e41a9d72100240c9f,29069,ORG3402 Organisasjonsatferd og ledelse,1453115377,2016-01-18 12:09:37,1453115445,68
5698db6e41a9d72100240c9f,33431,ORG3402 Organisasjonsatferd og ledelse,1453118778,2016-01-18 13:06:18,1453118796,18
5698db6e41a9d72100240c9f,84288,ORG3402 Organisasjonsatferd og ledelse,1453755703,2016-01-25 22:01:43,1453755774,71
5698db6e41a9d72100240c9f,87981,ORG3402 Organisasjonsatferd og ledelse,1453886745,2016-01-27 10:25:45,1453887030,285
5698db6e41a9d72100240c9f,46171,ORG3402 Organisasjonsatferd og ledelse,1453896622,2016-01-27 13:10:22,1453896631,9
5698db6e41a9d72100240c9f,99840,ORG3402 Organisasjonsatferd og ledelse,1454328741,2016-02-01 13:12:21,1454329531,790
5698db6e41a9d72100240c9f,27849,ORG3402 Organisasjonsatferd og ledelse,1454929512,2016-02-08 12:05:12,1454929513,1
5698db6e41a9d72100240ca2,82005,ORG3402 Organisasjonsatferd og ledelse,1453720274,2016-01-25 12:11:14,1453720593,319
5698db6e41a9d72100240ca2,35414,ORG3402 Organisasjonsatferd og ledelse,1453724314,2016-01-25 13:18:34,1453724338,24
5698db6e41a9d72100240ca2,87438,ORG3402 Organisasjonsatferd og ledelse,1453729431,2016-01-25 14:43:51,1453729432,1
5698db6e41a9d72100240ca2,37594,ORG3402 Organisasjonsatferd og ledelse,1454929730,2016-02-08 12:08:50,1454929778,48
5698db6e41a9d72100240ca2,63712,ORG3402 Organisasjonsatferd og ledelse,1454931486,2016-02-08 12:38:06,1454931912,426
5698db6e41a9d72100240ca2,67678,ORG3402 Organisasjonsatferd og ledelse,1454947654,2016-02-08 17:07:34,1454947733,79
5698db6f2fb0de2600f22e16,27427,ORG3402 Organisasjonsatferd og ledelse,1453240411,2016-01-19 22:53:31,1453240580,169
5698db6f2fb0de2600f22e16,49649,ORG3402 Organisasjonsatferd og ledelse,1453724985,2016-01-25 13:29:45,1453725769,784
5698db6f2fb0de2600f22e16,93095,ORG3402 Organisasjonsatferd og ledelse,1454938515,2016-02-08 14:35:15,1454938516,1
5698db6f2fb0de2600f22e17,46034,ORG3402 Organisasjonsatferd og ledelse,1453472614,2016-01-22 15:23:34,1453473097,483
5698db6f2fb0de2600f22e17,43804,ORG3402 Organisasjonsatferd og ledelse,1454502504,2016-02-03 13:28:24,1454502552,48
5698db6f2fb0de2600f22e17,91268,ORG3402 Organisasjonsatferd og ledelse,1454933045,2016-02-08 13:04:05,1454933190,145
5698db6f2fb0de2600f22e17,30632,ORG3402 Organisasjonsatferd og ledelse,1454940340,2016-02-08 15:05:40,1454940698,358
5698db6f41a9d72100240cba,80725,ORG3402 Organisasjonsatferd og ledelse,1455218688,2016-02-11 20:24:48,1455218690,2
5698db6f41a9d72100240cbd,68675,ORG3402 Organisasjonsatferd og ledelse,1452958003,2016-01-16 16:26:43,1452959034,1031
5698db6f41a9d72100240cbd,29070,ORG3402 Organisasjonsatferd og ledelse,1453039277,2016-01-17 15:01:17,1453039277,0
5698db6f41a9d72100240cbd,6512,ORG3402 Organisasjonsatferd og ledelse,1453073942,2016-01-18 00:39:02,1453073960,18
5698db6f41a9d72100240cbd,74908,ORG3402 Organisasjonsatferd og ledelse,1453155883,2016-01-18 23:24:43,1453155892,9
5698db6f41a9d72100240cbd,6054,ORG3402 Organisasjonsatferd og ledelse,1453720771,2016-01-25 12:19:31,1453720782,11
5698db6f41a9d72100240cbd,34831,ORG3402 Organisasjonsatferd og ledelse,1453728185,2016-01-25 14:23:05,1453729188,1003
5698db6f41a9d72100240cbd,14,ORG3402 Organisasjonsatferd og ledelse,1455113602,2016-02-10 15:13:22,1455113602,0
5698db6f41a9d72100240cbd,19290,ORG3402 Organisasjonsatferd og ledelse,1455117859,2016-02-10 16:24:19,1455117860,1
5698db702fb0de2600f22e1c,32708,ORG3402 Organisasjonsatferd og ledelse,1453720731,2016-01-25 12:18:51,1453720769,38
5698db702fb0de2600f22e1c,31153,ORG3402 Organisasjonsatferd og ledelse,1453728286,2016-01-25 14:24:46,1453728391,105
5698db702fb0de2600f22e1c,32524,ORG3402 Organisasjonsatferd og ledelse,1454330698,2016-02-01 13:44:58,1454330736,38
5698db702fb0de2600f22e1c,93831,ORG3402 Organisasjonsatferd og ledelse,1455014974,2016-02-09 11:49:34,1455015052,78
5698db702fb0de2600f22e1d,18290,ORG3402 Organisasjonsatferd og ledelse,1453119911,2016-01-18 13:25:11,1453119971,60
5698db702fb0de2600f22e1d,20601,ORG3402 Organisasjonsatferd og ledelse,1453719710,2016-01-25 12:01:50,1453720001,291
5698db702fb0de2600f22e1e,73631,ORG3402 Organisasjonsatferd og ledelse,1453479799,2016-01-22 17:23:19,1453479861,62
5698db702fb0de2600f22e1e,8416,ORG3402 Organisasjonsatferd og ledelse,1454510962,2016-02-03 15:49:22,1454511040,78
5698db702fb0de2600f22e1e,57783,ORG3402 Organisasjonsatferd og ledelse,1454512529,2016-02-03 16:15:29,1454512674,145
5698db702fb0de2600f22e1e,24085,ORG3402 Organisasjonsatferd og ledelse,1454514914,2016-02-03 16:55:14,1454514929,15
5698db702fb0de2600f22e1f,40427,ORG3402 Organisasjonsatferd og ledelse,1454324844,2016-02-01 12:07:24,1454324874,30
5698db702fb0de2600f22e1f,61104,ORG3402 Organisasjonsatferd og ledelse,1454330656,2016-02-01 13:44:16,1454330752,96
5698db702fb0de2600f22e1f,62868,ORG3402 Organisasjonsatferd og ledelse,1454334122,2016-02-01 14:42:02,1454334135,13
5698db702fb0de2600f22e20,71022,ORG3402 Organisasjonsatferd og ledelse,1452871240,2016-01-15 16:20:40,1452872268,1028
5698db702fb0de2600f22e20,13511,ORG3402 Organisasjonsatferd og ledelse,1452874084,2016-01-15 17:08:04,1452874084,0
5698db702fb0de2600f22e20,92589,ORG3402 Organisasjonsatferd og ledelse,1452887644,2016-01-15 20:54:04,1452887650,6
5698db702fb0de2600f22e20,91094,ORG3402 Organisasjonsatferd og ledelse,1452889219,2016-01-15 21:20:19,1452889219,0
5698db702fb0de2600f22e20,50151,ORG3402 Organisasjonsatferd og ledelse,1452974719,2016-01-16 21:05:19,1452974829,110
5698db702fb0de2600f22e20,85487,ORG3402 Organisasjonsatferd og ledelse,1453061291,2016-01-17 21:08:11,1453062352,1061
5698db702fb0de2600f22e20,98916,ORG3402 Organisasjonsatferd og ledelse,1453115230,2016-01-18 12:07:10,1453115634,404
5698db702fb0de2600f22e20,17470,ORG3402 Organisasjonsatferd og ledelse,1453206235,2016-01-19 13:23:55,1453206254,19
5698db702fb0de2600f22e20,32668,ORG3402 Organisasjonsatferd og ledelse,1453501552,2016-01-22 23:25:52,1453501571,19
5698db702fb0de2600f22e20,53421,ORG3402 Organisasjonsatferd og ledelse,1453655653,2016-01-24 18:14:13,1453655691,38
5698db702fb0de2600f22e20,3763,ORG3402 Organisasjonsatferd og ledelse,1453671078,2016-01-24 22:31:18,1453671085,7
5698db702fb0de2600f22e20,39260,ORG3402 Organisasjonsatferd og ledelse,1454097787,2016-01-29 21:03:07,1454098981,1194
5698db712fb0de2600f22e22,44154,ORG3402 Organisasjonsatferd og ledelse,1453808390,2016-01-26 12:39:50,1453808430,40
5698db712fb0de2600f22e23,52262,ORG3402 Organisasjonsatferd og ledelse,1453119380,2016-01-18 13:16:20,1453119380,0
5698db7141a9d72100240cbe,26886,ORG3402 Organisasjonsatferd og ledelse,1453118066,2016-01-18 12:54:26,1453118640,574
5698db7141a9d72100240cbe,85344,ORG3402 Organisasjonsatferd og ledelse,1454324500,2016-02-01 12:01:40,1454324559,59
5698db7141a9d72100240cbe,11491,ORG3402 Organisasjonsatferd og ledelse,1455371979,2016-02-13 14:59:39,1455372772,793
5698db7141a9d72100240cbf,88472,ORG3402 Organisasjonsatferd og ledelse,1453037715,2016-01-17 14:35:15,1453040427,2712
5698db7141a9d72100240cbf,79525,ORG3402 Organisasjonsatferd og ledelse,1453926857,2016-01-27 21:34:17,1453926891,34
5698db7141a9d72100240cbf,24012,ORG3402 Organisasjonsatferd og ledelse,1453928111,2016-01-27 21:55:11,1453928112,1
5698db7141a9d72100240cbf,30424,ORG3402 Organisasjonsatferd og ledelse,1454330765,2016-02-01 13:46:05,1454330766,1
5698db7141a9d72100240cc0,81409,ORG3402 Organisasjonsatferd og ledelse,1453113998,2016-01-18 11:46:38,1453114165,167
5698db7141a9d72100240cc0,1837,ORG3402 Organisasjonsatferd og ledelse,1453122750,2016-01-18 14:12:30,1453123117,367
5698db7141a9d72100240cc0,6936,ORG3402 Organisasjonsatferd og ledelse,1453220496,2016-01-19 17:21:36,1453220580,84
5698db7141a9d72100240cc0,10339,ORG3402 Organisasjonsatferd og ledelse,1453718448,2016-01-25 11:40:48,1453718547,99
5698db7141a9d72100240cc0,39573,ORG3402 Organisasjonsatferd og ledelse,1453887373,2016-01-27 10:36:13,1453887373,0
5698db7141a9d72100240cc0,88636,ORG3402 Organisasjonsatferd og ledelse,1453894884,2016-01-27 12:41:24,1453894892,8
5698db7141a9d72100240cc0,2798,ORG3402 Organisasjonsatferd og ledelse,1453903497,2016-01-27 15:04:57,1453903788,291
5698db7141a9d72100240cc0,64742,ORG3402 Organisasjonsatferd og ledelse,1454321645,2016-02-01 11:14:05,1454322824,1179
5698db7141a9d72100240cc2,51926,ORG3402 Organisasjonsatferd og ledelse,1455103720,2016-02-10 12:28:40,1455104027,307
5698db7141a9d72100240cc4,16904,ORG3402 Organisasjonsatferd og ledelse,1453157626,2016-01-18 23:53:46,1453157756,130
5698db7141a9d72100240cc4,84935,ORG3402 Organisasjonsatferd og ledelse,1453720533,2016-01-25 12:15:33,1453721228,695
5698db7141a9d72100240cc4,46195,ORG3402 Organisasjonsatferd og ledelse,1453724174,2016-01-25 13:16:14,1453724335,161
5698db7141a9d72100240cc4,42655,ORG3402 Organisasjonsatferd og ledelse,1453728261,2016-01-25 14:24:21,1453728571,310
5698db7141a9d72100240cc4,34677,ORG3402 Organisasjonsatferd og ledelse,1453929452,2016-01-27 22:17:32,1453929452,0
5698db7141a9d72100240cc4,36969,ORG3402 Organisasjonsatferd og ledelse,1454120054,2016-01-30 03:14:14,1454120055,1
5698db7141a9d72100240cc4,86705,ORG3402 Organisasjonsatferd og ledelse,1454273206,2016-01-31 21:46:46,1454273207,1
5698db7141a9d72100240cc4,36498,ORG3402 Organisasjonsatferd og ledelse,1454324266,2016-02-01 11:57:46,1454324460,194
5698db7141a9d72100240cc4,15849,ORG3402 Organisasjonsatferd og ledelse,1454326369,2016-02-01 12:32:49,1454326438,69
5698db7141a9d72100240cc4,21096,ORG3402 Organisasjonsatferd og ledelse,1454330419,2016-02-01 13:40:19,1454330420,1
5698db7141a9d72100240cc4,22119,ORG3402 Organisasjonsatferd og ledelse,1454929598,2016-02-08 12:06:38,1454929598,0
5698db7141a9d72100240cc4,46862,ORG3402 Organisasjonsatferd og ledelse,1454933033,2016-02-08 13:03:53,1454933044,11
5698db7141a9d72100240cc4,430,ORG3402 Organisasjonsatferd og ledelse,1454935114,2016-02-08 13:38:34,1454935128,14
5698db722fb0de2600f22e3e,98019,ORG3402 Organisasjonsatferd og ledelse,1453055019,2016-01-17 19:23:39,1453055221,202
5698db722fb0de2600f22e3e,68156,ORG3402 Organisasjonsatferd og ledelse,1453152093,2016-01-18 22:21:33,1453152104,11
5698db722fb0de2600f22e3e,35160,ORG3402 Organisasjonsatferd og ledelse,1453226704,2016-01-19 19:05:04,1453226744,40
5698db722fb0de2600f22e3e,58757,ORG3402 Organisasjonsatferd og ledelse,1453227947,2016-01-19 19:25:47,1453227947,0
5698db722fb0de2600f22e3e,71588,ORG3402 Organisasjonsatferd og ledelse,1454882590,2016-02-07 23:03:10,1454882613,23
5698db722fb0de2600f22e3e,37164,ORG3402 Organisasjonsatferd og ledelse,1455030113,2016-02-09 16:01:53,1455030297,184
5698db722fb0de2600f22e3e,21725,ORG3402 Organisasjonsatferd og ledelse,1455380159,2016-02-13 17:15:59,1455380164,5
5698db722fb0de2600f22e3f,2771,ORG3402 Organisasjonsatferd og ledelse,1452862185,2016-01-15 13:49:45,1452862499,314
5698db722fb0de2600f22e3f,92982,ORG3402 Organisasjonsatferd og ledelse,1453050176,2016-01-17 18:02:56,1453050458,282
5698db722fb0de2600f22e3f,96640,ORG3402 Organisasjonsatferd og ledelse,1453055839,2016-01-17 19:37:19,1453055840,1
5698db722fb0de2600f22e3f,74610,ORG3402 Organisasjonsatferd og ledelse,1453060137,2016-01-17 20:48:57,1453060219,82
5698db722fb0de2600f22e3f,14199,ORG3402 Organisasjonsatferd og ledelse,1453116139,2016-01-18 12:22:19,1453117473,1334
5698db722fb0de2600f22e3f,77584,ORG3402 Organisasjonsatferd og ledelse,1453122572,2016-01-18 14:09:32,1453122822,250
5698db722fb0de2600f22e3f,77154,ORG3402 Organisasjonsatferd og ledelse,1453128254,2016-01-18 15:44:14,1453128275,21
5698db722fb0de2600f22e3f,79680,ORG3402 Organisasjonsatferd og ledelse,1453210923,2016-01-19 14:42:03,1453211826,903
5698db722fb0de2600f22e3f,77279,ORG3402 Organisasjonsatferd og ledelse,1453382028,2016-01-21 14:13:48,1453382079,51
5698db722fb0de2600f22e3f,75212,ORG3402 Organisasjonsatferd og ledelse,1453644138,2016-01-24 15:02:18,1453644360,222
5698db722fb0de2600f22e3f,6683,ORG3402 Organisasjonsatferd og ledelse,1453668967,2016-01-24 21:56:07,1453668971,4
5698db722fb0de2600f22e3f,53250,ORG3402 Organisasjonsatferd og ledelse,1454263646,2016-01-31 19:07:26,1454263670,24
5698db722fb0de2600f22e3f,71641,ORG3402 Organisasjonsatferd og ledelse,1454324544,2016-02-01 12:02:24,1454324595,51
5698db722fb0de2600f22e3f,94179,ORG3402 Organisasjonsatferd og ledelse,1454332987,2016-02-01 14:23:07,1454333803,816
5698db722fb0de2600f22e3f,8579,ORG3402 Organisasjonsatferd og ledelse,1454508939,2016-02-03 15:15:39,1454509076,137
5698db722fb0de2600f22e3f,25572,ORG3402 Organisasjonsatferd og ledelse,1454857646,2016-02-07 16:07:26,1454858300,654
5698db722fb0de2600f22e3f,37098,ORG3402 Organisasjonsatferd og ledelse,1454925704,2016-02-08 11:01:44,1454926449,745
5698db722fb0de2600f22e3f,52793,ORG3402 Organisasjonsatferd og ledelse,1454941641,2016-02-08 15:27:21,1454941645,4
5698db722fb0de2600f22e3f,50785,ORG3402 Organisasjonsatferd og ledelse,1455029599,2016-02-09 15:53:19,1455029631,32
5698db722fb0de2600f22e3f,76053,ORG3402 Organisasjonsatferd og ledelse,1455037968,2016-02-09 18:12:48,1455038081,113
5698db722fb0de2600f22e3f,56893,ORG3402 Organisasjonsatferd og ledelse,1455182662,2016-02-11 10:24:22,1455182668,6
5698db722fb0de2600f22e41,53355,ORG3402 Organisasjonsatferd og ledelse,1455095411,2016-02-10 10:10:11,1455096408,997
5698db722fb0de2600f22e42,60314,ORG3402 Organisasjonsatferd og ledelse,1455458787,2016-02-14 15:06:27,1455458877,90
5698db722fb0de2600f22e42,48504,ORG3402 Organisasjonsatferd og ledelse,1455465188,2016-02-14 16:53:08,1455465188,0
5698db722fb0de2600f22e42,38022,ORG3402 Organisasjonsatferd og ledelse,1455466529,2016-02-14 17:15:29,1455466530,1
5698db722fb0de2600f22e42,8452,ORG3402 Organisasjonsatferd og ledelse,1455468515,2016-02-14 17:48:35,1455468516,1
5698db722fb0de2600f22e42,12007,ORG3402 Organisasjonsatferd og ledelse,1455483127,2016-02-14 21:52:07,1455483127,0
5698db722fb0de2600f22e42,87152,ORG3402 Organisasjonsatferd og ledelse,1455484370,2016-02-14 22:12:50,1455484445,75
5698db722fb0de2600f22e42,58324,ORG3402 Organisasjonsatferd og ledelse,1455489174,2016-02-14 23:32:54,1455489175,1
5698db7241a9d72100240ce2,52211,ORG3402 Organisasjonsatferd og ledelse,1453720333,2016-01-25 12:12:13,1453720439,106
5698db7241a9d72100240ce2,34991,ORG3402 Organisasjonsatferd og ledelse,1453722688,2016-01-25 12:51:28,1453723549,861
5698db7241a9d72100240ce2,60994,ORG3402 Organisasjonsatferd og ledelse,1453724851,2016-01-25 13:27:31,1453725262,411
5698db7241a9d72100240ce2,86447,ORG3402 Organisasjonsatferd og ledelse,1453726598,2016-01-25 13:56:38,1453726671,73
5698db7241a9d72100240ce2,27890,ORG3402 Organisasjonsatferd og ledelse,1453728202,2016-01-25 14:23:22,1453728296,94
5698db7241a9d72100240ce2,54407,ORG3402 Organisasjonsatferd og ledelse,1453729999,2016-01-25 14:53:19,1453730471,472
5698db7241a9d72100240ce6,49704,ORG3402 Organisasjonsatferd og ledelse,1453965080,2016-01-28 08:11:20,1453965178,98
5698db7241a9d72100240ce8,37018,ORG3402 Organisasjonsatferd og ledelse,1453235392,2016-01-19 21:29:52,1453236245,853
5698db7241a9d72100240ce8,11199,ORG3402 Organisasjonsatferd og ledelse,1454498894,2016-02-03 12:28:14,1454499532,638
5698db732fb0de2600f22e44,3227,ORG3402 Organisasjonsatferd og ledelse,1453144759,2016-01-18 20:19:19,1453145487,728
5698db732fb0de2600f22e44,71397,ORG3402 Organisasjonsatferd og ledelse,1455116977,2016-02-10 16:09:37,1455117157,180
5698db732fb0de2600f22e45,97968,ORG3402 Organisasjonsatferd og ledelse,1453058416,2016-01-17 20:20:16,1453060416,2000
5698db732fb0de2600f22e45,5194,ORG3402 Organisasjonsatferd og ledelse,1455362797,2016-02-13 12:26:37,1455362872,75
5698db732fb0de2600f22e47,5485,ORG3402 Organisasjonsatferd og ledelse,1452863376,2016-01-15 14:09:36,1452867289,3913
5698db732fb0de2600f22e47,851,ORG3402 Organisasjonsatferd og ledelse,1453051782,2016-01-17 18:29:42,1453051944,162
5698db732fb0de2600f22e47,84512,ORG3402 Organisasjonsatferd og ledelse,1453060227,2016-01-17 20:50:27,1453060295,68
5698db732fb0de2600f22e47,52797,ORG3402 Organisasjonsatferd og ledelse,1453149069,2016-01-18 21:31:09,1453149962,893
5698db732fb0de2600f22e47,132,ORG3402 Organisasjonsatferd og ledelse,1453229016,2016-01-19 19:43:36,1453229024,8
5698db732fb0de2600f22e47,50902,ORG3402 Organisasjonsatferd og ledelse,1453315533,2016-01-20 19:45:33,1453315734,201
5698db732fb0de2600f22e47,94412,ORG3402 Organisasjonsatferd og ledelse,1453471193,2016-01-22 14:59:53,1453471196,3
5698db732fb0de2600f22e47,81337,ORG3402 Organisasjonsatferd og ledelse,1453504579,2016-01-23 00:16:19,1453504580,1
5698db732fb0de2600f22e47,50310,ORG3402 Organisasjonsatferd og ledelse,1453582562,2016-01-23 21:56:02,1453582572,10
5698db732fb0de2600f22e47,11472,ORG3402 Organisasjonsatferd og ledelse,1453640787,2016-01-24 14:06:27,1453641029,242
5698db732fb0de2600f22e47,99284,ORG3402 Organisasjonsatferd og ledelse,1453668568,2016-01-24 21:49:28,1453668572,4
5698db732fb0de2600f22e47,98465,ORG3402 Organisasjonsatferd og ledelse,1453670299,2016-01-24 22:18:19,1453670306,7
5698db732fb0de2600f22e47,17364,ORG3402 Organisasjonsatferd og ledelse,1453750814,2016-01-25 20:40:14,1453750856,42
5698db732fb0de2600f22e47,10332,ORG3402 Organisasjonsatferd og ledelse,1453819477,2016-01-26 15:44:37,1453819506,29
5698db732fb0de2600f22e47,90861,ORG3402 Organisasjonsatferd og ledelse,1453890187,2016-01-27 11:23:07,1453890190,3
5698db732fb0de2600f22e47,38737,ORG3402 Organisasjonsatferd og ledelse,1453898441,2016-01-27 13:40:41,1453898448,7
5698db732fb0de2600f22e47,89150,ORG3402 Organisasjonsatferd og ledelse,1453933616,2016-01-27 23:26:56,1453933690,74
5698db732fb0de2600f22e47,40846,ORG3402 Organisasjonsatferd og ledelse,1453979656,2016-01-28 12:14:16,1453980012,356
5698db732fb0de2600f22e47,93472,ORG3402 Organisasjonsatferd og ledelse,1453992700,2016-01-28 15:51:40,1453992710,10
5698db732fb0de2600f22e47,94993,ORG3402 Organisasjonsatferd og ledelse,1454086176,2016-01-29 17:49:36,1454086177,1
5698db732fb0de2600f22e47,17567,ORG3402 Organisasjonsatferd og ledelse,1454419067,2016-02-02 14:17:47,1454419465,398
5698db732fb0de2600f22e47,16255,ORG3402 Organisasjonsatferd og ledelse,1454444941,2016-02-02 21:29:01,1454444992,51
5698db732fb0de2600f22e47,84546,ORG3402 Organisasjonsatferd og ledelse,1454504577,2016-02-03 14:02:57,1454504879,302
5698db732fb0de2600f22e47,3430,ORG3402 Organisasjonsatferd og ledelse,1454768519,2016-02-06 15:21:59,1454768761,242
5698db732fb0de2600f22e47,86037,ORG3402 Organisasjonsatferd og ledelse,1454773273,2016-02-06 16:41:13,1454773500,227
5698db732fb0de2600f22e47,51839,ORG3402 Organisasjonsatferd og ledelse,1454775261,2016-02-06 17:14:21,1454775265,4
5698db732fb0de2600f22e47,37222,ORG3402 Organisasjonsatferd og ledelse,1454871019,2016-02-07 19:50:19,1454871019,0
5698db732fb0de2600f22e47,30750,ORG3402 Organisasjonsatferd og ledelse,1454957584,2016-02-08 19:53:04,1454957622,38
5698db732fb0de2600f22e47,73505,ORG3402 Organisasjonsatferd og ledelse,1455019108,2016-02-09 12:58:28,1455019108,0
5698db732fb0de2600f22e47,60468,ORG3402 Organisasjonsatferd og ledelse,1455044892,2016-02-09 20:08:12,1455044892,0
5698db732fb0de2600f22e47,53429,ORG3402 Organisasjonsatferd og ledelse,1455057167,2016-02-09 23:32:47,1455057167,0
5698db732fb0de2600f22e47,80624,ORG3402 Organisasjonsatferd og ledelse,1455125402,2016-02-10 18:30:02,1455125402,0
5698db732fb0de2600f22e47,72486,ORG3402 Organisasjonsatferd og ledelse,1455145902,2016-02-11 00:11:42,1455145902,0
5698db732fb0de2600f22e47,87469,ORG3402 Organisasjonsatferd og ledelse,1455205891,2016-02-11 16:51:31,1455205945,54
5698db732fb0de2600f22e47,50123,ORG3402 Organisasjonsatferd og ledelse,1455283089,2016-02-12 14:18:09,1455283089,0
5698db732fb0de2600f22e47,44878,ORG3402 Organisasjonsatferd og ledelse,1455363565,2016-02-13 12:39:25,1455363575,10
5698db732fb0de2600f22e47,11449,ORG3402 Organisasjonsatferd og ledelse,1455373440,2016-02-13 15:24:00,1455374850,1410
5698db732fb0de2600f22e47,93622,ORG3402 Organisasjonsatferd og ledelse,1455462067,2016-02-14 16:01:07,1455462068,1
5698db7441a9d72100240cea,65737,ORG3402 Organisasjonsatferd og ledelse,1452861919,2016-01-15 13:45:19,1452862406,487
5698db7441a9d72100240cea,87511,ORG3402 Organisasjonsatferd og ledelse,1453648627,2016-01-24 16:17:07,1453648743,116
5698db7441a9d72100240cea,33770,ORG3402 Organisasjonsatferd og ledelse,1453754688,2016-01-25 21:44:48,1453754726,38
5698db7441a9d72100240cea,47726,ORG3402 Organisasjonsatferd og ledelse,1455045855,2016-02-09 20:24:15,1455046010,155
5698db7441a9d72100240ceb,94405,ORG3402 Organisasjonsatferd og ledelse,1454332250,2016-02-01 14:10:50,1454332251,1
5698db7441a9d72100240ceb,76109,ORG3402 Organisasjonsatferd og ledelse,1455189054,2016-02-11 12:10:54,1455189109,55
5698db7441a9d72100240cec,63381,ORG3402 Organisasjonsatferd og ledelse,1452862176,2016-01-15 13:49:36,1452862224,48
5698db7441a9d72100240cec,49146,ORG3402 Organisasjonsatferd og ledelse,1452886408,2016-01-15 20:33:28,1452886409,1
5698db7441a9d72100240cec,53335,ORG3402 Organisasjonsatferd og ledelse,1453158872,2016-01-19 00:14:32,1453158873,1
5698db7441a9d72100240cec,39875,ORG3402 Organisasjonsatferd og ledelse,1453185242,2016-01-19 07:34:02,1453185784,542
5698db7441a9d72100240cec,30356,ORG3402 Organisasjonsatferd og ledelse,1453679990,2016-01-25 00:59:50,1453680232,242
5698db7441a9d72100240cec,69182,ORG3402 Organisasjonsatferd og ledelse,1455194523,2016-02-11 13:42:03,1455194695,172
5698db7441a9d72100240ced,30925,ORG3402 Organisasjonsatferd og ledelse,1452861893,2016-01-15 13:44:53,1452862121,228
5698db7441a9d72100240ced,79098,ORG3402 Organisasjonsatferd og ledelse,1453050081,2016-01-17 18:01:21,1453050729,648
5698db7441a9d72100240ced,89960,ORG3402 Organisasjonsatferd og ledelse,1453055980,2016-01-17 19:39:40,1453055981,1
5698db7441a9d72100240ced,45390,ORG3402 Organisasjonsatferd og ledelse,1453115273,2016-01-18 12:07:53,1453115339,66
5698db7441a9d72100240ced,71675,ORG3402 Organisasjonsatferd og ledelse,1453290257,2016-01-20 12:44:17,1453290258,1
5698db7441a9d72100240ced,77319,ORG3402 Organisasjonsatferd og ledelse,1453719978,2016-01-25 12:06:18,1453721791,1813
5698db7441a9d72100240ced,94317,ORG3402 Organisasjonsatferd og ledelse,1453725553,2016-01-25 13:39:13,1453725553,0
5698db7441a9d72100240ced,9437,ORG3402 Organisasjonsatferd og ledelse,1455237889,2016-02-12 01:44:49,1455237890,1
5698db7441a9d72100240cf0,41316,ORG3402 Organisasjonsatferd og ledelse,1453070265,2016-01-17 23:37:45,1453071731,1466
5698db7441a9d72100240cf0,13297,ORG3402 Organisasjonsatferd og ledelse,1453242930,2016-01-19 23:35:30,1453243009,79
5698db7441a9d72100240cf0,81503,ORG3402 Organisasjonsatferd og ledelse,1453326885,2016-01-20 22:54:45,1453326907,22
5698db7441a9d72100240cf0,98571,ORG3402 Organisasjonsatferd og ledelse,1453402650,2016-01-21 19:57:30,1453402653,3
5698db7441a9d72100240cf0,98926,ORG3402 Organisasjonsatferd og ledelse,1453405702,2016-01-21 20:48:22,1453405705,3
5698db7441a9d72100240cf0,22850,ORG3402 Organisasjonsatferd og ledelse,1453918026,2016-01-27 19:07:06,1453918109,83
5698db7441a9d72100240cf0,45658,ORG3402 Organisasjonsatferd og ledelse,1454979608,2016-02-09 02:00:08,1454979720,112
5698db7441a9d72100240cf0,76393,ORG3402 Organisasjonsatferd og ledelse,1455125040,2016-02-10 18:24:00,1455125369,329
5698db7441a9d72100240cf4,41381,ORG3402 Organisasjonsatferd og ledelse,1453894377,2016-01-27 12:32:57,1453894958,581
5698db7441a9d72100240cf4,44281,ORG3402 Organisasjonsatferd og ledelse,1455028290,2016-02-09 15:31:30,1455029162,872
5698db7441a9d72100240cf4,22725,ORG3402 Organisasjonsatferd og ledelse,1455030905,2016-02-09 16:15:05,1455030907,2
5698db7441a9d72100240cf4,30923,ORG3402 Organisasjonsatferd og ledelse,1455109488,2016-02-10 14:04:48,1455109490,2
5698db752fb0de2600f22e66,86433,ORG3402 Organisasjonsatferd og ledelse,1453136744,2016-01-18 18:05:44,1453136830,86
5698db752fb0de2600f22e66,91139,ORG3402 Organisasjonsatferd og ledelse,1454850914,2016-02-07 14:15:14,1454850929,15
5698db752fb0de2600f22e67,1637,ORG3402 Organisasjonsatferd og ledelse,1453149038,2016-01-18 21:30:38,1453150085,1047
5698db752fb0de2600f22e67,32181,ORG3402 Organisasjonsatferd og ledelse,1453901445,2016-01-27 14:30:45,1453901445,0
5698db752fb0de2600f22e67,37675,ORG3402 Organisasjonsatferd og ledelse,1454324756,2016-02-01 12:05:56,1454324761,5
5698db752fb0de2600f22e67,3158,ORG3402 Organisasjonsatferd og ledelse,1454326063,2016-02-01 12:27:43,1454326066,3
5698db752fb0de2600f22e67,10089,ORG3402 Organisasjonsatferd og ledelse,1454333920,2016-02-01 14:38:40,1454333920,0
5698db752fb0de2600f22e67,32336,ORG3402 Organisasjonsatferd og ledelse,1455037610,2016-02-09 18:06:50,1455037610,0
5698db752fb0de2600f22e67,12088,ORG3402 Organisasjonsatferd og ledelse,1455371644,2016-02-13 14:54:04,1455371679,35
5698db7541a9d72100240d0d,45566,ORG3402 Organisasjonsatferd og ledelse,1453666340,2016-01-24 21:12:20,1453666382,42
5698db7541a9d72100240d0d,60867,ORG3402 Organisasjonsatferd og ledelse,1454321661,2016-02-01 11:14:21,1454321694,33
5698db7541a9d72100240d0d,4800,ORG3402 Organisasjonsatferd og ledelse,1454325335,2016-02-01 12:15:35,1454325570,235
5698db7541a9d72100240d0d,17595,ORG3402 Organisasjonsatferd og ledelse,1454330776,2016-02-01 13:46:16,1454330776,0
5698db7541a9d72100240d0d,88525,ORG3402 Organisasjonsatferd og ledelse,1454357448,2016-02-01 21:10:48,1454357448,0
5698db7541a9d72100240d0d,24698,ORG3402 Organisasjonsatferd og ledelse,1454870433,2016-02-07 19:40:33,1454870781,348
5698db762fb0de2600f22e6c,5720,ORG3402 Organisasjonsatferd og ledelse,1453205216,2016-01-19 13:06:56,1453207109,1893
5698db762fb0de2600f22e6c,96160,ORG3402 Organisasjonsatferd og ledelse,1453383393,2016-01-21 14:36:33,1453383463,70
5698db762fb0de2600f22e6c,17435,ORG3402 Organisasjonsatferd og ledelse,1453719541,2016-01-25 11:59:01,1453720206,665
5698db762fb0de2600f22e6c,60148,ORG3402 Organisasjonsatferd og ledelse,1453742687,2016-01-25 18:24:47,1453742812,125
5698db762fb0de2600f22e6c,56725,ORG3402 Organisasjonsatferd og ledelse,1453822951,2016-01-26 16:42:31,1453822963,12
5698db762fb0de2600f22e6c,67302,ORG3402 Organisasjonsatferd og ledelse,1453828622,2016-01-26 18:17:02,1453828683,61
5698db762fb0de2600f22e6c,45109,ORG3402 Organisasjonsatferd og ledelse,1453985978,2016-01-28 13:59:38,1453986103,125
5698db762fb0de2600f22e6c,98827,ORG3402 Organisasjonsatferd og ledelse,1454347935,2016-02-01 18:32:15,1454347947,12
5698db762fb0de2600f22e6c,28710,ORG3402 Organisasjonsatferd og ledelse,1454708698,2016-02-05 22:44:58,1454708750,52
5698db762fb0de2600f22e6c,505,ORG3402 Organisasjonsatferd og ledelse,1454929215,2016-02-08 12:00:15,1454929216,1
5698db762fb0de2600f22e6c,34277,ORG3402 Organisasjonsatferd og ledelse,1454933189,2016-02-08 13:06:29,1454933196,7
5698db762fb0de2600f22e6c,20244,ORG3402 Organisasjonsatferd og ledelse,1454939527,2016-02-08 14:52:07,1454940491,964
5698db762fb0de2600f22e6d,3084,ORG3402 Organisasjonsatferd og ledelse,1454892066,2016-02-08 01:41:06,1454892174,108
5698db762fb0de2600f22e6d,71426,ORG3402 Organisasjonsatferd og ledelse,1454932487,2016-02-08 12:54:47,1454933198,711
5698db762fb0de2600f22e6e,43383,ORG3402 Organisasjonsatferd og ledelse,1454940361,2016-02-08 15:06:01,1454940553,192
5698db762fb0de2600f22e6e,51117,ORG3402 Organisasjonsatferd og ledelse,1454942888,2016-02-08 15:48:08,1454942889,1
5698db762fb0de2600f22e70,52334,ORG3402 Organisasjonsatferd og ledelse,1452959542,2016-01-16 16:52:22,1452959632,90
5698db762fb0de2600f22e70,50318,ORG3402 Organisasjonsatferd og ledelse,1452968851,2016-01-16 19:27:31,1452968852,1
5698db762fb0de2600f22e70,26414,ORG3402 Organisasjonsatferd og ledelse,1453720515,2016-01-25 12:15:15,1453720761,246
5698db762fb0de2600f22e70,22571,ORG3402 Organisasjonsatferd og ledelse,1453896043,2016-01-27 13:00:43,1453896477,434
5698db762fb0de2600f22e70,64960,ORG3402 Organisasjonsatferd og ledelse,1454492751,2016-02-03 10:45:51,1454492805,54
5698db762fb0de2600f22e70,87165,ORG3402 Organisasjonsatferd og ledelse,1454497385,2016-02-03 12:03:05,1454498081,696
5698db762fb0de2600f22e70,12627,ORG3402 Organisasjonsatferd og ledelse,1455101683,2016-02-10 11:54:43,1455102402,719
5698db762fb0de2600f22e70,14110,ORG3402 Organisasjonsatferd og ledelse,1455122895,2016-02-10 17:48:15,1455122900,5
5698db762fb0de2600f22e70,62415,ORG3402 Organisasjonsatferd og ledelse,1455130622,2016-02-10 19:57:02,1455130700,78
5698db762fb0de2600f22e70,79210,ORG3402 Organisasjonsatferd og ledelse,1455465938,2016-02-14 17:05:38,1455465938,0
5698db772fb0de2600f22e72,39705,ORG3402 Organisasjonsatferd og ledelse,1453113340,2016-01-18 11:35:40,1453113962,622
5698db772fb0de2600f22e72,70755,ORG3402 Organisasjonsatferd og ledelse,1453115198,2016-01-18 12:06:38,1453115327,129
5698db772fb0de2600f22e72,13203,ORG3402 Organisasjonsatferd og ledelse,1453719508,2016-01-25 11:58:28,1453719508,0
5698db772fb0de2600f22e72,47612,ORG3402 Organisasjonsatferd og ledelse,1454330739,2016-02-01 13:45:39,1454330793,54
5698db772fb0de2600f22e72,43591,ORG3402 Organisasjonsatferd og ledelse,1455017228,2016-02-09 12:27:08,1455018147,919
5698db772fb0de2600f22e72,29695,ORG3402 Organisasjonsatferd og ledelse,1455030732,2016-02-09 16:12:12,1455030732,0
5698db772fb0de2600f22e72,37666,ORG3402 Organisasjonsatferd og ledelse,1455193046,2016-02-11 13:17:26,1455193495,449
5698db772fb0de2600f22e74,82395,ORG3402 Organisasjonsatferd og ledelse,1454331083,2016-02-01 13:51:23,1454331083,0
5698db772fb0de2600f22e74,92868,ORG3402 Organisasjonsatferd og ledelse,1454371895,2016-02-02 01:11:35,1454371923,28
5698db772fb0de2600f22e74,30993,ORG3402 Organisasjonsatferd og ledelse,1454417013,2016-02-02 13:43:33,1454417055,42
5698db772fb0de2600f22e74,19662,ORG3402 Organisasjonsatferd og ledelse,1454859314,2016-02-07 16:35:14,1454859354,40
5698db772fb0de2600f22e74,57651,ORG3402 Organisasjonsatferd og ledelse,1455373961,2016-02-13 15:32:41,1455373979,18
5698db7741a9d72100240d0f,33038,ORG3402 Organisasjonsatferd og ledelse,1453115773,2016-01-18 12:16:13,1453117318,1545
5698db7741a9d72100240d0f,57114,ORG3402 Organisasjonsatferd og ledelse,1453119710,2016-01-18 13:21:50,1453120814,1104
5698db782fb0de2600f22e8e,9384,ORG3402 Organisasjonsatferd og ledelse,1453116033,2016-01-18 12:20:33,1453116394,361
5698db782fb0de2600f22e8e,54405,ORG3402 Organisasjonsatferd og ledelse,1453117781,2016-01-18 12:49:41,1453117802,21
5698db782fb0de2600f22e8e,35638,ORG3402 Organisasjonsatferd og ledelse,1453122863,2016-01-18 14:14:23,1453124590,1727
5698db782fb0de2600f22e8e,98509,ORG3402 Organisasjonsatferd og ledelse,1453143251,2016-01-18 19:54:11,1453143261,10
5698db782fb0de2600f22e8e,30662,ORG3402 Organisasjonsatferd og ledelse,1453980320,2016-01-28 12:25:20,1453980354,34
5698db792fb0de2600f22e90,95430,ORG3402 Organisasjonsatferd og ledelse,1453202846,2016-01-19 12:27:26,1453202938,92
5698db792fb0de2600f22e90,96901,ORG3402 Organisasjonsatferd og ledelse,1455040972,2016-02-09 19:02:52,1455041344,372
5698db792fb0de2600f22e90,17573,ORG3402 Organisasjonsatferd og ledelse,1455043007,2016-02-09 19:36:47,1455043013,6
5698db792fb0de2600f22e90,50137,ORG3402 Organisasjonsatferd og ledelse,1455116495,2016-02-10 16:01:35,1455116504,9
5698db792fb0de2600f22e92,31201,ORG3402 Organisasjonsatferd og ledelse,1453392135,2016-01-21 17:02:15,1453392249,114
5698db792fb0de2600f22e92,70752,ORG3402 Organisasjonsatferd og ledelse,1454933521,2016-02-08 13:12:01,1454933562,41
5698db792fb0de2600f22e93,341,ORG3402 Organisasjonsatferd og ledelse,1454328148,2016-02-01 13:02:28,1454328148,0
5698db7941a9d72100240d32,61378,ORG3402 Organisasjonsatferd og ledelse,1453287589,2016-01-20 11:59:49,1453287730,141
5698db7941a9d72100240d34,86244,ORG3402 Organisasjonsatferd og ledelse,1454598744,2016-02-04 16:12:24,1454599271,527
5698db7941a9d72100240d34,23500,ORG3402 Organisasjonsatferd og ledelse,1455487693,2016-02-14 23:08:13,1455487836,143
5698db7941a9d72100240d35,15940,ORG3402 Organisasjonsatferd og ledelse,1453709911,2016-01-25 09:18:31,1453710042,131
5698db7941a9d72100240d35,69709,ORG3402 Organisasjonsatferd og ledelse,1453712427,2016-01-25 10:00:27,1453712449,22
5698db7941a9d72100240d35,92905,ORG3402 Organisasjonsatferd og ledelse,1453715298,2016-01-25 10:48:18,1453715652,354
5698db7941a9d72100240d35,86409,ORG3402 Organisasjonsatferd og ledelse,1453967474,2016-01-28 08:51:14,1453967516,42
5698db7941a9d72100240d35,16015,ORG3402 Organisasjonsatferd og ledelse,1454320012,2016-02-01 10:46:52,1454320042,30
5698db7941a9d72100240d35,43651,ORG3402 Organisasjonsatferd og ledelse,1455405166,2016-02-14 00:12:46,1455405167,1
5698db7a2fb0de2600f22e95,88937,ORG3402 Organisasjonsatferd og ledelse,1452861895,2016-01-15 13:44:55,1452862197,302
5698db7a2fb0de2600f22e95,17211,ORG3402 Organisasjonsatferd og ledelse,1452925755,2016-01-16 07:29:15,1452925756,1
5698db7a2fb0de2600f22e95,29227,ORG3402 Organisasjonsatferd og ledelse,1452970784,2016-01-16 19:59:44,1452970784,0
5698db7a2fb0de2600f22e95,64767,ORG3402 Organisasjonsatferd og ledelse,1453191385,2016-01-19 09:16:25,1453191492,107
5698db7a2fb0de2600f22e95,18506,ORG3402 Organisasjonsatferd og ledelse,1453297897,2016-01-20 14:51:37,1453297939,42
5698db7a2fb0de2600f22e95,7992,ORG3402 Organisasjonsatferd og ledelse,1453817986,2016-01-26 15:19:46,1453818001,15
5698db7a2fb0de2600f22e95,16866,ORG3402 Organisasjonsatferd og ledelse,1455155287,2016-02-11 02:48:07,1455156509,1222
5698db7a2fb0de2600f22e97,29079,ORG3402 Organisasjonsatferd og ledelse,1452862800,2016-01-15 14:00:00,1452862800,0
5698db7a2fb0de2600f22e97,2563,ORG3402 Organisasjonsatferd og ledelse,1452959826,2016-01-16 16:57:06,1452959826,0
5698db7a2fb0de2600f22e97,63774,ORG3402 Organisasjonsatferd og ledelse,1453130172,2016-01-18 16:16:12,1453131212,1040
5698db7a2fb0de2600f22e97,58950,ORG3402 Organisasjonsatferd og ledelse,1453132991,2016-01-18 17:03:11,1453132991,0
5698db7a2fb0de2600f22e97,36497,ORG3402 Organisasjonsatferd og ledelse,1453414174,2016-01-21 23:09:34,1453414175,1
5698db7a2fb0de2600f22e97,17847,ORG3402 Organisasjonsatferd og ledelse,1453658851,2016-01-24 19:07:31,1453658851,0
5698db7a2fb0de2600f22e97,87158,ORG3402 Organisasjonsatferd og ledelse,1454070181,2016-01-29 13:23:01,1454070215,34
5698db7a2fb0de2600f22e97,22512,ORG3402 Organisasjonsatferd og ledelse,1454897546,2016-02-08 03:12:26,1454897648,102
5698db7a2fb0de2600f22e97,73318,ORG3402 Organisasjonsatferd og ledelse,1455017955,2016-02-09 12:39:15,1455017964,9
5698db7a2fb0de2600f22e97,14789,ORG3402 Organisasjonsatferd og ledelse,1455019290,2016-02-09 13:01:30,1455019393,103
5698db7a2fb0de2600f22e97,26055,ORG3402 Organisasjonsatferd og ledelse,1455070626,2016-02-10 03:17:06,1455070735,109
5698db7a2fb0de2600f22e97,83725,ORG3402 Organisasjonsatferd og ledelse,1455480570,2016-02-14 21:09:30,1455480570,0
5698db7a2fb0de2600f22e98,12492,ORG3402 Organisasjonsatferd og ledelse,1452863299,2016-01-15 14:08:19,1452864297,998
5698db7a2fb0de2600f22e98,6813,ORG3402 Organisasjonsatferd og ledelse,1452870107,2016-01-15 16:01:47,1452870120,13
5698db7a2fb0de2600f22e98,15164,ORG3402 Organisasjonsatferd og ledelse,1452872033,2016-01-15 16:33:53,1452873052,1019
5698db7a2fb0de2600f22e98,57953,ORG3402 Organisasjonsatferd og ledelse,1452951121,2016-01-16 14:32:01,1452951122,1
5698db7a2fb0de2600f22e98,30333,ORG3402 Organisasjonsatferd og ledelse,1453817660,2016-01-26 15:14:20,1453817745,85
5698db7a2fb0de2600f22e98,81300,ORG3402 Organisasjonsatferd og ledelse,1454328049,2016-02-01 13:00:49,1454328051,2
5698db7a2fb0de2600f22e98,11235,ORG3402 Organisasjonsatferd og ledelse,1454412559,2016-02-02 12:29:19,1454412613,54
5698db7a2fb0de2600f22e98,98268,ORG3402 Organisasjonsatferd og ledelse,1455196613,2016-02-11 14:16:53,1455196795,182
5698db7a41a9d72100240d37,98777,ORG3402 Organisasjonsatferd og ledelse,1454332162,2016-02-01 14:09:22,1454332260,98
5698db7a41a9d72100240d37,86613,ORG3402 Organisasjonsatferd og ledelse,1454580787,2016-02-04 11:13:07,1454580787,0
5698db7a41a9d72100240d37,11876,ORG3402 Organisasjonsatferd og ledelse,1455410289,2016-02-14 01:38:09,1455410289,0
5698db7a41a9d72100240d39,79804,ORG3402 Organisasjonsatferd og ledelse,1454930225,2016-02-08 12:17:05,1454930263,38
5698db7a41a9d72100240d39,89112,ORG3402 Organisasjonsatferd og ledelse,1454936936,2016-02-08 14:08:56,1454937001,65
5698db7a41a9d72100240d39,36266,ORG3402 Organisasjonsatferd og ledelse,1454961321,2016-02-08 20:55:21,1454962061,740
5698db7a41a9d72100240d39,66561,ORG3402 Organisasjonsatferd og ledelse,1455047431,2016-02-09 20:50:31,1455048799,1368
5698db7a41a9d72100240d3a,96659,ORG3402 Organisasjonsatferd og ledelse,1452866922,2016-01-15 15:08:42,1452867077,155
5698db7a41a9d72100240d3a,27534,ORG3402 Organisasjonsatferd og ledelse,1453028797,2016-01-17 12:06:37,1453028809,12
5698db7a41a9d72100240d3a,21685,ORG3402 Organisasjonsatferd og ledelse,1453060440,2016-01-17 20:54:00,1453060511,71
5698db7a41a9d72100240d3a,99814,ORG3402 Organisasjonsatferd og ledelse,1454247952,2016-01-31 14:45:52,1454248117,165
5698db7a41a9d72100240d3a,75371,ORG3402 Organisasjonsatferd og ledelse,1454423163,2016-02-02 15:26:03,1454423267,104
5698db7a41a9d72100240d3a,25665,ORG3402 Organisasjonsatferd og ledelse,1454665616,2016-02-05 10:46:56,1454665653,37
5698db7a41a9d72100240d3a,61405,ORG3402 Organisasjonsatferd og ledelse,1454673781,2016-02-05 13:03:01,1454673781,0
5698db7a41a9d72100240d3a,85488,ORG3402 Organisasjonsatferd og ledelse,1454880077,2016-02-07 22:21:17,1454880295,218
5698db7a41a9d72100240d3a,40515,ORG3402 Organisasjonsatferd og ledelse,1455024106,2016-02-09 14:21:46,1455024141,35
5698db7a41a9d72100240d3a,32834,ORG3402 Organisasjonsatferd og ledelse,1455295371,2016-02-12 17:42:51,1455295459,88
5698db7a41a9d72100240d3c,93088,ORG3402 Organisasjonsatferd og ledelse,1453042243,2016-01-17 15:50:43,1453042303,60
5698db7a41a9d72100240d3c,40512,ORG3402 Organisasjonsatferd og ledelse,1453045648,2016-01-17 16:47:28,1453045730,82
5698db7a41a9d72100240d3c,97869,ORG3402 Organisasjonsatferd og ledelse,1453059151,2016-01-17 20:32:31,1453059169,18
5698db7a41a9d72100240d3c,68513,ORG3402 Organisasjonsatferd og ledelse,1453112243,2016-01-18 11:17:23,1453112484,241
5698db7a41a9d72100240d3c,48750,ORG3402 Organisasjonsatferd og ledelse,1453653389,2016-01-24 17:36:29,1453653504,115
5698db7a41a9d72100240d3c,6759,ORG3402 Organisasjonsatferd og ledelse,1453655411,2016-01-24 18:10:11,1453655418,7
5698db7a41a9d72100240d3c,53563,ORG3402 Organisasjonsatferd og ledelse,1453657116,2016-01-24 18:38:36,1453657142,26
5698db7b2fb0de2600f22eb6,62461,ORG3402 Organisasjonsatferd og ledelse,1453111146,2016-01-18 10:59:06,1453111261,115
5698db7b2fb0de2600f22eb6,59505,ORG3402 Organisasjonsatferd og ledelse,1453119337,2016-01-18 13:15:37,1453119338,1
5698db7b2fb0de2600f22eb6,21525,ORG3402 Organisasjonsatferd og ledelse,1453122315,2016-01-18 14:05:15,1453123018,703
5698db7b2fb0de2600f22eb6,70788,ORG3402 Organisasjonsatferd og ledelse,1454324579,2016-02-01 12:02:59,1454325164,585
5698db7b2fb0de2600f22eb6,82673,ORG3402 Organisasjonsatferd og ledelse,1454332260,2016-02-01 14:11:00,1454333673,1413
5698db7b41a9d72100240d5a,31855,ORG3402 Organisasjonsatferd og ledelse,1453124945,2016-01-18 14:49:05,1453125005,60
5698db7b41a9d72100240d5a,18326,ORG3402 Organisasjonsatferd og ledelse,1453127610,2016-01-18 15:33:30,1453128402,792
5698db7b41a9d72100240d5a,91590,ORG3402 Organisasjonsatferd og ledelse,1453147580,2016-01-18 21:06:20,1453147582,2
5698db7b41a9d72100240d5a,74158,ORG3402 Organisasjonsatferd og ledelse,1453328436,2016-01-20 23:20:36,1453328436,0
5698db7c2fb0de2600f22eb7,95015,ORG3402 Organisasjonsatferd og ledelse,1453314652,2016-01-20 19:30:52,1453314743,91
5698db7c2fb0de2600f22eb8,19657,ORG3402 Organisasjonsatferd og ledelse,1453119269,2016-01-18 13:14:29,1453119403,134
5698db7c2fb0de2600f22eb8,22307,ORG3402 Organisasjonsatferd og ledelse,1453122746,2016-01-18 14:12:26,1453122746,0
5698db7c2fb0de2600f22eb8,26133,ORG3402 Organisasjonsatferd og ledelse,1453124693,2016-01-18 14:44:53,1453124712,19
5698db7c2fb0de2600f22eb8,47932,ORG3402 Organisasjonsatferd og ledelse,1453129984,2016-01-18 16:13:04,1453130263,279
5698db7c2fb0de2600f22eb8,4378,ORG3402 Organisasjonsatferd og ledelse,1453137731,2016-01-18 18:22:11,1453138390,659
5698db7c2fb0de2600f22eb8,50236,ORG3402 Organisasjonsatferd og ledelse,1453667302,2016-01-24 21:28:22,1453667389,87
5698db7c2fb0de2600f22eb8,25871,ORG3402 Organisasjonsatferd og ledelse,1453668951,2016-01-24 21:55:51,1453668967,16
5698db7c2fb0de2600f22eb8,44151,ORG3402 Organisasjonsatferd og ledelse,1453721419,2016-01-25 12:30:19,1453721443,24
5698db7c2fb0de2600f22eb8,39032,ORG3402 Organisasjonsatferd og ledelse,1454324530,2016-02-01 12:02:10,1454324530,0
5698db7c2fb0de2600f22eb8,29696,ORG3402 Organisasjonsatferd og ledelse,1454929508,2016-02-08 12:05:08,1454929508,0
5698db7c2fb0de2600f22eb8,2618,ORG3402 Organisasjonsatferd og ledelse,1455132410,2016-02-10 20:26:50,1455132422,12
5698db7c2fb0de2600f22eb8,30082,ORG3402 Organisasjonsatferd og ledelse,1455453902,2016-02-14 13:45:02,1455453903,1
5698db7c2fb0de2600f22eb8,59009,ORG3402 Organisasjonsatferd og ledelse,1455489397,2016-02-14 23:36:37,1455489397,0
5698db7c2fb0de2600f22eb9,14174,ORG3402 Organisasjonsatferd og ledelse,1453116157,2016-01-18 12:22:37,1453116570,413
5698db7c2fb0de2600f22ebb,29683,ORG3402 Organisasjonsatferd og ledelse,1452864582,2016-01-15 14:29:42,1452864623,41
5698db7c2fb0de2600f22ebb,13082,ORG3402 Organisasjonsatferd og ledelse,1453051321,2016-01-17 18:22:01,1453051471,150
5698db7c2fb0de2600f22ebb,38132,ORG3402 Organisasjonsatferd og ledelse,1453114911,2016-01-18 12:01:51,1453115003,92
5698db7c2fb0de2600f22ebb,71835,nan,1454330678,2016-02-01 13:44:38,1454330814,136
5698db7c2fb0de2600f22ebb,56985,ORG3402 Organisasjonsatferd og ledelse,1454332351,2016-02-01 14:12:31,1454332403,52
5698db7c2fb0de2600f22ebb,36100,ORG3402 Organisasjonsatferd og ledelse,1455021995,2016-02-09 13:46:35,1455022055,60
5698db7c2fb0de2600f22ebb,18589,ORG3402 Organisasjonsatferd og ledelse,1455208167,2016-02-11 17:29:27,1455208167,0
5698db7c41a9d72100240d5c,56051,ORG3402 Organisasjonsatferd og ledelse,1452863108,2016-01-15 14:05:08,1452863108,0
5698db7c41a9d72100240d5c,24059,ORG3402 Organisasjonsatferd og ledelse,1452866665,2016-01-15 15:04:25,1452866667,2
5698db7c41a9d72100240d5c,40942,ORG3402 Organisasjonsatferd og ledelse,1453118210,2016-01-18 12:56:50,1453118836,626
5698db7c41a9d72100240d5c,3915,ORG3402 Organisasjonsatferd og ledelse,1453720006,2016-01-25 12:06:46,1453720108,102
5698db7c41a9d72100240d5c,79201,ORG3402 Organisasjonsatferd og ledelse,1454243312,2016-01-31 13:28:32,1454243779,467
5698db7c41a9d72100240d5c,7607,ORG3402 Organisasjonsatferd og ledelse,1454247230,2016-01-31 14:33:50,1454247528,298
5698db7c41a9d72100240d5c,89394,ORG3402 Organisasjonsatferd og ledelse,1454929355,2016-02-08 12:02:35,1454929356,1
5698db7c41a9d72100240d5c,78432,ORG3402 Organisasjonsatferd og ledelse,1454931879,2016-02-08 12:44:39,1454933290,1411
5698db7c41a9d72100240d5c,55046,ORG3402 Organisasjonsatferd og ledelse,1455132590,2016-02-10 20:29:50,1455132641,51
5698db7d2fb0de2600f22ec2,78229,ORG3402 Organisasjonsatferd og ledelse,1453210554,2016-01-19 14:35:54,1453210975,421
5698db7d41a9d72100240d5e,69194,ORG3402 Organisasjonsatferd og ledelse,1454327391,2016-02-01 12:49:51,1454327781,390
5698db7d41a9d72100240d5f,73464,ORG3402 Organisasjonsatferd og ledelse,1453913938,2016-01-27 17:58:58,1453914015,77
5698db7d41a9d72100240d62,38903,ORG3402 Organisasjonsatferd og ledelse,1453720109,2016-01-25 12:08:29,1453720225,116
5698db7d41a9d72100240d62,54939,ORG3402 Organisasjonsatferd og ledelse,1453721513,2016-01-25 12:31:53,1453721572,59
5698db7d41a9d72100240d63,32314,ORG3402 Organisasjonsatferd og ledelse,1453075075,2016-01-18 00:57:55,1453075117,42
5698db7d41a9d72100240d63,89838,ORG3402 Organisasjonsatferd og ledelse,1453198750,2016-01-19 11:19:10,1453198781,31
5698db7d41a9d72100240d63,37713,ORG3402 Organisasjonsatferd og ledelse,1453670535,2016-01-24 22:22:15,1453670604,69
5698db7d41a9d72100240d63,44337,ORG3402 Organisasjonsatferd og ledelse,1453725752,2016-01-25 13:42:32,1453725780,28
5698db7d41a9d72100240d63,24053,ORG3402 Organisasjonsatferd og ledelse,1454350810,2016-02-01 19:20:10,1454353112,2302
5698db7e2fb0de2600f22ecb,4841,ORG3402 Organisasjonsatferd og ledelse,1453126960,2016-01-18 15:22:40,1453127080,120
5698db7e2fb0de2600f22ecb,36879,ORG3402 Organisasjonsatferd og ledelse,1453372086,2016-01-21 11:28:06,1453372099,13
5698db7e2fb0de2600f22ecb,57141,ORG3402 Organisasjonsatferd og ledelse,1453467854,2016-01-22 14:04:14,1453467999,145
5698db7e2fb0de2600f22ecb,93067,ORG3402 Organisasjonsatferd og ledelse,1455446345,2016-02-14 11:39:05,1455446657,312
5698db7e2fb0de2600f22ecb,42282,ORG3402 Organisasjonsatferd og ledelse,1455463035,2016-02-14 16:17:15,1455463036,1
5698db7e41a9d72100240d64,23426,ORG3402 Organisasjonsatferd og ledelse,1453135496,2016-01-18 17:44:56,1453135786,290
5698db7e41a9d72100240d66,15796,ORG3402 Organisasjonsatferd og ledelse,1454932784,2016-02-08 12:59:44,1454932901,117
5698db7e41a9d72100240d66,14793,ORG3402 Organisasjonsatferd og ledelse,1455016199,2016-02-09 12:09:59,1455016313,114
5698db7f2fb0de2600f22edd,29171,ORG3402 Organisasjonsatferd og ledelse,1453225747,2016-01-19 18:49:07,1453225833,86
5698db7f2fb0de2600f22edd,82580,ORG3402 Organisasjonsatferd og ledelse,1453661851,2016-01-24 19:57:31,1453661918,67
5698db7f2fb0de2600f22edd,93867,ORG3402 Organisasjonsatferd og ledelse,1453668689,2016-01-24 21:51:29,1453668772,83
5698db7f2fb0de2600f22edd,14941,ORG3402 Organisasjonsatferd og ledelse,1453671029,2016-01-24 22:30:29,1453671030,1
5698db7f2fb0de2600f22edd,81932,ORG3402 Organisasjonsatferd og ledelse,1454864052,2016-02-07 17:54:12,1454864143,91
5698db7f2fb0de2600f22edf,70569,ORG3402 Organisasjonsatferd og ledelse,1453108160,2016-01-18 10:09:20,1453109333,1173
5698db7f2fb0de2600f22edf,5922,ORG3402 Organisasjonsatferd og ledelse,1453111446,2016-01-18 11:04:06,1453112748,1302
5698db7f41a9d72100240d82,51856,ORG3402 Organisasjonsatferd og ledelse,1453654037,2016-01-24 17:47:17,1453654109,72
5698db7f41a9d72100240d82,42446,ORG3402 Organisasjonsatferd og ledelse,1453657658,2016-01-24 18:47:38,1453657704,46
5698db7f41a9d72100240d82,3720,ORG3402 Organisasjonsatferd og ledelse,1453668713,2016-01-24 21:51:53,1453668714,1
5698db7f41a9d72100240d82,96580,ORG3402 Organisasjonsatferd og ledelse,1455111822,2016-02-10 14:43:42,1455112217,395
5698db7f41a9d72100240d83,27492,ORG3402 Organisasjonsatferd og ledelse,1453720186,2016-01-25 12:09:46,1453720296,110
5698db7f41a9d72100240d83,42244,ORG3402 Organisasjonsatferd og ledelse,1453741145,2016-01-25 17:59:05,1453741244,99
5698db7f41a9d72100240d83,30031,ORG3402 Organisasjonsatferd og ledelse,1454324575,2016-02-01 12:02:55,1454326249,1674
5698db7f41a9d72100240d83,61254,ORG3402 Organisasjonsatferd og ledelse,1455107519,2016-02-10 13:31:59,1455108535,1016
5698db7f41a9d72100240d83,38973,ORG3402 Organisasjonsatferd og ledelse,1455115569,2016-02-10 15:46:09,1455115570,1
5698db7f41a9d72100240d84,39774,ORG3402 Organisasjonsatferd og ledelse,1453119609,2016-01-18 13:20:09,1453119637,28
5698db7f41a9d72100240d84,28307,ORG3402 Organisasjonsatferd og ledelse,1453133696,2016-01-18 17:14:56,1453134125,429
5698db7f41a9d72100240d84,64956,ORG3402 Organisasjonsatferd og ledelse,1453137046,2016-01-18 18:10:46,1453137074,28
5698db7f41a9d72100240d84,92897,ORG3402 Organisasjonsatferd og ledelse,1453138381,2016-01-18 18:33:01,1453138443,62
5698db7f41a9d72100240d84,97338,ORG3402 Organisasjonsatferd og ledelse,1453148382,2016-01-18 21:19:42,1453148426,44
5698db7f41a9d72100240d84,94805,ORG3402 Organisasjonsatferd og ledelse,1454693539,2016-02-05 18:32:19,1454694139,600
5698db7f41a9d72100240d85,55989,ORG3402 Organisasjonsatferd og ledelse,1455093462,2016-02-10 09:37:42,1455093569,107
5698db7f41a9d72100240d85,18083,ORG3402 Organisasjonsatferd og ledelse,1455102744,2016-02-10 12:12:24,1455102744,0
5698db7f41a9d72100240d86,36789,ORG3402 Organisasjonsatferd og ledelse,1453123858,2016-01-18 14:30:58,1453123920,62
5698db7f41a9d72100240d86,43854,ORG3402 Organisasjonsatferd og ledelse,1454339402,2016-02-01 16:10:02,1454339486,84
5698db7f41a9d72100240d86,58165,ORG3402 Organisasjonsatferd og ledelse,1454923039,2016-02-08 10:17:19,1454923129,90
5698db7f41a9d72100240d86,89665,ORG3402 Organisasjonsatferd og ledelse,1454938192,2016-02-08 14:29:52,1454938590,398
5698db7f41a9d72100240d86,26368,ORG3402 Organisasjonsatferd og ledelse,1455376813,2016-02-13 16:20:13,1455379167,2354
5698db802fb0de2600f22eea,88445,ORG3402 Organisasjonsatferd og ledelse,1453807383,2016-01-26 12:23:03,1453807907,524
5698db802fb0de2600f22eea,84137,ORG3402 Organisasjonsatferd og ledelse,1453892677,2016-01-27 12:04:37,1453892934,257
5698db802fb0de2600f22eea,67758,ORG3402 Organisasjonsatferd og ledelse,1453900424,2016-01-27 14:13:44,1453900455,31
5698db802fb0de2600f22eea,36126,ORG3402 Organisasjonsatferd og ledelse,1454070052,2016-01-29 13:20:52,1454070063,11
5698db802fb0de2600f22eea,82079,ORG3402 Organisasjonsatferd og ledelse,1454421580,2016-02-02 14:59:40,1454422573,993
5698db802fb0de2600f22eea,41783,ORG3402 Organisasjonsatferd og ledelse,1455101337,2016-02-10 11:48:57,1455101338,1
5698db802fb0de2600f22eea,15511,ORG3402 Organisasjonsatferd og ledelse,1455106542,2016-02-10 13:15:42,1455106546,4
5698db802fb0de2600f22ef0,79669,ORG3402 Organisasjonsatferd og ledelse,1452872864,2016-01-15 16:47:44,1452872998,134
5698db802fb0de2600f22ef0,64009,ORG3402 Organisasjonsatferd og ledelse,1453652412,2016-01-24 17:20:12,1453653604,1192
5698db802fb0de2600f22ef0,40313,ORG3402 Organisasjonsatferd og ledelse,1453661277,2016-01-24 19:47:57,1453661282,5
5698db802fb0de2600f22ef0,78652,ORG3402 Organisasjonsatferd og ledelse,1453893649,2016-01-27 12:20:49,1453894233,584
5698db802fb0de2600f22ef0,18307,ORG3402 Organisasjonsatferd og ledelse,1453899476,2016-01-27 13:57:56,1453900328,852
5698db802fb0de2600f22ef0,32527,ORG3402 Organisasjonsatferd og ledelse,1453902385,2016-01-27 14:46:25,1453902443,58
5698db802fb0de2600f22ef0,40220,ORG3402 Organisasjonsatferd og ledelse,1454505602,2016-02-03 14:20:02,1454505602,0
5698db8041a9d72100240d88,47139,ORG3402 Organisasjonsatferd og ledelse,1453153397,2016-01-18 22:43:17,1453153436,39
5698db8041a9d72100240d88,75721,ORG3402 Organisasjonsatferd og ledelse,1453755744,2016-01-25 22:02:24,1453755799,55
5698db8041a9d72100240d88,85524,ORG3402 Organisasjonsatferd og ledelse,1454352892,2016-02-01 19:54:52,1454352957,65
5698db8041a9d72100240d88,39993,ORG3402 Organisasjonsatferd og ledelse,1454444350,2016-02-02 21:19:10,1454444351,1
5698db8041a9d72100240d88,78551,ORG3402 Organisasjonsatferd og ledelse,1454542605,2016-02-04 00:36:45,1454542606,1
5698db8041a9d72100240d88,6791,ORG3402 Organisasjonsatferd og ledelse,1454702656,2016-02-05 21:04:16,1454702676,20
5698db8041a9d72100240d95,54752,ORG3402 Organisasjonsatferd og ledelse,1453119795,2016-01-18 13:23:15,1453119827,32
5698db8041a9d72100240d95,92250,ORG3402 Organisasjonsatferd og ledelse,1453722157,2016-01-25 12:42:37,1453723425,1268
5698db8041a9d72100240d95,69306,ORG3402 Organisasjonsatferd og ledelse,1454261872,2016-01-31 18:37:52,1454261947,75
5698db8041a9d72100240d95,97559,ORG3402 Organisasjonsatferd og ledelse,1455136715,2016-02-10 21:38:35,1455138867,2152
5698db8141a9d72100240d98,70344,ORG3402 Organisasjonsatferd og ledelse,1455095876,2016-02-10 10:17:56,1455096012,136
5698db8141a9d72100240d99,37284,ORG3402 Organisasjonsatferd og ledelse,1453113539,2016-01-18 11:38:59,1453114273,734
5698db8141a9d72100240d99,73080,ORG3402 Organisasjonsatferd og ledelse,1453709816,2016-01-25 09:16:56,1453709842,26
5698db8141a9d72100240d99,62126,ORG3402 Organisasjonsatferd og ledelse,1453713442,2016-01-25 10:17:22,1453713460,18
5698db8141a9d72100240d99,44039,ORG3402 Organisasjonsatferd og ledelse,1454075281,2016-01-29 14:48:01,1454075290,9
5698db8141a9d72100240d99,32093,ORG3402 Organisasjonsatferd og ledelse,1454328340,2016-02-01 13:05:40,1454328398,58
5698db8141a9d72100240d99,82915,ORG3402 Organisasjonsatferd og ledelse,1455011049,2016-02-09 10:44:09,1455011159,110
5698db8141a9d72100240d99,46219,ORG3402 Organisasjonsatferd og ledelse,1455224033,2016-02-11 21:53:53,1455224033,0
5698db8241a9d72100240daa,25415,ORG3402 Organisasjonsatferd og ledelse,1453115097,2016-01-18 12:04:57,1453115647,550
5698db8241a9d72100240daa,21484,ORG3402 Organisasjonsatferd og ledelse,1453638986,2016-01-24 13:36:26,1453639015,29
5698db8241a9d72100240daa,32557,ORG3402 Organisasjonsatferd og ledelse,1453728725,2016-01-25 14:32:05,1453728750,25
5698db8241a9d72100240daa,27661,ORG3402 Organisasjonsatferd og ledelse,1453814967,2016-01-26 14:29:27,1453814968,1
5698db8241a9d72100240daa,32082,ORG3402 Organisasjonsatferd og ledelse,1455314012,2016-02-12 22:53:32,1455314020,8
5698db8241a9d72100240dab,17946,ORG3402 Organisasjonsatferd og ledelse,1453064095,2016-01-17 21:54:55,1453064409,314
5698db8241a9d72100240dab,51612,ORG3402 Organisasjonsatferd og ledelse,1453113880,2016-01-18 11:44:40,1453113881,1
5698db8241a9d72100240dab,70882,ORG3402 Organisasjonsatferd og ledelse,1453115148,2016-01-18 12:05:48,1453115262,114
5698db8241a9d72100240dab,91954,ORG3402 Organisasjonsatferd og ledelse,1453119266,2016-01-18 13:14:26,1453119868,602
5698db8241a9d72100240dab,57781,ORG3402 Organisasjonsatferd og ledelse,1453122751,2016-01-18 14:12:31,1453122768,17
5698db8241a9d72100240dab,85530,ORG3402 Organisasjonsatferd og ledelse,1453136603,2016-01-18 18:03:23,1453136610,7
5698db8241a9d72100240dab,27518,ORG3402 Organisasjonsatferd og ledelse,1453361653,2016-01-21 08:34:13,1453361653,0
5698db8241a9d72100240dab,93672,ORG3402 Organisasjonsatferd og ledelse,1453669684,2016-01-24 22:08:04,1453669688,4
5698db8241a9d72100240dab,90023,ORG3402 Organisasjonsatferd og ledelse,1454397527,2016-02-02 08:18:47,1454397527,0
5698db8241a9d72100240dac,84068,ORG3402 Organisasjonsatferd og ledelse,1452862775,2016-01-15 13:59:35,1452863047,272
5698db8241a9d72100240dac,95167,ORG3402 Organisasjonsatferd og ledelse,1453051085,2016-01-17 18:18:05,1453051187,102
5698db8241a9d72100240dac,41830,ORG3402 Organisasjonsatferd og ledelse,1453111099,2016-01-18 10:58:19,1453112119,1020
5698db8241a9d72100240dac,78901,ORG3402 Organisasjonsatferd og ledelse,1453982371,2016-01-28 12:59:31,1453983536,1165
5698db8241a9d72100240dac,85385,ORG3402 Organisasjonsatferd og ledelse,1454620670,2016-02-04 22:17:50,1454621159,489
5698db832fb0de2600f22f07,31906,ORG3402 Organisasjonsatferd og ledelse,1454954980,2016-02-08 19:09:40,1454955215,235
5698db832fb0de2600f22f08,79674,ORG3402 Organisasjonsatferd og ledelse,1452861924,2016-01-15 13:45:24,1452862063,139
5698db832fb0de2600f22f08,59252,ORG3402 Organisasjonsatferd og ledelse,1453055475,2016-01-17 19:31:15,1453055865,390
5698db842fb0de2600f22f0b,29642,ORG3402 Organisasjonsatferd og ledelse,1453288576,2016-01-20 12:16:16,1453288730,154
5698db842fb0de2600f22f0b,1009,ORG3402 Organisasjonsatferd og ledelse,1455101677,2016-02-10 11:54:37,1455101702,25
5698db842fb0de2600f22f0b,53555,ORG3402 Organisasjonsatferd og ledelse,1455114115,2016-02-10 15:21:55,1455114137,22
5698db842fb0de2600f22f0d,6320,ORG3402 Organisasjonsatferd og ledelse,1452865175,2016-01-15 14:39:35,1452865231,56
5698db842fb0de2600f22f0d,27063,ORG3402 Organisasjonsatferd og ledelse,1453050146,2016-01-17 18:02:26,1453050286,140
5698db842fb0de2600f22f0d,92663,ORG3402 Organisasjonsatferd og ledelse,1453060234,2016-01-17 20:50:34,1453060256,22
5698db842fb0de2600f22f0d,14591,ORG3402 Organisasjonsatferd og ledelse,1453668727,2016-01-24 21:52:07,1453668761,34
5698db842fb0de2600f22f0d,69585,ORG3402 Organisasjonsatferd og ledelse,1453678548,2016-01-25 00:35:48,1453678549,1
5698db842fb0de2600f22f0d,25739,ORG3402 Organisasjonsatferd og ledelse,1453916920,2016-01-27 18:48:40,1453916955,35
5698db842fb0de2600f22f0d,91456,ORG3402 Organisasjonsatferd og ledelse,1454878114,2016-02-07 21:48:34,1454878114,0
5698db8441a9d72100240db2,15915,ORG3402 Organisasjonsatferd og ledelse,1453725612,2016-01-25 13:40:12,1453725703,91
5698db8441a9d72100240db2,50213,ORG3402 Organisasjonsatferd og ledelse,1453894158,2016-01-27 12:29:18,1453894500,342
5698db8441a9d72100240db2,16395,ORG3402 Organisasjonsatferd og ledelse,1453898740,2016-01-27 13:45:40,1453898965,225
5698db8441a9d72100240db2,65432,ORG3402 Organisasjonsatferd og ledelse,1455012025,2016-02-09 11:00:25,1455012051,26
5698db8441a9d72100240db3,95052,ORG3402 Organisasjonsatferd og ledelse,1454324482,2016-02-01 12:01:22,1454324542,60
5698db8441a9d72100240db3,14242,ORG3402 Organisasjonsatferd og ledelse,1454333539,2016-02-01 14:32:19,1454333722,183
5698db8441a9d72100240db3,75857,ORG3402 Organisasjonsatferd og ledelse,1454390850,2016-02-02 06:27:30,1454391134,284
5698db8441a9d72100240db3,26829,ORG3402 Organisasjonsatferd og ledelse,1454392613,2016-02-02 06:56:53,1454392882,269
5698db8441a9d72100240db3,36435,ORG3402 Organisasjonsatferd og ledelse,1454394282,2016-02-02 07:24:42,1454394301,19
5698db8441a9d72100240db3,89213,ORG3402 Organisasjonsatferd og ledelse,1454396190,2016-02-02 07:56:30,1454396198,8
5698db8441a9d72100240db3,68272,ORG3402 Organisasjonsatferd og ledelse,1454929617,2016-02-08 12:06:57,1454930696,1079
5698db8441a9d72100240db6,38524,ORG3402 Organisasjonsatferd og ledelse,1453958195,2016-01-28 06:16:35,1453958532,337
5698db8441a9d72100240db6,52832,ORG3402 Organisasjonsatferd og ledelse,1454040054,2016-01-29 05:00:54,1454040112,58
5698db8441a9d72100240db6,70069,ORG3402 Organisasjonsatferd og ledelse,1454095574,2016-01-29 20:26:14,1454095575,1
5698db8441a9d72100240db6,65266,ORG3402 Organisasjonsatferd og ledelse,1454623801,2016-02-04 23:10:01,1454624038,237
5698db8441a9d72100240db6,31507,ORG3402 Organisasjonsatferd og ledelse,1455061362,2016-02-10 00:42:42,1455061364,2
5698db8441a9d72100240db6,31336,ORG3402 Organisasjonsatferd og ledelse,1455176335,2016-02-11 08:38:55,1455176335,0
5698db8441a9d72100240db6,34095,ORG3402 Organisasjonsatferd og ledelse,1455430497,2016-02-14 07:14:57,1455430497,0
5698db8441a9d72100240db6,82071,ORG3402 Organisasjonsatferd og ledelse,1455458897,2016-02-14 15:08:17,1455458897,0
5698db8441a9d72100240db8,4497,ORG3402 Organisasjonsatferd og ledelse,1453120626,2016-01-18 13:37:06,1453120685,59
5698db8441a9d72100240db8,13749,ORG3402 Organisasjonsatferd og ledelse,1453311010,2016-01-20 18:30:10,1453311650,640
5698db8441a9d72100240db8,47066,ORG3402 Organisasjonsatferd og ledelse,1454252001,2016-01-31 15:53:21,1454252234,233
5698db8441a9d72100240db8,14830,ORG3402 Organisasjonsatferd og ledelse,1454328689,2016-02-01 13:11:29,1454328696,7
5698db8441a9d72100240db8,22935,ORG3402 Organisasjonsatferd og ledelse,1454332615,2016-02-01 14:16:55,1454333012,397
5698db8441a9d72100240db9,95283,ORG3402 Organisasjonsatferd og ledelse,1453067245,2016-01-17 22:47:25,1453067803,558
5698db8441a9d72100240db9,7285,ORG3402 Organisasjonsatferd og ledelse,1453470921,2016-01-22 14:55:21,1453471244,323
5698db8441a9d72100240db9,3280,ORG3402 Organisasjonsatferd og ledelse,1453514328,2016-01-23 02:58:48,1453514330,2
5698db8441a9d72100240db9,35818,ORG3402 Organisasjonsatferd og ledelse,1453675173,2016-01-24 23:39:33,1453675416,243
5698db8441a9d72100240db9,79036,ORG3402 Organisasjonsatferd og ledelse,1453679969,2016-01-25 00:59:29,1453679972,3
5698db8441a9d72100240db9,19185,ORG3402 Organisasjonsatferd og ledelse,1454970972,2016-02-08 23:36:12,1454971108,136
5698db8441a9d72100240db9,98637,ORG3402 Organisasjonsatferd og ledelse,1455217824,2016-02-11 20:10:24,1455217891,67
5698db852fb0de2600f22f10,75770,ORG3402 Organisasjonsatferd og ledelse,1452863914,2016-01-15 14:18:34,1452863915,1
5698db852fb0de2600f22f13,28649,ORG3402 Organisasjonsatferd og ledelse,1452864060,2016-01-15 14:21:00,1452864206,146
5698db852fb0de2600f22f14,6184,ORG3402 Organisasjonsatferd og ledelse,1452941234,2016-01-16 11:47:14,1452941431,197
5698db852fb0de2600f22f14,87125,ORG3402 Organisasjonsatferd og ledelse,1453153320,2016-01-18 22:42:00,1453154426,1106
5698db852fb0de2600f22f14,15324,ORG3402 Organisasjonsatferd og ledelse,1453500778,2016-01-22 23:12:58,1453500869,91
5698db852fb0de2600f22f14,73341,ORG3402 Organisasjonsatferd og ledelse,1454855655,2016-02-07 15:34:15,1454855726,71
5698db852fb0de2600f22f14,23550,ORG3402 Organisasjonsatferd og ledelse,1455127096,2016-02-10 18:58:16,1455127096,0
5698db852fb0de2600f22f14,44730,ORG3402 Organisasjonsatferd og ledelse,1455298368,2016-02-12 18:32:48,1455298370,2
5698db8541a9d72100240dd2,62296,ORG3402 Organisasjonsatferd og ledelse,1453469787,2016-01-22 14:36:27,1453470377,590
5698db8541a9d72100240dd2,89585,ORG3402 Organisasjonsatferd og ledelse,1453705853,2016-01-25 08:10:53,1453705986,133
5698db8541a9d72100240dd2,5052,ORG3402 Organisasjonsatferd og ledelse,1453714591,2016-01-25 10:36:31,1453714659,68
5698db8541a9d72100240dd2,2929,ORG3402 Organisasjonsatferd og ledelse,1453717108,2016-01-25 11:18:28,1453717215,107
5698db8541a9d72100240dd2,64272,ORG3402 Organisasjonsatferd og ledelse,1453719849,2016-01-25 12:04:09,1453720419,570
5698db8541a9d72100240dd2,79013,ORG3402 Organisasjonsatferd og ledelse,1454312701,2016-02-01 08:45:01,1454313044,343
5698db8541a9d72100240dd2,74764,ORG3402 Organisasjonsatferd og ledelse,1454318553,2016-02-01 10:22:33,1454318572,19
5698db8541a9d72100240dd2,53374,ORG3402 Organisasjonsatferd og ledelse,1454324058,2016-02-01 11:54:18,1454324127,69
5698db8541a9d72100240dd2,94755,ORG3402 Organisasjonsatferd og ledelse,1454928604,2016-02-08 11:50:04,1454930451,1847
5698db862fb0de2600f22f32,44669,ORG3402 Organisasjonsatferd og ledelse,1454437463,2016-02-02 19:24:23,1454437690,227
5698db862fb0de2600f22f32,81844,ORG3402 Organisasjonsatferd og ledelse,1454498917,2016-02-03 12:28:37,1454499023,106
5698db862fb0de2600f22f33,19531,ORG3402 Organisasjonsatferd og ledelse,1454614300,2016-02-04 20:31:40,1454614467,167
5698db862fb0de2600f22f33,42021,ORG3402 Organisasjonsatferd og ledelse,1455022513,2016-02-09 13:55:13,1455022974,461
5698db862fb0de2600f22f33,2471,ORG3402 Organisasjonsatferd og ledelse,1455026323,2016-02-09 14:58:43,1455026334,11
5698db862fb0de2600f22f34,66504,ORG3402 Organisasjonsatferd og ledelse,1453118043,2016-01-18 12:54:03,1453118079,36
5698db862fb0de2600f22f34,86843,ORG3402 Organisasjonsatferd og ledelse,1455031377,2016-02-09 16:22:57,1455031435,58
5698db8641a9d72100240dd5,13109,ORG3402 Organisasjonsatferd og ledelse,1452866643,2016-01-15 15:04:03,1452866764,121
5698db8641a9d72100240dd5,90914,ORG3402 Organisasjonsatferd og ledelse,1452932715,2016-01-16 09:25:15,1452932716,1
5698db8641a9d72100240dd5,22728,ORG3402 Organisasjonsatferd og ledelse,1453052218,2016-01-17 18:36:58,1453052218,0
5698db8641a9d72100240dd5,50424,ORG3402 Organisasjonsatferd og ledelse,1453127469,2016-01-18 15:31:09,1453127594,125
5698db8641a9d72100240dd5,19917,ORG3402 Organisasjonsatferd og ledelse,1453670743,2016-01-24 22:25:43,1453670774,31
5698db8641a9d72100240dd5,9927,ORG3402 Organisasjonsatferd og ledelse,1454329603,2016-02-01 13:26:43,1454329657,54
5698db8641a9d72100240dd5,4210,ORG3402 Organisasjonsatferd og ledelse,1454496206,2016-02-03 11:43:26,1454496437,231
5698db8641a9d72100240dd6,55503,ORG3402 Organisasjonsatferd og ledelse,1455012535,2016-02-09 11:08:55,1455012535,0
5698db8641a9d72100240dd7,94411,ORG3402 Organisasjonsatferd og ledelse,1453036887,2016-01-17 14:21:27,1453036887,0
5698db8641a9d72100240dd7,83385,ORG3402 Organisasjonsatferd og ledelse,1453052560,2016-01-17 18:42:40,1453052561,1
5698db8641a9d72100240dd7,26662,ORG3402 Organisasjonsatferd og ledelse,1453089693,2016-01-18 05:01:33,1453089789,96
5698db8641a9d72100240dd7,14114,ORG3402 Organisasjonsatferd og ledelse,1453091010,2016-01-18 05:23:30,1453091301,291
5698db8641a9d72100240dd7,92545,ORG3402 Organisasjonsatferd og ledelse,1453130110,2016-01-18 16:15:10,1453130112,2
5698db8641a9d72100240dd7,32252,ORG3402 Organisasjonsatferd og ledelse,1454412328,2016-02-02 12:25:28,1454412366,38
5698db8641a9d72100240dd7,99183,ORG3402 Organisasjonsatferd og ledelse,1454682761,2016-02-05 15:32:41,1454682780,19
5698db872fb0de2600f22f3a,15077,ORG3402 Organisasjonsatferd og ledelse,1452885568,2016-01-15 20:19:28,1452886066,498
5698db872fb0de2600f22f3a,49129,ORG3402 Organisasjonsatferd og ledelse,1452944072,2016-01-16 12:34:32,1452944308,236
5698db872fb0de2600f22f3a,691,ORG3402 Organisasjonsatferd og ledelse,1453074638,2016-01-18 00:50:38,1453074675,37
5698db872fb0de2600f22f3a,54527,ORG3402 Organisasjonsatferd og ledelse,1453114480,2016-01-18 11:54:40,1453114765,285
5698db872fb0de2600f22f3a,87986,ORG3402 Organisasjonsatferd og ledelse,1453127389,2016-01-18 15:29:49,1453127390,1
5698db872fb0de2600f22f3a,12462,ORG3402 Organisasjonsatferd og ledelse,1453719711,2016-01-25 12:01:51,1453720578,867
5698db872fb0de2600f22f3a,15217,ORG3402 Organisasjonsatferd og ledelse,1453729417,2016-01-25 14:43:37,1453729523,106
5698db872fb0de2600f22f3a,29720,ORG3402 Organisasjonsatferd og ledelse,1454352521,2016-02-01 19:48:41,1454353343,822
5698db872fb0de2600f22f3c,71670,ORG3402 Organisasjonsatferd og ledelse,1453651363,2016-01-24 17:02:43,1453651921,558
5698db872fb0de2600f22f3c,75186,ORG3402 Organisasjonsatferd og ledelse,1453664754,2016-01-24 20:45:54,1453664764,10
5698db872fb0de2600f22f3c,17528,ORG3402 Organisasjonsatferd og ledelse,1453669980,2016-01-24 22:13:00,1453670016,36
5698db872fb0de2600f22f3c,4015,ORG3402 Organisasjonsatferd og ledelse,1453726430,2016-01-25 13:53:50,1453726516,86
5698db8741a9d72100240dd8,87177,ORG3402 Organisasjonsatferd og ledelse,1453221555,2016-01-19 17:39:15,1453221963,408
5698db8741a9d72100240dd8,33821,ORG3402 Organisasjonsatferd og ledelse,1453471679,2016-01-22 15:07:59,1453471679,0
5698db8741a9d72100240dd8,30458,ORG3402 Organisasjonsatferd og ledelse,1453473036,2016-01-22 15:30:36,1453474087,1051
5698db8741a9d72100240dd8,20531,ORG3402 Organisasjonsatferd og ledelse,1453658779,2016-01-24 19:06:19,1453658804,25
5698db8741a9d72100240dd8,11276,ORG3402 Organisasjonsatferd og ledelse,1453844364,2016-01-26 22:39:24,1453844372,8
5698db8741a9d72100240dd8,49761,ORG3402 Organisasjonsatferd og ledelse,1454366131,2016-02-01 23:35:31,1454366247,116
5698db8741a9d72100240dd8,96107,ORG3402 Organisasjonsatferd og ledelse,1454955767,2016-02-08 19:22:47,1454955804,37
5698db8741a9d72100240dd8,6915,ORG3402 Organisasjonsatferd og ledelse,1455190425,2016-02-11 12:33:45,1455190425,0
5698db8741a9d72100240dd8,43624,ORG3402 Organisasjonsatferd og ledelse,1455487591,2016-02-14 23:06:31,1455487591,0
5698db8741a9d72100240dd9,35486,ORG3402 Organisasjonsatferd og ledelse,1453118067,2016-01-18 12:54:27,1453118894,827
5698db8741a9d72100240dd9,10757,ORG3402 Organisasjonsatferd og ledelse,1453297844,2016-01-20 14:50:44,1453297895,51
5698db8741a9d72100240dd9,5075,ORG3402 Organisasjonsatferd og ledelse,1453397654,2016-01-21 18:34:14,1453397778,124
5698db8741a9d72100240dd9,46686,ORG3402 Organisasjonsatferd og ledelse,1455033042,2016-02-09 16:50:42,1455033278,236
5698db8741a9d72100240dda,93352,ORG3402 Organisasjonsatferd og ledelse,1454255070,2016-01-31 16:44:30,1454255070,0
5698db8741a9d72100240dda,42031,ORG3402 Organisasjonsatferd og ledelse,1455094937,2016-02-10 10:02:17,1455094964,27
5698db8741a9d72100240ddb,54437,ORG3402 Organisasjonsatferd og ledelse,1453036537,2016-01-17 14:15:37,1453036711,174
5698db8741a9d72100240ddb,52934,ORG3402 Organisasjonsatferd og ledelse,1453055112,2016-01-17 19:25:12,1453055118,6
5698db8741a9d72100240ddb,84386,ORG3402 Organisasjonsatferd og ledelse,1453065413,2016-01-17 22:16:53,1453065414,1
5698db8741a9d72100240ddb,46458,ORG3402 Organisasjonsatferd og ledelse,1453146638,2016-01-18 20:50:38,1453146639,1
5698db8741a9d72100240ddb,25972,ORG3402 Organisasjonsatferd og ledelse,1453677714,2016-01-25 00:21:54,1453677715,1
5698db8741a9d72100240ddb,76588,ORG3402 Organisasjonsatferd og ledelse,1454265979,2016-01-31 19:46:19,1454266003,24
5698db8741a9d72100240ddb,18208,ORG3402 Organisasjonsatferd og ledelse,1454667816,2016-02-05 11:23:36,1454667843,27
5698db8741a9d72100240ddb,51882,ORG3402 Organisasjonsatferd og ledelse,1454878381,2016-02-07 21:53:01,1454878388,7
5698db8741a9d72100240ddb,24249,ORG3402 Organisasjonsatferd og ledelse,1454923492,2016-02-08 10:24:52,1454923552,60
5698db8741a9d72100240ddc,21226,ORG3402 Organisasjonsatferd og ledelse,1453044232,2016-01-17 16:23:52,1453045616,1384
5698db8741a9d72100240ddc,65205,ORG3402 Organisasjonsatferd og ledelse,1453046957,2016-01-17 17:09:17,1453046957,0
5698db8741a9d72100240ddc,32559,ORG3402 Organisasjonsatferd og ledelse,1453075912,2016-01-18 01:11:52,1453076179,267
5698db8741a9d72100240ddc,90614,ORG3402 Organisasjonsatferd og ledelse,1453114935,2016-01-18 12:02:15,1453115787,852
5698db8741a9d72100240ddc,95011,ORG3402 Organisasjonsatferd og ledelse,1453117474,2016-01-18 12:44:34,1453117474,0
5698db8741a9d72100240ddc,96381,ORG3402 Organisasjonsatferd og ledelse,1453118825,2016-01-18 13:07:05,1453119999,1174
5698db8741a9d72100240ddc,42797,ORG3402 Organisasjonsatferd og ledelse,1453208673,2016-01-19 14:04:33,1453208705,32
5698db8741a9d72100240ddc,45433,ORG3402 Organisasjonsatferd og ledelse,1453237223,2016-01-19 22:00:23,1453237255,32
5698db8741a9d72100240ddc,4510,ORG3402 Organisasjonsatferd og ledelse,1453459783,2016-01-22 11:49:43,1453459870,87
5698db8741a9d72100240ddc,33043,ORG3402 Organisasjonsatferd og ledelse,1453550591,2016-01-23 13:03:11,1453550591,0
5698db8741a9d72100240ddc,18880,ORG3402 Organisasjonsatferd og ledelse,1453649092,2016-01-24 16:24:52,1453649092,0
5698db8741a9d72100240ddc,77998,ORG3402 Organisasjonsatferd og ledelse,1453719606,2016-01-25 12:00:06,1453720655,1049
5698db8741a9d72100240ddc,17664,ORG3402 Organisasjonsatferd og ledelse,1453723456,2016-01-25 13:04:16,1453723953,497
5698db8741a9d72100240ddc,14309,ORG3402 Organisasjonsatferd og ledelse,1454250431,2016-01-31 15:27:11,1454250778,347
5698db8741a9d72100240ddc,18682,ORG3402 Organisasjonsatferd og ledelse,1454324614,2016-02-01 12:03:34,1454324653,39
5698db8741a9d72100240ddc,63078,ORG3402 Organisasjonsatferd og ledelse,1454326069,2016-02-01 12:27:49,1454326121,52
5698db8741a9d72100240ddc,42976,ORG3402 Organisasjonsatferd og ledelse,1454328257,2016-02-01 13:04:17,1454328747,490
5698db8741a9d72100240ddc,46085,ORG3402 Organisasjonsatferd og ledelse,1454330635,2016-02-01 13:43:55,1454330635,0
5698db8741a9d72100240ddc,99269,ORG3402 Organisasjonsatferd og ledelse,1454332139,2016-02-01 14:08:59,1454332139,0
5698db8741a9d72100240ddc,77020,ORG3402 Organisasjonsatferd og ledelse,1454333656,2016-02-01 14:34:16,1454333660,4
5698db8741a9d72100240ddc,57176,ORG3402 Organisasjonsatferd og ledelse,1454678245,2016-02-05 14:17:25,1454678349,104
5698db8741a9d72100240ddc,39604,ORG3402 Organisasjonsatferd og ledelse,1454680794,2016-02-05 14:59:54,1454680794,0
5698db8741a9d72100240ddc,56648,ORG3402 Organisasjonsatferd og ledelse,1454929452,2016-02-08 12:04:12,1454929452,0
5698db8741a9d72100240ddc,88924,ORG3402 Organisasjonsatferd og ledelse,1454932994,2016-02-08 13:03:14,1454932994,0
5698db8741a9d72100240ddc,85478,ORG3402 Organisasjonsatferd og ledelse,1454934420,2016-02-08 13:27:00,1454934420,0
5698db8741a9d72100240ddc,13767,ORG3402 Organisasjonsatferd og ledelse,1454937650,2016-02-08 14:20:50,1454938440,790
5698db8741a9d72100240ddc,93050,ORG3402 Organisasjonsatferd og ledelse,1455014894,2016-02-09 11:48:14,1455014917,23
5698db8741a9d72100240ddc,80987,ORG3402 Organisasjonsatferd og ledelse,1455020135,2016-02-09 13:15:35,1455020136,1
5698db882fb0de2600f22f3e,2535,ORG3402 Organisasjonsatferd og ledelse,1454412163,2016-02-02 12:22:43,1454412164,1
5698db882fb0de2600f22f3f,58685,ORG3402 Organisasjonsatferd og ledelse,1452871269,2016-01-15 16:21:09,1452871541,272
5698db882fb0de2600f22f3f,30626,ORG3402 Organisasjonsatferd og ledelse,1453836851,2016-01-26 20:34:11,1453837829,978
5698db882fb0de2600f22f3f,50458,ORG3402 Organisasjonsatferd og ledelse,1455047335,2016-02-09 20:48:55,1455047336,1
5698db882fb0de2600f22f40,64232,ORG3402 Organisasjonsatferd og ledelse,1454262529,2016-01-31 18:48:49,1454262913,384
5698db882fb0de2600f22f40,8976,ORG3402 Organisasjonsatferd og ledelse,1454930786,2016-02-08 12:26:26,1454930960,174
5698db882fb0de2600f22f40,90342,ORG3402 Organisasjonsatferd og ledelse,1455023313,2016-02-09 14:08:33,1455023325,12
5698db8841a9d72100240def,31248,ORG3402 Organisasjonsatferd og ledelse,1453124258,2016-01-18 14:37:38,1453124371,113
5698db8841a9d72100240def,4424,ORG3402 Organisasjonsatferd og ledelse,1453134087,2016-01-18 17:21:27,1453135872,1785
5698db8841a9d72100240def,58584,ORG3402 Organisasjonsatferd og ledelse,1453933224,2016-01-27 23:20:24,1453933263,39
5698db8841a9d72100240def,63486,ORG3402 Organisasjonsatferd og ledelse,1454417712,2016-02-02 13:55:12,1454417882,170
5698db8841a9d72100240def,33841,ORG3402 Organisasjonsatferd og ledelse,1454419753,2016-02-02 14:29:13,1454419753,0
5698db8841a9d72100240def,50416,ORG3402 Organisasjonsatferd og ledelse,1454967136,2016-02-08 22:32:16,1454969360,2224
5698db8841a9d72100240dfe,76791,ORG3402 Organisasjonsatferd og ledelse,1453216275,2016-01-19 16:11:15,1453216275,0
5698db8841a9d72100240dfe,29966,ORG3402 Organisasjonsatferd og ledelse,1453217554,2016-01-19 16:32:34,1453217870,316
5698db8841a9d72100240dfe,7002,ORG3402 Organisasjonsatferd og ledelse,1453219105,2016-01-19 16:58:25,1453219107,2
5698db8841a9d72100240dfe,22108,ORG3402 Organisasjonsatferd og ledelse,1453309561,2016-01-20 18:06:01,1453309570,9
5698db8841a9d72100240dfe,75585,ORG3402 Organisasjonsatferd og ledelse,1453719888,2016-01-25 12:04:48,1453720764,876
5698db8841a9d72100240dfe,457,ORG3402 Organisasjonsatferd og ledelse,1453728217,2016-01-25 14:23:37,1453728218,1
5698db8841a9d72100240dfe,58478,ORG3402 Organisasjonsatferd og ledelse,1454274599,2016-01-31 22:09:59,1454274622,23
5698db8841a9d72100240dfe,22024,ORG3402 Organisasjonsatferd og ledelse,1454933405,2016-02-08 13:10:05,1454933449,44
5698db8841a9d72100240dfe,96382,ORG3402 Organisasjonsatferd og ledelse,1454938450,2016-02-08 14:34:10,1454938541,91
5698db8841a9d72100240dfe,38587,ORG3402 Organisasjonsatferd og ledelse,1454972065,2016-02-08 23:54:25,1454972118,53
5698db8841a9d72100240dfe,31081,ORG3402 Organisasjonsatferd og ledelse,1455042114,2016-02-09 19:21:54,1455042114,0
5698db8841a9d72100240dfe,9958,ORG3402 Organisasjonsatferd og ledelse,1455461504,2016-02-14 15:51:44,1455461504,0
5698db892fb0de2600f22f57,95576,ORG3402 Organisasjonsatferd og ledelse,1453115108,2016-01-18 12:05:08,1453115344,236
5698db892fb0de2600f22f57,20519,ORG3402 Organisasjonsatferd og ledelse,1453118398,2016-01-18 12:59:58,1453118446,48
5698db892fb0de2600f22f57,33320,ORG3402 Organisasjonsatferd og ledelse,1453122696,2016-01-18 14:11:36,1453122714,18
5698db892fb0de2600f22f57,66190,ORG3402 Organisasjonsatferd og ledelse,1453719555,2016-01-25 11:59:15,1453720608,1053
5698db892fb0de2600f22f57,84142,ORG3402 Organisasjonsatferd og ledelse,1454324439,2016-02-01 12:00:39,1454324452,13
5698db892fb0de2600f22f57,77337,ORG3402 Organisasjonsatferd og ledelse,1454326754,2016-02-01 12:39:14,1454326754,0
5698db892fb0de2600f22f57,92487,ORG3402 Organisasjonsatferd og ledelse,1454333135,2016-02-01 14:25:35,1454333135,0
5698db892fb0de2600f22f57,32812,ORG3402 Organisasjonsatferd og ledelse,1455127524,2016-02-10 19:05:24,1455127536,12
5698db892fb0de2600f22f5c,64601,ORG3402 Organisasjonsatferd og ledelse,1453112757,2016-01-18 11:25:57,1453113102,345
5698db892fb0de2600f22f5c,54434,ORG3402 Organisasjonsatferd og ledelse,1453672741,2016-01-24 22:59:01,1453672741,0
5698db892fb0de2600f22f5c,20992,ORG3402 Organisasjonsatferd og ledelse,1454288185,2016-02-01 01:56:25,1454288310,125
5698db892fb0de2600f22f5c,79258,ORG3402 Organisasjonsatferd og ledelse,1454366643,2016-02-01 23:44:03,1454366834,191
5698db892fb0de2600f22f5c,84886,ORG3402 Organisasjonsatferd og ledelse,1454444037,2016-02-02 21:13:57,1454444073,36
5698db892fb0de2600f22f5c,9162,ORG3402 Organisasjonsatferd og ledelse,1454883338,2016-02-07 23:15:38,1454883390,52
5698db892fb0de2600f22f5c,10409,ORG3402 Organisasjonsatferd og ledelse,1454885899,2016-02-07 23:58:19,1454885899,0
5698db892fb0de2600f22f5c,26906,ORG3402 Organisasjonsatferd og ledelse,1454921063,2016-02-08 09:44:23,1454921115,52
5698db892fb0de2600f22f5c,26690,ORG3402 Organisasjonsatferd og ledelse,1455064526,2016-02-10 01:35:26,1455064598,72
5698db892fb0de2600f22f5c,96622,ORG3402 Organisasjonsatferd og ledelse,1455146359,2016-02-11 00:19:19,1455146360,1
5698db8941a9d72100240e00,71738,ORG3402 Organisasjonsatferd og ledelse,1453842636,2016-01-26 22:10:36,1453842853,217
5698db8a2fb0de2600f22f5e,87881,ORG3402 Organisasjonsatferd og ledelse,1453108073,2016-01-18 10:07:53,1453109121,1048
5698db8a2fb0de2600f22f5e,96292,ORG3402 Organisasjonsatferd og ledelse,1453111438,2016-01-18 11:03:58,1453111776,338
5698db8a2fb0de2600f22f5e,46452,ORG3402 Organisasjonsatferd og ledelse,1453710657,2016-01-25 09:30:57,1453710686,29
5698db8a2fb0de2600f22f5e,88036,ORG3402 Organisasjonsatferd og ledelse,1453713530,2016-01-25 10:18:50,1453715320,1790
5698db8a2fb0de2600f22f5e,19595,ORG3402 Organisasjonsatferd og ledelse,1454422739,2016-02-02 15:18:59,1454422739,0
5698db8a2fb0de2600f22f5e,74302,ORG3402 Organisasjonsatferd og ledelse,1454495340,2016-02-03 11:29:00,1454495412,72
5698db8a2fb0de2600f22f5e,20771,ORG3402 Organisasjonsatferd og ledelse,1454499908,2016-02-03 12:45:08,1454499965,57
5698db8a2fb0de2600f22f5e,40877,ORG3402 Organisasjonsatferd og ledelse,1454923096,2016-02-08 10:18:16,1454923186,90
5698db8a2fb0de2600f22f5e,53632,ORG3402 Organisasjonsatferd og ledelse,1455028402,2016-02-09 15:33:22,1455028479,77
5698db8a2fb0de2600f22f5e,37619,ORG3402 Organisasjonsatferd og ledelse,1455030795,2016-02-09 16:13:15,1455030795,0
5698db8a2fb0de2600f22f5f,22067,ORG3402 Organisasjonsatferd og ledelse,1453720268,2016-01-25 12:11:08,1453720398,130
5698db8a2fb0de2600f22f5f,23073,ORG3402 Organisasjonsatferd og ledelse,1454597506,2016-02-04 15:51:46,1454597506,0
5698db8a2fb0de2600f22f5f,27884,ORG3402 Organisasjonsatferd og ledelse,1454930387,2016-02-08 12:19:47,1454930387,0
5698db8a2fb0de2600f22f5f,40861,ORG3402 Organisasjonsatferd og ledelse,1454935307,2016-02-08 13:41:47,1454935324,17
5698db8a2fb0de2600f22f5f,52814,ORG3402 Organisasjonsatferd og ledelse,1455481587,2016-02-14 21:26:27,1455482163,576
5698db8a2fb0de2600f22f61,97048,ORG3402 Organisasjonsatferd og ledelse,1453898293,2016-01-27 13:38:13,1453899340,1047
5698db8a2fb0de2600f22f61,4821,ORG3402 Organisasjonsatferd og ledelse,1455187861,2016-02-11 11:51:01,1455187873,12
5698db8a2fb0de2600f22f61,90154,ORG3402 Organisasjonsatferd og ledelse,1455189121,2016-02-11 12:12:01,1455189123,2
5698db8a41a9d72100240e04,43843,ORG3402 Organisasjonsatferd og ledelse,1453075850,2016-01-18 01:10:50,1453075912,62
5698db8a41a9d72100240e05,78977,ORG3402 Organisasjonsatferd og ledelse,1453719980,2016-01-25 12:06:20,1453720018,38
5698db8a41a9d72100240e05,28427,ORG3402 Organisasjonsatferd og ledelse,1453725493,2016-01-25 13:38:13,1453725581,88
5698db8a41a9d72100240e06,87304,ORG3402 Organisasjonsatferd og ledelse,1453115114,2016-01-18 12:05:14,1453115941,827
5698db8a41a9d72100240e06,48637,ORG3402 Organisasjonsatferd og ledelse,1453119864,2016-01-18 13:24:24,1453120790,926
5698db8a41a9d72100240e06,32633,ORG3402 Organisasjonsatferd og ledelse,1453122379,2016-01-18 14:06:19,1453123683,1304
5698db8a41a9d72100240e06,55199,ORG3402 Organisasjonsatferd og ledelse,1453488022,2016-01-22 19:40:22,1453488038,16
5698db8a41a9d72100240e06,67014,ORG3402 Organisasjonsatferd og ledelse,1453562229,2016-01-23 16:17:09,1453562245,16
5698db8a41a9d72100240e06,84225,ORG3402 Organisasjonsatferd og ledelse,1453674793,2016-01-24 23:33:13,1453674794,1
5698db8a41a9d72100240e06,96421,ORG3402 Organisasjonsatferd og ledelse,1453679911,2016-01-25 00:58:31,1453679912,1
5698db8a41a9d72100240e06,74838,ORG3402 Organisasjonsatferd og ledelse,1453721448,2016-01-25 12:30:48,1453721520,72
5698db8a41a9d72100240e06,78873,ORG3402 Organisasjonsatferd og ledelse,1453725629,2016-01-25 13:40:29,1453725629,0
5698db8a41a9d72100240e06,52561,ORG3402 Organisasjonsatferd og ledelse,1453727390,2016-01-25 14:09:50,1453728384,994
5698db8a41a9d72100240e06,40394,ORG3402 Organisasjonsatferd og ledelse,1453758186,2016-01-25 22:43:06,1453758186,0
5698db8a41a9d72100240e06,52419,ORG3402 Organisasjonsatferd og ledelse,1453763263,2016-01-26 00:07:43,1453763283,20
5698db8a41a9d72100240e06,64482,ORG3402 Organisasjonsatferd og ledelse,1454325197,2016-02-01 12:13:17,1454325204,7
5698db8a41a9d72100240e06,26056,ORG3402 Organisasjonsatferd og ledelse,1454330658,2016-02-01 13:44:18,1454330666,8
5698db8a41a9d72100240e06,77560,ORG3402 Organisasjonsatferd og ledelse,1454870403,2016-02-07 19:40:03,1454870412,9
5698db8a41a9d72100240e06,30334,ORG3402 Organisasjonsatferd og ledelse,1454929319,2016-02-08 12:01:59,1454929639,320
5698db8a41a9d72100240e06,83022,ORG3402 Organisasjonsatferd og ledelse,1455201036,2016-02-11 15:30:36,1455201180,144
5698db8a41a9d72100240e07,45267,ORG3402 Organisasjonsatferd og ledelse,1454421159,2016-02-02 14:52:39,1454421159,0
5698db8b2fb0de2600f22f62,86090,ORG3402 Organisasjonsatferd og ledelse,1453878187,2016-01-27 08:03:07,1453878741,554
5698db8b2fb0de2600f22f62,17631,ORG3402 Organisasjonsatferd og ledelse,1455109945,2016-02-10 14:12:25,1455109976,31
5698db8b2fb0de2600f22f63,83144,ORG3402 Organisasjonsatferd og ledelse,1453125564,2016-01-18 14:59:24,1453125564,0
5698db8b2fb0de2600f22f63,94953,ORG3402 Organisasjonsatferd og ledelse,1453128405,2016-01-18 15:46:45,1453128487,82
5698db8b2fb0de2600f22f63,26437,ORG3402 Organisasjonsatferd og ledelse,1453132246,2016-01-18 16:50:46,1453132253,7
5698db8b2fb0de2600f22f63,7821,ORG3402 Organisasjonsatferd og ledelse,1453141923,2016-01-18 19:32:03,1453141926,3
5698db8b2fb0de2600f22f63,14889,ORG3402 Organisasjonsatferd og ledelse,1453636400,2016-01-24 12:53:20,1453637236,836
5698db8b2fb0de2600f22f63,8538,ORG3402 Organisasjonsatferd og ledelse,1453705892,2016-01-25 08:11:32,1453705932,40
5698db8b2fb0de2600f22f63,57131,ORG3402 Organisasjonsatferd og ledelse,1453985633,2016-01-28 13:53:53,1453985638,5
5698db8b2fb0de2600f22f63,42111,ORG3402 Organisasjonsatferd og ledelse,1454764569,2016-02-06 14:16:09,1454764643,74
5698db8b2fb0de2600f22f63,47275,ORG3402 Organisasjonsatferd og ledelse,1454792618,2016-02-06 22:03:38,1454792810,192
5698db8b2fb0de2600f22f63,99901,ORG3402 Organisasjonsatferd og ledelse,1454914256,2016-02-08 07:50:56,1454914258,2
5698db8b2fb0de2600f22f63,15310,ORG3402 Organisasjonsatferd og ledelse,1455018515,2016-02-09 12:48:35,1455018562,47
5698db8b2fb0de2600f22f63,54026,ORG3402 Organisasjonsatferd og ledelse,1455270332,2016-02-12 10:45:32,1455270702,370
5698db8b2fb0de2600f22f63,21910,ORG3402 Organisasjonsatferd og ledelse,1455272240,2016-02-12 11:17:20,1455272837,597
5698db8b2fb0de2600f22f63,13878,ORG3402 Organisasjonsatferd og ledelse,1455277933,2016-02-12 12:52:13,1455279828,1895
5698db8b2fb0de2600f22f63,84400,ORG3402 Organisasjonsatferd og ledelse,1455297612,2016-02-12 18:20:12,1455297613,1
5698db8b2fb0de2600f22f7e,99746,ORG3402 Organisasjonsatferd og ledelse,1453054435,2016-01-17 19:13:55,1453054618,183
5698db8b2fb0de2600f22f7e,92231,ORG3402 Organisasjonsatferd og ledelse,1453635179,2016-01-24 12:32:59,1453635260,81
5698db8b2fb0de2600f22f7e,11195,ORG3402 Organisasjonsatferd og ledelse,1453675151,2016-01-24 23:39:11,1453675161,10
5698db8b2fb0de2600f22f7e,37418,ORG3402 Organisasjonsatferd og ledelse,1453721867,2016-01-25 12:37:47,1453721896,29
5698db8b2fb0de2600f22f7e,11133,ORG3402 Organisasjonsatferd og ledelse,1453751552,2016-01-25 20:52:32,1453751553,1
5698db8b2fb0de2600f22f7e,47790,ORG3402 Organisasjonsatferd og ledelse,1454670691,2016-02-05 12:11:31,1454670726,35
5698db8b41a9d72100240e16,13197,ORG3402 Organisasjonsatferd og ledelse,1453119223,2016-01-18 13:13:43,1453119997,774
5698db8b41a9d72100240e16,54951,ORG3402 Organisasjonsatferd og ledelse,1453126748,2016-01-18 15:19:08,1453126848,100
5698db8b41a9d72100240e16,26892,ORG3402 Organisasjonsatferd og ledelse,1453137324,2016-01-18 18:15:24,1453138706,1382
5698db8b41a9d72100240e16,16230,ORG3402 Organisasjonsatferd og ledelse,1453140600,2016-01-18 19:10:00,1453140673,73
5698db8b41a9d72100240e16,64095,ORG3402 Organisasjonsatferd og ledelse,1453298902,2016-01-20 15:08:22,1453298902,0
5698db8b41a9d72100240e16,21812,ORG3402 Organisasjonsatferd og ledelse,1453300337,2016-01-20 15:32:17,1453300343,6
5698db8b41a9d72100240e16,54600,ORG3402 Organisasjonsatferd og ledelse,1453408444,2016-01-21 21:34:04,1453408445,1
5698db8b41a9d72100240e16,53174,ORG3402 Organisasjonsatferd og ledelse,1453608921,2016-01-24 05:15:21,1453608921,0
5698db8b41a9d72100240e16,20127,ORG3402 Organisasjonsatferd og ledelse,1453721285,2016-01-25 12:28:05,1453721291,6
5698db8b41a9d72100240e16,56245,ORG3402 Organisasjonsatferd og ledelse,1454345228,2016-02-01 17:47:08,1454345232,4
5698db8b41a9d72100240e16,19343,ORG3402 Organisasjonsatferd og ledelse,1454932593,2016-02-08 12:56:33,1454932611,18
5698db8b41a9d72100240e17,75981,ORG3402 Organisasjonsatferd og ledelse,1453586383,2016-01-23 22:59:43,1453587039,656
5698db8b41a9d72100240e17,6194,ORG3402 Organisasjonsatferd og ledelse,1454364216,2016-02-01 23:03:36,1454364243,27
5698db8b41a9d72100240e17,26396,ORG3402 Organisasjonsatferd og ledelse,1454433627,2016-02-02 18:20:27,1454433647,20
5698db8b41a9d72100240e17,36782,ORG3402 Organisasjonsatferd og ledelse,1454438617,2016-02-02 19:43:37,1454438617,0
5698db8b41a9d72100240e17,25051,ORG3402 Organisasjonsatferd og ledelse,1455024628,2016-02-09 14:30:28,1455024666,38
5698db8b41a9d72100240e17,88998,ORG3402 Organisasjonsatferd og ledelse,1455032010,2016-02-09 16:33:30,1455032148,138
5698db8b41a9d72100240e17,3665,ORG3402 Organisasjonsatferd og ledelse,1455047800,2016-02-09 20:56:40,1455047800,0
5698db8c41a9d72100240e26,39737,ORG3402 Organisasjonsatferd og ledelse,1453220808,2016-01-19 17:26:48,1453221009,201
5698db8c41a9d72100240e26,61855,ORG3402 Organisasjonsatferd og ledelse,1453648804,2016-01-24 16:20:04,1453648854,50
5698db8c41a9d72100240e26,58228,ORG3402 Organisasjonsatferd og ledelse,1453908610,2016-01-27 16:30:10,1453909676,1066
5698db8c41a9d72100240e26,90493,ORG3402 Organisasjonsatferd og ledelse,1453915697,2016-01-27 18:28:17,1453915701,4
5698db8c41a9d72100240e26,4248,ORG3402 Organisasjonsatferd og ledelse,1455284534,2016-02-12 14:42:14,1455284535,1
5698db8c41a9d72100240e27,83344,ORG3402 Organisasjonsatferd og ledelse,1452869975,2016-01-15 15:59:35,1452870049,74
5698db8c41a9d72100240e27,50315,ORG3402 Organisasjonsatferd og ledelse,1453055322,2016-01-17 19:28:42,1453055342,20
5698db8c41a9d72100240e27,3499,ORG3402 Organisasjonsatferd og ledelse,1453119878,2016-01-18 13:24:38,1453119887,9
5698db8c41a9d72100240e27,20629,ORG3402 Organisasjonsatferd og ledelse,1453215600,2016-01-19 16:00:00,1453215631,31
5698db8c41a9d72100240e27,94739,ORG3402 Organisasjonsatferd og ledelse,1454780716,2016-02-06 18:45:16,1454780716,0
5698db8c41a9d72100240e27,1475,ORG3402 Organisasjonsatferd og ledelse,1455058105,2016-02-09 23:48:25,1455058110,5
5698db8d2fb0de2600f22f81,64313,ORG3402 Organisasjonsatferd og ledelse,1453832909,2016-01-26 19:28:29,1453832968,59
5698db8d2fb0de2600f22f81,18128,ORG3402 Organisasjonsatferd og ledelse,1455328614,2016-02-13 02:56:54,1455328800,186
5698db8d2fb0de2600f22f84,32353,ORG3402 Organisasjonsatferd og ledelse,1453117736,2016-01-18 12:48:56,1453118022,286
5698db8d2fb0de2600f22f84,38853,ORG3402 Organisasjonsatferd og ledelse,1453719544,2016-01-25 11:59:04,1453720474,930
5698db8d2fb0de2600f22f84,49329,ORG3402 Organisasjonsatferd og ledelse,1453725288,2016-01-25 13:34:48,1453725295,7
5698db8d2fb0de2600f22f84,54581,ORG3402 Organisasjonsatferd og ledelse,1454329135,2016-02-01 13:18:55,1454329219,84
5698db8d2fb0de2600f22f84,62568,ORG3402 Organisasjonsatferd og ledelse,1454330663,2016-02-01 13:44:23,1454330764,101
5698db8d2fb0de2600f22f84,55101,ORG3402 Organisasjonsatferd og ledelse,1454333655,2016-02-01 14:34:15,1454333655,0
5698db8d2fb0de2600f22f84,68502,ORG3402 Organisasjonsatferd og ledelse,1454929859,2016-02-08 12:10:59,1454929966,107
5698db8d2fb0de2600f22f84,18219,ORG3402 Organisasjonsatferd og ledelse,1454934645,2016-02-08 13:30:45,1454934645,0
5698db8d2fb0de2600f22f84,56124,ORG3402 Organisasjonsatferd og ledelse,1455201035,2016-02-11 15:30:35,1455201082,47
5698db8d41a9d72100240e2a,34460,ORG3402 Organisasjonsatferd og ledelse,1453122245,2016-01-18 14:04:05,1453122751,506
5698db8d41a9d72100240e2a,69559,ORG3402 Organisasjonsatferd og ledelse,1453129925,2016-01-18 16:12:05,1453129987,62
5698db8d41a9d72100240e2a,87675,ORG3402 Organisasjonsatferd og ledelse,1454324779,2016-02-01 12:06:19,1454324780,1
5698db8d41a9d72100240e2d,13917,ORG3402 Organisasjonsatferd og ledelse,1453065100,2016-01-17 22:11:40,1453065560,460
5698db8d41a9d72100240e2d,27972,ORG3402 Organisasjonsatferd og ledelse,1453722370,2016-01-25 12:46:10,1453722393,23
5698db8d41a9d72100240e2d,41312,ORG3402 Organisasjonsatferd og ledelse,1454941824,2016-02-08 15:30:24,1454941840,16
5698db8d41a9d72100240e2d,50686,ORG3402 Organisasjonsatferd og ledelse,1455013099,2016-02-09 11:18:19,1455013154,55
5698db8d41a9d72100240e2d,79981,ORG3402 Organisasjonsatferd og ledelse,1455021842,2016-02-09 13:44:02,1455022045,203
5698db8d41a9d72100240e2d,70083,ORG3402 Organisasjonsatferd og ledelse,1455025630,2016-02-09 14:47:10,1455025634,4
5698db8d41a9d72100240e2d,23934,ORG3402 Organisasjonsatferd og ledelse,1455457558,2016-02-14 14:45:58,1455458154,596
5698db8d41a9d72100240e30,37583,ORG3402 Organisasjonsatferd og ledelse,1453029306,2016-01-17 12:15:06,1453029667,361
5698db8d41a9d72100240e30,16295,ORG3402 Organisasjonsatferd og ledelse,1453031618,2016-01-17 12:53:38,1453031641,23
5698db8d41a9d72100240e30,29363,ORG3402 Organisasjonsatferd og ledelse,1453033266,2016-01-17 13:21:06,1453033270,4
5698db8d41a9d72100240e30,9389,ORG3402 Organisasjonsatferd og ledelse,1453112263,2016-01-18 11:17:43,1453112363,100
5698db8d41a9d72100240e30,69909,ORG3402 Organisasjonsatferd og ledelse,1453115340,2016-01-18 12:09:00,1453115940,600
5698db8d41a9d72100240e30,37696,ORG3402 Organisasjonsatferd og ledelse,1453119278,2016-01-18 13:14:38,1453119279,1
5698db8d41a9d72100240e30,16465,ORG3402 Organisasjonsatferd og ledelse,1453122772,2016-01-18 14:12:52,1453122772,0
5698db8d41a9d72100240e30,97284,ORG3402 Organisasjonsatferd og ledelse,1453639287,2016-01-24 13:41:27,1453639287,0
5698db8d41a9d72100240e30,7271,ORG3402 Organisasjonsatferd og ledelse,1453759068,2016-01-25 22:57:48,1453759083,15
5698db8d41a9d72100240e30,58009,ORG3402 Organisasjonsatferd og ledelse,1453885689,2016-01-27 10:08:09,1453885704,15
5698db8d41a9d72100240e30,426,ORG3402 Organisasjonsatferd og ledelse,1454269683,2016-01-31 20:48:03,1454269683,0
5698db8d41a9d72100240e30,17163,ORG3402 Organisasjonsatferd og ledelse,1454324532,2016-02-01 12:02:12,1454324718,186
5698db8d41a9d72100240e30,53251,ORG3402 Organisasjonsatferd og ledelse,1454330492,2016-02-01 13:41:32,1454330504,12
5698db8d41a9d72100240e30,75997,ORG3402 Organisasjonsatferd og ledelse,1454332659,2016-02-01 14:17:39,1454332662,3
5698db8d41a9d72100240e30,15858,ORG3402 Organisasjonsatferd og ledelse,1454501285,2016-02-03 13:08:05,1454501289,4
5698db8d41a9d72100240e30,55071,ORG3402 Organisasjonsatferd og ledelse,1454517483,2016-02-03 17:38:03,1454517506,23
5698db8d41a9d72100240e30,97306,ORG3402 Organisasjonsatferd og ledelse,1454585075,2016-02-04 12:24:35,1454585145,70
5698db8d41a9d72100240e30,46558,ORG3402 Organisasjonsatferd og ledelse,1454863022,2016-02-07 17:37:02,1454863036,14
5698db8d41a9d72100240e30,30165,ORG3402 Organisasjonsatferd og ledelse,1454952203,2016-02-08 18:23:23,1454952203,0
5698db8d41a9d72100240e30,90421,ORG3402 Organisasjonsatferd og ledelse,1455378862,2016-02-13 16:54:22,1455378978,116
5698db8d41a9d72100240e30,24559,ORG3402 Organisasjonsatferd og ledelse,1455480390,2016-02-14 21:06:30,1455480451,61
5698db8d41a9d72100240e31,68332,ORG3402 Organisasjonsatferd og ledelse,1454324156,2016-02-01 11:55:56,1454324166,10
5698db8d41a9d72100240e31,47010,ORG3402 Organisasjonsatferd og ledelse,1454413252,2016-02-02 12:40:52,1454413275,23
5698db8d41a9d72100240e31,72913,ORG3402 Organisasjonsatferd og ledelse,1454933152,2016-02-08 13:05:52,1454933163,11
5698db8e2fb0de2600f22f86,15898,ORG3402 Organisasjonsatferd og ledelse,1452869238,2016-01-15 15:47:18,1452869764,526
5698db8e2fb0de2600f22f86,78234,ORG3402 Organisasjonsatferd og ledelse,1453051636,2016-01-17 18:27:16,1453051675,39
5698db8e2fb0de2600f22f86,80492,ORG3402 Organisasjonsatferd og ledelse,1453058735,2016-01-17 20:25:35,1453059118,383
5698db8e2fb0de2600f22f86,66716,ORG3402 Organisasjonsatferd og ledelse,1453122825,2016-01-18 14:13:45,1453122856,31
5698db8e2fb0de2600f22f86,8447,ORG3402 Organisasjonsatferd og ledelse,1453644986,2016-01-24 15:16:26,1453646249,1263
5698db8e2fb0de2600f22f86,84025,ORG3402 Organisasjonsatferd og ledelse,1453652031,2016-01-24 17:13:51,1453652031,0
5698db8e2fb0de2600f22f86,5640,ORG3402 Organisasjonsatferd og ledelse,1453668646,2016-01-24 21:50:46,1453668659,13
5698db8e2fb0de2600f22f86,44945,ORG3402 Organisasjonsatferd og ledelse,1454923186,2016-02-08 10:19:46,1454923270,84
5698db8e2fb0de2600f22f87,59018,ORG3402 Organisasjonsatferd og ledelse,1454328534,2016-02-01 13:08:54,1454329227,693
5698db8e2fb0de2600f22f88,52853,ORG3402 Organisasjonsatferd og ledelse,1453041723,2016-01-17 15:42:03,1453041889,166
5698db8e2fb0de2600f22f88,57472,ORG3402 Organisasjonsatferd og ledelse,1453045840,2016-01-17 16:50:40,1453045842,2
5698db8e2fb0de2600f22f88,4555,ORG3402 Organisasjonsatferd og ledelse,1453047779,2016-01-17 17:22:59,1453047780,1
5698db8e2fb0de2600f22f88,94922,ORG3402 Organisasjonsatferd og ledelse,1453056378,2016-01-17 19:46:18,1453056378,0
5698db8e2fb0de2600f22f88,99374,ORG3402 Organisasjonsatferd og ledelse,1453060279,2016-01-17 20:51:19,1453060318,39
5698db8e2fb0de2600f22f88,80754,ORG3402 Organisasjonsatferd og ledelse,1453109572,2016-01-18 10:32:52,1453109600,28
5698db8e2fb0de2600f22f88,56205,ORG3402 Organisasjonsatferd og ledelse,1453720067,2016-01-25 12:07:47,1453720749,682
5698db8e2fb0de2600f22f88,8793,ORG3402 Organisasjonsatferd og ledelse,1454324478,2016-02-01 12:01:18,1454324495,17
5698db8e2fb0de2600f22f88,70530,ORG3402 Organisasjonsatferd og ledelse,1454325886,2016-02-01 12:24:46,1454325995,109
5698db8e2fb0de2600f22f88,14218,ORG3402 Organisasjonsatferd og ledelse,1454591548,2016-02-04 14:12:28,1454591647,99
5698db8e2fb0de2600f22f88,96615,ORG3402 Organisasjonsatferd og ledelse,1454918805,2016-02-08 09:06:45,1454918811,6
5698db8e2fb0de2600f22f88,45098,ORG3402 Organisasjonsatferd og ledelse,1455458757,2016-02-14 15:05:57,1455458757,0
5698db8e2fb0de2600f22f89,15102,ORG3402 Organisasjonsatferd og ledelse,1454328837,2016-02-01 13:13:57,1454329060,223
5698db8e2fb0de2600f22f89,5374,ORG3402 Organisasjonsatferd og ledelse,1454498170,2016-02-03 12:16:10,1454498984,814
5698db8e2fb0de2600f22f89,56689,ORG3402 Organisasjonsatferd og ledelse,1454924260,2016-02-08 10:37:40,1454924293,33
5698db8e2fb0de2600f22f8a,50517,ORG3402 Organisasjonsatferd og ledelse,1454932563,2016-02-08 12:56:03,1454933605,1042
5698db8e41a9d72100240e35,30612,ORG3402 Organisasjonsatferd og ledelse,1453032590,2016-01-17 13:09:50,1453032645,55
5698db8e41a9d72100240e35,80936,ORG3402 Organisasjonsatferd og ledelse,1453898646,2016-01-27 13:44:06,1453898963,317
5698db8f2fb0de2600f22faa,74460,ORG3402 Organisasjonsatferd og ledelse,1453215587,2016-01-19 15:59:47,1453216441,854
5698db8f2fb0de2600f22faa,66254,ORG3402 Organisasjonsatferd og ledelse,1453710901,2016-01-25 09:35:01,1453710994,93
5698db8f2fb0de2600f22faa,74987,ORG3402 Organisasjonsatferd og ledelse,1453719456,2016-01-25 11:57:36,1453720739,1283
5698db8f2fb0de2600f22faa,59521,ORG3402 Organisasjonsatferd og ledelse,1453728125,2016-01-25 14:22:05,1453728125,0
5698db8f2fb0de2600f22fab,47111,ORG3402 Organisasjonsatferd og ledelse,1453066831,2016-01-17 22:40:31,1453066869,38
5698db8f2fb0de2600f22fab,26301,ORG3402 Organisasjonsatferd og ledelse,1453650696,2016-01-24 16:51:36,1453650700,4
5698db8f2fb0de2600f22fab,85272,ORG3402 Organisasjonsatferd og ledelse,1455027725,2016-02-09 15:22:05,1455028094,369
5698db8f41a9d72100240e4e,16840,ORG3402 Organisasjonsatferd og ledelse,1453675306,2016-01-24 23:41:46,1453675469,163
5698db8f41a9d72100240e4e,62272,ORG3402 Organisasjonsatferd og ledelse,1453889574,2016-01-27 11:12:54,1453889575,1
5698db8f41a9d72100240e4f,46800,ORG3402 Organisasjonsatferd og ledelse,1453304828,2016-01-20 16:47:08,1453305094,266
5698db902fb0de2600f22fad,17728,ORG3402 Organisasjonsatferd og ledelse,1452862401,2016-01-15 13:53:21,1452862611,210
5698db902fb0de2600f22fad,13847,ORG3402 Organisasjonsatferd og ledelse,1453053809,2016-01-17 19:03:29,1453054108,299
5698db902fb0de2600f22fae,62210,ORG3402 Organisasjonsatferd og ledelse,1454432345,2016-02-02 17:59:05,1454432346,1
5698db902fb0de2600f22fae,79436,ORG3402 Organisasjonsatferd og ledelse,1454434033,2016-02-02 18:27:13,1454434906,873
5698db902fb0de2600f22fae,83429,ORG3402 Organisasjonsatferd og ledelse,1455304179,2016-02-12 20:09:39,1455304179,0
5698db902fb0de2600f22faf,50949,ORG3402 Organisasjonsatferd og ledelse,1454320916,2016-02-01 11:01:56,1454321951,1035
5698db902fb0de2600f22fb0,71746,ORG3402 Organisasjonsatferd og ledelse,1453113010,2016-01-18 11:30:10,1453115093,2083
5698db902fb0de2600f22fb0,38234,ORG3402 Organisasjonsatferd og ledelse,1453116986,2016-01-18 12:36:26,1453117397,411
5698db902fb0de2600f22fb0,47166,ORG3402 Organisasjonsatferd og ledelse,1453320633,2016-01-20 21:10:33,1453320634,1
5698db902fb0de2600f22fb0,99623,ORG3402 Organisasjonsatferd og ledelse,1454321067,2016-02-01 11:04:27,1454321103,36
5698db9041a9d72100240e50,54597,ORG3402 Organisasjonsatferd og ledelse,1453202749,2016-01-19 12:25:49,1453203509,760
5698db9041a9d72100240e50,66568,ORG3402 Organisasjonsatferd og ledelse,1453754486,2016-01-25 21:41:26,1453754510,24
5698db9041a9d72100240e50,29582,ORG3402 Organisasjonsatferd og ledelse,1453825948,2016-01-26 17:32:28,1453825948,0
5698db9041a9d72100240e50,90978,ORG3402 Organisasjonsatferd og ledelse,1453902303,2016-01-27 14:45:03,1453902304,1
5698db9041a9d72100240e50,48992,ORG3402 Organisasjonsatferd og ledelse,1455115589,2016-02-10 15:46:29,1455115589,0
5698db9041a9d72100240e58,33542,ORG3402 Organisasjonsatferd og ledelse,1454512662,2016-02-03 16:17:42,1454512790,128
5698db9041a9d72100240e59,54469,ORG3402 Organisasjonsatferd og ledelse,1454326158,2016-02-01 12:29:18,1454327952,1794
5698db9041a9d72100240e59,81525,ORG3402 Organisasjonsatferd og ledelse,1454331126,2016-02-01 13:52:06,1454331126,0
5698db9041a9d72100240e59,19834,ORG3402 Organisasjonsatferd og ledelse,1454333093,2016-02-01 14:24:53,1454333137,44
5698db9041a9d72100240e5a,53706,ORG3402 Organisasjonsatferd og ledelse,1453073196,2016-01-18 00:26:36,1453073458,262
5698db9041a9d72100240e5a,1324,ORG3402 Organisasjonsatferd og ledelse,1453232154,2016-01-19 20:35:54,1453232615,461
5698db9041a9d72100240e5a,60350,ORG3402 Organisasjonsatferd og ledelse,1453289124,2016-01-20 12:25:24,1453289124,0
5698db9041a9d72100240e5a,66902,ORG3402 Organisasjonsatferd og ledelse,1453290576,2016-01-20 12:49:36,1453290684,108
5698db9041a9d72100240e5a,92533,ORG3402 Organisasjonsatferd og ledelse,1453584353,2016-01-23 22:25:53,1453584353,0
5698db9041a9d72100240e5a,95348,ORG3402 Organisasjonsatferd og ledelse,1453758184,2016-01-25 22:43:04,1453758223,39
5698db9041a9d72100240e5a,44003,ORG3402 Organisasjonsatferd og ledelse,1454940579,2016-02-08 15:09:39,1454940631,52
5698db9041a9d72100240e5a,88202,ORG3402 Organisasjonsatferd og ledelse,1455375246,2016-02-13 15:54:06,1455375249,3
5698db912fb0de2600f22fb3,88898,ORG3402 Organisasjonsatferd og ledelse,1453221684,2016-01-19 17:41:24,1453222510,826
5698db912fb0de2600f22fb3,53024,ORG3402 Organisasjonsatferd og ledelse,1453728353,2016-01-25 14:25:53,1453729087,734
5698db912fb0de2600f22fb3,21708,ORG3402 Organisasjonsatferd og ledelse,1453832410,2016-01-26 19:20:10,1453832504,94
5698db912fb0de2600f22fb3,8125,ORG3402 Organisasjonsatferd og ledelse,1453897240,2016-01-27 13:20:40,1453898342,1102
5698db912fb0de2600f22fb3,60229,ORG3402 Organisasjonsatferd og ledelse,1454166747,2016-01-30 16:12:27,1454166750,3
5698db912fb0de2600f22fb3,92695,ORG3402 Organisasjonsatferd og ledelse,1454437065,2016-02-02 19:17:45,1454437133,68
5698db912fb0de2600f22fb3,6188,ORG3402 Organisasjonsatferd og ledelse,1454943996,2016-02-08 16:06:36,1454943996,0
5698db912fb0de2600f22fb3,41173,ORG3402 Organisasjonsatferd og ledelse,1455466100,2016-02-14 17:08:20,1455466163,63
5698db912fb0de2600f22fb4,90332,ORG3402 Organisasjonsatferd og ledelse,1453050483,2016-01-17 18:08:03,1453050516,33
5698db912fb0de2600f22fb4,77081,ORG3402 Organisasjonsatferd og ledelse,1453113618,2016-01-18 11:40:18,1453113672,54
5698db912fb0de2600f22fb4,17890,ORG3402 Organisasjonsatferd og ledelse,1453201624,2016-01-19 12:07:04,1453201629,5
5698db912fb0de2600f22fb4,35750,ORG3402 Organisasjonsatferd og ledelse,1453287852,2016-01-20 12:04:12,1453287902,50
5698db912fb0de2600f22fb4,56255,ORG3402 Organisasjonsatferd og ledelse,1453293058,2016-01-20 13:30:58,1453293101,43
5698db912fb0de2600f22fb4,81451,ORG3402 Organisasjonsatferd og ledelse,1453370491,2016-01-21 11:01:31,1453370494,3
5698db912fb0de2600f22fb4,83559,ORG3402 Organisasjonsatferd og ledelse,1453389441,2016-01-21 16:17:21,1453389897,456
5698db912fb0de2600f22fb4,52947,ORG3402 Organisasjonsatferd og ledelse,1453551264,2016-01-23 13:14:24,1453551264,0
5698db912fb0de2600f22fb4,9568,ORG3402 Organisasjonsatferd og ledelse,1453672097,2016-01-24 22:48:17,1453672107,10
5698db912fb0de2600f22fb4,59366,ORG3402 Organisasjonsatferd og ledelse,1454425724,2016-02-02 16:08:44,1454426803,1079
5698db912fb0de2600f22fb4,40396,ORG3402 Organisasjonsatferd og ledelse,1455010936,2016-02-09 10:42:16,1455011002,66
5698db912fb0de2600f22fc5,45344,ORG3402 Organisasjonsatferd og ledelse,1452863561,2016-01-15 14:12:41,1452864088,527
5698db912fb0de2600f22fc5,52209,ORG3402 Organisasjonsatferd og ledelse,1453132715,2016-01-18 16:58:35,1453132774,59
5698db912fb0de2600f22fc5,92824,ORG3402 Organisasjonsatferd og ledelse,1453675762,2016-01-24 23:49:22,1453675766,4
5698db9141a9d72100240e60,18751,ORG3402 Organisasjonsatferd og ledelse,1453203657,2016-01-19 12:40:57,1453203874,217
5698db9141a9d72100240e60,94229,ORG3402 Organisasjonsatferd og ledelse,1455019963,2016-02-09 13:12:43,1455020029,66
5698db9141a9d72100240e62,29057,ORG3402 Organisasjonsatferd og ledelse,1453115361,2016-01-18 12:09:21,1453115519,158
5698db9141a9d72100240e62,4300,ORG3402 Organisasjonsatferd og ledelse,1453121861,2016-01-18 13:57:41,1453122764,903
5698db9141a9d72100240e62,40736,ORG3402 Organisasjonsatferd og ledelse,1453674772,2016-01-24 23:32:52,1453674839,67
5698db9141a9d72100240e62,16192,ORG3402 Organisasjonsatferd og ledelse,1453676241,2016-01-24 23:57:21,1453676246,5
5698db9141a9d72100240e62,18061,ORG3402 Organisasjonsatferd og ledelse,1453720475,2016-01-25 12:14:35,1453720476,1
5698db9141a9d72100240e62,77119,ORG3402 Organisasjonsatferd og ledelse,1453723802,2016-01-25 13:10:02,1453723815,13
5698db9141a9d72100240e62,75359,ORG3402 Organisasjonsatferd og ledelse,1454324763,2016-02-01 12:06:03,1454324764,1
5698db922fb0de2600f22fd3,11191,ORG3402 Organisasjonsatferd og ledelse,1455375832,2016-02-13 16:03:52,1455377364,1532
5698db922fb0de2600f22fd6,71377,ORG3402 Organisasjonsatferd og ledelse,1452950521,2016-01-16 14:22:01,1452950568,47
5698db922fb0de2600f22fd6,64832,ORG3402 Organisasjonsatferd og ledelse,1453069544,2016-01-17 23:25:44,1453069552,8
5698db922fb0de2600f22fd6,96026,ORG3402 Organisasjonsatferd og ledelse,1453122237,2016-01-18 14:03:57,1453122296,59
5698db922fb0de2600f22fd6,99593,ORG3402 Organisasjonsatferd og ledelse,1453322463,2016-01-20 21:41:03,1453322464,1
5698db922fb0de2600f22fd6,82151,ORG3402 Organisasjonsatferd og ledelse,1453884260,2016-01-27 09:44:20,1453884267,7
5698db922fb0de2600f22fd6,77087,ORG3402 Organisasjonsatferd og ledelse,1455284571,2016-02-12 14:42:51,1455284586,15
5698db922fb0de2600f22fd7,7159,ORG3402 Organisasjonsatferd og ledelse,1452865394,2016-01-15 14:43:14,1452865395,1
5698db922fb0de2600f22fd7,50947,ORG3402 Organisasjonsatferd og ledelse,1454453475,2016-02-02 23:51:15,1454453586,111
5698db9241a9d72100240e72,8165,ORG3402 Organisasjonsatferd og ledelse,1453115142,2016-01-18 12:05:42,1453115212,70
5698db9241a9d72100240e72,5058,ORG3402 Organisasjonsatferd og ledelse,1453122920,2016-01-18 14:15:20,1453123959,1039
5698db9241a9d72100240e72,23650,ORG3402 Organisasjonsatferd og ledelse,1453719616,2016-01-25 12:00:16,1453721701,2085
5698db9241a9d72100240e72,88664,ORG3402 Organisasjonsatferd og ledelse,1454929473,2016-02-08 12:04:33,1454930418,945
5698db9241a9d72100240e72,13418,ORG3402 Organisasjonsatferd og ledelse,1454935572,2016-02-08 13:46:12,1454935596,24
5698db932fb0de2600f22fdb,99282,ORG3402 Organisasjonsatferd og ledelse,1452943813,2016-01-16 12:30:13,1452944221,408
5698db932fb0de2600f22fdb,49620,ORG3402 Organisasjonsatferd og ledelse,1453728389,2016-01-25 14:26:29,1453728445,56
5698db932fb0de2600f22fdb,39741,ORG3402 Organisasjonsatferd og ledelse,1455188438,2016-02-11 12:00:38,1455188479,41
5698db932fb0de2600f22fde,12082,ORG3402 Organisasjonsatferd og ledelse,1453109386,2016-01-18 10:29:46,1453110495,1109
5698db932fb0de2600f22fde,99340,ORG3402 Organisasjonsatferd og ledelse,1453111815,2016-01-18 11:10:15,1453112079,264
5698db932fb0de2600f22fde,11693,ORG3402 Organisasjonsatferd og ledelse,1453715992,2016-01-25 10:59:52,1453716060,68
5698db932fb0de2600f22fde,91566,ORG3402 Organisasjonsatferd og ledelse,1453987254,2016-01-28 14:20:54,1453987291,37
5698db932fb0de2600f22fde,67852,ORG3402 Organisasjonsatferd og ledelse,1454444698,2016-02-02 21:24:58,1454444814,116
5698db932fb0de2600f22fde,28561,ORG3402 Organisasjonsatferd og ledelse,1454447618,2016-02-02 22:13:38,1454447619,1
5698db932fb0de2600f22fde,28801,ORG3402 Organisasjonsatferd og ledelse,1455052642,2016-02-09 22:17:22,1455052828,186
5698db9341a9d72100240e75,34877,ORG3402 Organisasjonsatferd og ledelse,1453240372,2016-01-19 22:52:52,1453240376,4
5698db9341a9d72100240e75,18052,ORG3402 Organisasjonsatferd og ledelse,1453719662,2016-01-25 12:01:02,1453719689,27
5698db9341a9d72100240e76,24330,ORG3402 Organisasjonsatferd og ledelse,1453125642,2016-01-18 15:00:42,1453125642,0
5698db9341a9d72100240e76,947,ORG3402 Organisasjonsatferd og ledelse,1455205322,2016-02-11 16:42:02,1455205419,97
5698db9341a9d72100240e76,36805,ORG3402 Organisasjonsatferd og ledelse,1455209421,2016-02-11 17:50:21,1455209421,0
5698db9341a9d72100240e76,17546,ORG3402 Organisasjonsatferd og ledelse,1455221091,2016-02-11 21:04:51,1455221124,33
5698db9341a9d72100240e76,60097,ORG3402 Organisasjonsatferd og ledelse,1455234997,2016-02-12 00:56:37,1455234997,0
5698db9341a9d72100240e77,90152,ORG3402 Organisasjonsatferd og ledelse,1453297120,2016-01-20 14:38:40,1453297186,66
5698db9341a9d72100240e77,4911,ORG3402 Organisasjonsatferd og ledelse,1453719592,2016-01-25 11:59:52,1453720316,724
5698db9341a9d72100240e77,99940,ORG3402 Organisasjonsatferd og ledelse,1453724851,2016-01-25 13:27:31,1453724917,66
5698db9341a9d72100240e77,89753,ORG3402 Organisasjonsatferd og ledelse,1454327290,2016-02-01 12:48:10,1454328149,859
5698db9341a9d72100240e77,48881,ORG3402 Organisasjonsatferd og ledelse,1455013164,2016-02-09 11:19:24,1455013165,1
5698db9341a9d72100240e77,97031,ORG3402 Organisasjonsatferd og ledelse,1455102087,2016-02-10 12:01:27,1455102087,0
5698db9341a9d72100240e78,71603,ORG3402 Organisasjonsatferd og ledelse,1453121800,2016-01-18 13:56:40,1453122233,433
5698db9341a9d72100240e78,70792,ORG3402 Organisasjonsatferd og ledelse,1453227275,2016-01-19 19:14:35,1453228306,1031
5698db9341a9d72100240e78,56940,ORG3402 Organisasjonsatferd og ledelse,1453412024,2016-01-21 22:33:44,1453412024,0
5698db9341a9d72100240e78,27035,ORG3402 Organisasjonsatferd og ledelse,1453729220,2016-01-25 14:40:20,1453729280,60
5698db9341a9d72100240e78,57590,ORG3402 Organisasjonsatferd og ledelse,1453842332,2016-01-26 22:05:32,1453842437,105
5698db9341a9d72100240e78,64125,ORG3402 Organisasjonsatferd og ledelse,1453902382,2016-01-27 14:46:22,1453902383,1
5698db9341a9d72100240e78,59957,ORG3402 Organisasjonsatferd og ledelse,1454929324,2016-02-08 12:02:04,1454929351,27
5698db9341a9d72100240e78,77535,ORG3402 Organisasjonsatferd og ledelse,1454933087,2016-02-08 13:04:47,1454933087,0
5698db9341a9d72100240e78,47947,ORG3402 Organisasjonsatferd og ledelse,1454934432,2016-02-08 13:27:12,1454934435,3
5698db9341a9d72100240e78,44606,ORG3402 Organisasjonsatferd og ledelse,1455116680,2016-02-10 16:04:40,1455116681,1
5698db9341a9d72100240e78,59189,ORG3402 Organisasjonsatferd og ledelse,1455118672,2016-02-10 16:37:52,1455118673,1
5698db9341a9d72100240e7b,40790,ORG3402 Organisasjonsatferd og ledelse,1453115772,2016-01-18 12:16:12,1453115773,1
5698db9341a9d72100240e7b,78441,ORG3402 Organisasjonsatferd og ledelse,1453714462,2016-01-25 10:34:22,1453714827,365
5698db9341a9d72100240e7b,67713,nan,1453719257,2016-01-25 11:54:17,1453719257,0
5698db9341a9d72100240e7e,67778,ORG3402 Organisasjonsatferd og ledelse,1453839668,2016-01-26 21:21:08,1453839801,133
5698db942fb0de2600f22fe2,48190,ORG3402 Organisasjonsatferd og ledelse,1453151338,2016-01-18 22:08:58,1453151417,79
5698db942fb0de2600f22fe2,90956,ORG3402 Organisasjonsatferd og ledelse,1453714521,2016-01-25 10:35:21,1453714570,49
5698db942fb0de2600f22fe2,76145,ORG3402 Organisasjonsatferd og ledelse,1453747232,2016-01-25 19:40:32,1453747232,0
5698db942fb0de2600f22fe2,83172,ORG3402 Organisasjonsatferd og ledelse,1453905652,2016-01-27 15:40:52,1453905658,6
5698db942fb0de2600f22fe2,13416,ORG3402 Organisasjonsatferd og ledelse,1453907857,2016-01-27 16:17:37,1453908933,1076
5698db942fb0de2600f22fe2,1307,ORG3402 Organisasjonsatferd og ledelse,1454932690,2016-02-08 12:58:10,1454932710,20
5698db942fb0de2600f22fe3,91151,ORG3402 Organisasjonsatferd og ledelse,1453156992,2016-01-18 23:43:12,1453157263,271
5698db942fb0de2600f22fe3,41348,ORG3402 Organisasjonsatferd og ledelse,1453158983,2016-01-19 00:16:23,1453160448,1465
5698db942fb0de2600f22fe4,13316,nan,1453116050,2016-01-18 12:20:50,1453116109,59
5698db942fb0de2600f22fe4,97058,ORG3402 Organisasjonsatferd og ledelse,1453120310,2016-01-18 13:31:50,1453120412,102
5698db942fb0de2600f22fe4,40535,ORG3402 Organisasjonsatferd og ledelse,1453129845,2016-01-18 16:10:45,1453130627,782
5698db942fb0de2600f22fe4,63815,ORG3402 Organisasjonsatferd og ledelse,1455104402,2016-02-10 12:40:02,1455104917,515
5698db942fb0de2600f22fe4,56577,ORG3402 Organisasjonsatferd og ledelse,1455311075,2016-02-12 22:04:35,1455311146,71
5698db9441a9d72100240e89,79752,ORG3402 Organisasjonsatferd og ledelse,1453401042,2016-01-21 19:30:42,1453401042,0
5698db9441a9d72100240e89,16827,ORG3402 Organisasjonsatferd og ledelse,1454962356,2016-02-08 21:12:36,1454962486,130
5698db9441a9d72100240e89,77203,ORG3402 Organisasjonsatferd og ledelse,1455121772,2016-02-10 17:29:32,1455121772,0
5698db9441a9d72100240e89,98820,ORG3402 Organisasjonsatferd og ledelse,1455124055,2016-02-10 18:07:35,1455124062,7
5698db9441a9d72100240e8b,28217,ORG3402 Organisasjonsatferd og ledelse,1455147695,2016-02-11 00:41:35,1455147857,162
5698db9441a9d72100240e8b,28361,ORG3402 Organisasjonsatferd og ledelse,1455184298,2016-02-11 10:51:38,1455184298,0
5698db9441a9d72100240e8c,7813,ORG3402 Organisasjonsatferd og ledelse,1453331657,2016-01-21 00:14:17,1453331715,58
5698db9441a9d72100240e8c,38031,ORG3402 Organisasjonsatferd og ledelse,1453726466,2016-01-25 13:54:26,1453726474,8
5698db9441a9d72100240e8c,90214,ORG3402 Organisasjonsatferd og ledelse,1455092985,2016-02-10 09:29:45,1455092987,2
5698db9441a9d72100240e8c,21123,ORG3402 Organisasjonsatferd og ledelse,1455095070,2016-02-10 10:04:30,1455095071,1
5698db952fb0de2600f22ff7,38967,ORG3402 Organisasjonsatferd og ledelse,1452987760,2016-01-17 00:42:40,1452987877,117
5698db952fb0de2600f22ff7,89087,ORG3402 Organisasjonsatferd og ledelse,1453115131,2016-01-18 12:05:31,1453115241,110
5698db952fb0de2600f22ff7,61068,ORG3402 Organisasjonsatferd og ledelse,1453118805,2016-01-18 13:06:45,1453118833,28
5698db952fb0de2600f22ff7,20949,ORG3402 Organisasjonsatferd og ledelse,1453120892,2016-01-18 13:41:32,1453120899,7
5698db952fb0de2600f22ff7,26514,ORG3402 Organisasjonsatferd og ledelse,1453903776,2016-01-27 15:09:36,1453903845,69
5698db952fb0de2600f22ff7,28983,ORG3402 Organisasjonsatferd og ledelse,1454324408,2016-02-01 12:00:08,1454324570,162
5698db952fb0de2600f22ff7,14832,ORG3402 Organisasjonsatferd og ledelse,1454332264,2016-02-01 14:11:04,1454332315,51
5698db952fb0de2600f22ff7,23178,ORG3402 Organisasjonsatferd og ledelse,1454333836,2016-02-01 14:37:16,1454333840,4
5698db952fb0de2600f22ff7,40844,ORG3402 Organisasjonsatferd og ledelse,1454929253,2016-02-08 12:00:53,1454930047,794
5698db952fb0de2600f22ff7,25843,ORG3402 Organisasjonsatferd og ledelse,1455105641,2016-02-10 13:00:41,1455105641,0
5698db952fb0de2600f22ff7,69449,ORG3402 Organisasjonsatferd og ledelse,1455107709,2016-02-10 13:35:09,1455107720,11
5698db952fb0de2600f22ff7,40115,ORG3402 Organisasjonsatferd og ledelse,1455202335,2016-02-11 15:52:15,1455202336,1
5698db952fb0de2600f22ff8,82374,ORG3402 Organisasjonsatferd og ledelse,1453806525,2016-01-26 12:08:45,1453807182,657
5698db962fb0de2600f22ffb,82881,ORG3402 Organisasjonsatferd og ledelse,1453121859,2016-01-18 13:57:39,1453122014,155
5698db962fb0de2600f22ffb,14651,ORG3402 Organisasjonsatferd og ledelse,1453674627,2016-01-24 23:30:27,1453675103,476
5698db962fb0de2600f22ffb,39387,ORG3402 Organisasjonsatferd og ledelse,1453719617,2016-01-25 12:00:17,1453720593,976
5698db962fb0de2600f22ffb,26327,ORG3402 Organisasjonsatferd og ledelse,1453992012,2016-01-28 15:40:12,1453992063,51
5698db962fb0de2600f22ffb,31591,ORG3402 Organisasjonsatferd og ledelse,1453993643,2016-01-28 16:07:23,1453993643,0
5698db962fb0de2600f22ffb,23563,ORG3402 Organisasjonsatferd og ledelse,1454271261,2016-01-31 21:14:21,1454271261,0
5698db962fb0de2600f22ffb,14534,ORG3402 Organisasjonsatferd og ledelse,1454324622,2016-02-01 12:03:42,1454324671,49
5698db962fb0de2600f22ffb,71801,ORG3402 Organisasjonsatferd og ledelse,1454330752,2016-02-01 13:45:52,1454330758,6
5698db962fb0de2600f22ffb,81266,ORG3402 Organisasjonsatferd og ledelse,1454528939,2016-02-03 20:48:59,1454528940,1
5698db962fb0de2600f22ffb,24758,ORG3402 Organisasjonsatferd og ledelse,1454752059,2016-02-06 10:47:39,1454752959,900
5698db962fb0de2600f22ffb,66603,ORG3402 Organisasjonsatferd og ledelse,1454931850,2016-02-08 12:44:10,1454931870,20
5698db962fb0de2600f22ffe,54516,ORG3402 Organisasjonsatferd og ledelse,1453061673,2016-01-17 21:14:33,1453061673,0
5698db962fb0de2600f22ffe,82084,ORG3402 Organisasjonsatferd og ledelse,1453070233,2016-01-17 23:37:13,1453070243,10
5698db962fb0de2600f22ffe,22989,ORG3402 Organisasjonsatferd og ledelse,1453227237,2016-01-19 19:13:57,1453227550,313
5698db962fb0de2600f22ffe,9054,ORG3402 Organisasjonsatferd og ledelse,1453237349,2016-01-19 22:02:29,1453237353,4
5698db962fb0de2600f22ffe,13153,ORG3402 Organisasjonsatferd og ledelse,1453829124,2016-01-26 18:25:24,1453829181,57
5698db962fb0de2600f22ffe,75374,ORG3402 Organisasjonsatferd og ledelse,1454428473,2016-02-02 16:54:33,1454428574,101
5698db962fb0de2600f22ffe,10684,ORG3402 Organisasjonsatferd og ledelse,1454516007,2016-02-03 17:13:27,1454516128,121
5698db962fb0de2600f22ffe,3696,ORG3402 Organisasjonsatferd og ledelse,1455104729,2016-02-10 12:45:29,1455104731,2
5698db962fb0de2600f22ffe,19158,ORG3402 Organisasjonsatferd og ledelse,1455111668,2016-02-10 14:41:08,1455112803,1135
5698db962fb0de2600f23000,21018,ORG3402 Organisasjonsatferd og ledelse,1455024798,2016-02-09 14:33:18,1455025412,614
5698db962fb0de2600f23001,77034,ORG3402 Organisasjonsatferd og ledelse,1453058062,2016-01-17 20:14:22,1453058938,876
5698db962fb0de2600f23001,17663,ORG3402 Organisasjonsatferd og ledelse,1453080836,2016-01-18 02:33:56,1453080928,92
5698db962fb0de2600f23001,96193,ORG3402 Organisasjonsatferd og ledelse,1455188723,2016-02-11 12:05:23,1455189265,542
5698db962fb0de2600f23002,4691,ORG3402 Organisasjonsatferd og ledelse,1452865996,2016-01-15 14:53:16,1452866138,142
5698db962fb0de2600f23002,89481,ORG3402 Organisasjonsatferd og ledelse,1453051319,2016-01-17 18:21:59,1453051359,40
5698db962fb0de2600f23002,72502,ORG3402 Organisasjonsatferd og ledelse,1453076597,2016-01-18 01:23:17,1453076636,39
5698db962fb0de2600f23002,68765,ORG3402 Organisasjonsatferd og ledelse,1453116333,2016-01-18 12:25:33,1453116861,528
5698db962fb0de2600f23002,15145,ORG3402 Organisasjonsatferd og ledelse,1453118380,2016-01-18 12:59:40,1453118901,521
5698db962fb0de2600f23002,61701,ORG3402 Organisasjonsatferd og ledelse,1453120824,2016-01-18 13:40:24,1453120920,96
5698db962fb0de2600f23002,88655,ORG3402 Organisasjonsatferd og ledelse,1453126987,2016-01-18 15:23:07,1453127112,125
5698db962fb0de2600f23002,31238,ORG3402 Organisasjonsatferd og ledelse,1453278164,2016-01-20 09:22:44,1453278194,30
5698db962fb0de2600f23002,67182,ORG3402 Organisasjonsatferd og ledelse,1453280977,2016-01-20 10:09:37,1453280977,0
5698db962fb0de2600f23002,58016,ORG3402 Organisasjonsatferd og ledelse,1453671658,2016-01-24 22:40:58,1453671659,1
5698db962fb0de2600f23002,54808,ORG3402 Organisasjonsatferd og ledelse,1453710786,2016-01-25 09:33:06,1453710788,2
5698db962fb0de2600f23002,27764,ORG3402 Organisasjonsatferd og ledelse,1454628560,2016-02-05 00:29:20,1454628851,291
5698db962fb0de2600f23002,9076,ORG3402 Organisasjonsatferd og ledelse,1455022498,2016-02-09 13:54:58,1455022589,91
5698db9641a9d72100240ea8,11805,ORG3402 Organisasjonsatferd og ledelse,1453056068,2016-01-17 19:41:08,1453056089,21
5698db9641a9d72100240ea8,46817,ORG3402 Organisasjonsatferd og ledelse,1453115464,2016-01-18 12:11:04,1453115778,314
5698db9641a9d72100240ea8,13842,ORG3402 Organisasjonsatferd og ledelse,1453205474,2016-01-19 13:11:14,1453205522,48
5698db9641a9d72100240ea8,66681,ORG3402 Organisasjonsatferd og ledelse,1453752112,2016-01-25 21:01:52,1453752122,10
5698db9641a9d72100240ea8,35406,ORG3402 Organisasjonsatferd og ledelse,1454072614,2016-01-29 14:03:34,1454072614,0
5698db9641a9d72100240ea8,77455,ORG3402 Organisasjonsatferd og ledelse,1454926209,2016-02-08 11:10:09,1454926211,2
5698db9641a9d72100240ea8,72214,ORG3402 Organisasjonsatferd og ledelse,1455388182,2016-02-13 19:29:42,1455388183,1
5698db972fb0de2600f23004,83990,ORG3402 Organisasjonsatferd og ledelse,1455118520,2016-02-10 16:35:20,1455118646,126
5698db972fb0de2600f23004,47155,ORG3402 Organisasjonsatferd og ledelse,1455188649,2016-02-11 12:04:09,1455188650,1
5698db972fb0de2600f23004,97798,ORG3402 Organisasjonsatferd og ledelse,1455191442,2016-02-11 12:50:42,1455191457,15
5698db972fb0de2600f23004,73955,ORG3402 Organisasjonsatferd og ledelse,1455192804,2016-02-11 13:13:24,1455192818,14
5698db972fb0de2600f2300b,18484,ORG3402 Organisasjonsatferd og ledelse,1453900031,2016-01-27 14:07:11,1453900113,82
5698db972fb0de2600f2300b,53105,ORG3402 Organisasjonsatferd og ledelse,1453902736,2016-01-27 14:52:16,1453902749,13
5698db972fb0de2600f2300b,69615,ORG3402 Organisasjonsatferd og ledelse,1453927573,2016-01-27 21:46:13,1453927580,7
5698db972fb0de2600f2300b,64453,ORG3402 Organisasjonsatferd og ledelse,1454064767,2016-01-29 11:52:47,1454064767,0
5698db972fb0de2600f2300b,26379,ORG3402 Organisasjonsatferd og ledelse,1454073658,2016-01-29 14:20:58,1454073675,17
5698db972fb0de2600f2300b,50931,ORG3402 Organisasjonsatferd og ledelse,1454359292,2016-02-01 21:41:32,1454359992,700
5698db972fb0de2600f2300b,59404,ORG3402 Organisasjonsatferd og ledelse,1454498729,2016-02-03 12:25:29,1454498864,135
5698db972fb0de2600f2300b,50021,ORG3402 Organisasjonsatferd og ledelse,1454506635,2016-02-03 14:37:15,1454506648,13
5698db972fb0de2600f2300b,22286,ORG3402 Organisasjonsatferd og ledelse,1454683131,2016-02-05 15:38:51,1454683174,43
5698db972fb0de2600f2300b,13655,ORG3402 Organisasjonsatferd og ledelse,1454695045,2016-02-05 18:57:25,1454695061,16
5698db972fb0de2600f2300b,25569,ORG3402 Organisasjonsatferd og ledelse,1455052478,2016-02-09 22:14:38,1455052531,53
5698dc3741a9d72100240f97,44698,ORG3402 Organisasjonsatferd og ledelse,1453897712,2016-01-27 13:28:32,1453897910,198
5698dc3741a9d72100240f97,170,ORG3402 Organisasjonsatferd og ledelse,1454059332,2016-01-29 10:22:12,1454059761,429
5698dc3741a9d72100240f98,41218,ORG3402 Organisasjonsatferd og ledelse,1452899239,2016-01-16 00:07:19,1452899369,130
5698dc3741a9d72100240f98,60496,ORG3402 Organisasjonsatferd og ledelse,1453143645,2016-01-18 20:00:45,1453144473,828
5698dc3741a9d72100240f98,67417,ORG3402 Organisasjonsatferd og ledelse,1453206125,2016-01-19 13:22:05,1453206126,1
5698dc3741a9d72100240f98,83039,ORG3402 Organisasjonsatferd og ledelse,1453748387,2016-01-25 19:59:47,1453748482,95
5698dc3741a9d72100240f98,30140,ORG3402 Organisasjonsatferd og ledelse,1455099941,2016-02-10 11:25:41,1455099941,0
5698dc3741a9d72100240f99,31266,ORG3402 Organisasjonsatferd og ledelse,1454066221,2016-01-29 12:17:01,1454066444,223
5698dc3741a9d72100240f99,88749,ORG3402 Organisasjonsatferd og ledelse,1454070071,2016-01-29 13:21:11,1454070071,0
5698dc3741a9d72100240f99,60612,ORG3402 Organisasjonsatferd og ledelse,1454497034,2016-02-03 11:57:14,1454498182,1148
5698dc3741a9d72100240f99,1174,ORG3402 Organisasjonsatferd og ledelse,1455104395,2016-02-10 12:39:55,1455106031,1636
5698dc3741a9d72100240f99,68615,ORG3402 Organisasjonsatferd og ledelse,1455108866,2016-02-10 13:54:26,1455108866,0
5698dc3741a9d72100240f9a,85462,ORG3402 Organisasjonsatferd og ledelse,1453212792,2016-01-19 15:13:12,1453212964,172
5698dc3741a9d72100240f9a,39384,ORG3402 Organisasjonsatferd og ledelse,1453297091,2016-01-20 14:38:11,1453297135,44
5698dc3741a9d72100240f9a,21304,ORG3402 Organisasjonsatferd og ledelse,1455186883,2016-02-11 11:34:43,1455187153,270
5698dc3741a9d72100240f9b,44881,ORG3402 Organisasjonsatferd og ledelse,1453213871,2016-01-19 15:31:11,1453215605,1734
5698dc3741a9d72100240f9b,64752,ORG3402 Organisasjonsatferd og ledelse,1453740102,2016-01-25 17:41:42,1453741354,1252
5698dc3741a9d72100240f9b,37282,ORG3402 Organisasjonsatferd og ledelse,1453759743,2016-01-25 23:09:03,1453759745,2
5698dc3741a9d72100240f9b,29838,ORG3402 Organisasjonsatferd og ledelse,1454426188,2016-02-02 16:16:28,1454426190,2
5698dc3741a9d72100240f9d,16549,ORG3402 Organisasjonsatferd og ledelse,1453992703,2016-01-28 15:51:43,1453992733,30
5698dc3741a9d72100240f9d,96146,ORG3402 Organisasjonsatferd og ledelse,1454258131,2016-01-31 17:35:31,1454258155,24
5698dc3741a9d72100240f9d,10577,ORG3402 Organisasjonsatferd og ledelse,1454261356,2016-01-31 18:29:16,1454261362,6
5698dc3741a9d72100240f9d,57706,ORG3402 Organisasjonsatferd og ledelse,1454340219,2016-02-01 16:23:39,1454341089,870
5698dc3741a9d72100240f9d,84277,ORG3402 Organisasjonsatferd og ledelse,1454497694,2016-02-03 12:08:14,1454497698,4
5698dc3741a9d72100240f9d,35117,ORG3402 Organisasjonsatferd og ledelse,1454506534,2016-02-03 14:35:34,1454506547,13
5698dc3741a9d72100240f9d,56422,ORG3402 Organisasjonsatferd og ledelse,1454527198,2016-02-03 20:19:58,1454527212,14
5698dc3741a9d72100240f9d,45907,ORG3402 Organisasjonsatferd og ledelse,1454607178,2016-02-04 18:32:58,1454607185,7
5698dc3741a9d72100240f9d,41561,ORG3402 Organisasjonsatferd og ledelse,1454859298,2016-02-07 16:34:58,1454859367,69
5698dc3741a9d72100240f9d,27250,ORG3402 Organisasjonsatferd og ledelse,1454935089,2016-02-08 13:38:09,1454935099,10
5698dc3741a9d72100240f9d,20760,ORG3402 Organisasjonsatferd og ledelse,1455027131,2016-02-09 15:12:11,1455027208,77
5698dc3741a9d72100240f9d,66265,ORG3402 Organisasjonsatferd og ledelse,1455104602,2016-02-10 12:43:22,1455104632,30
5698dc3741a9d72100240f9d,61056,ORG3402 Organisasjonsatferd og ledelse,1455107138,2016-02-10 13:25:38,1455107142,4
5698dc3741a9d72100240f9d,23517,ORG3402 Organisasjonsatferd og ledelse,1455110745,2016-02-10 14:25:45,1455110750,5
5698dc3741a9d72100240f9d,5946,ORG3402 Organisasjonsatferd og ledelse,1455291690,2016-02-12 16:41:30,1455291702,12
5698dc382fb0de2600f2314b,8172,ORG3402 Organisasjonsatferd og ledelse,1453288314,2016-01-20 12:11:54,1453288432,118
5698dc382fb0de2600f2314c,46427,ORG3402 Organisasjonsatferd og ledelse,1453063501,2016-01-17 21:45:01,1453063760,259
5698dc382fb0de2600f2314c,43719,ORG3402 Organisasjonsatferd og ledelse,1453145128,2016-01-18 20:25:28,1453146203,1075
5698dc382fb0de2600f2314c,28210,ORG3402 Organisasjonsatferd og ledelse,1453234916,2016-01-19 21:21:56,1453234919,3
5698dc382fb0de2600f2314c,83334,ORG3402 Organisasjonsatferd og ledelse,1454453425,2016-02-02 23:50:25,1454454027,602
5698dc382fb0de2600f2314c,54139,ORG3402 Organisasjonsatferd og ledelse,1454516414,2016-02-03 17:20:14,1454516437,23
5698dc382fb0de2600f2314c,30857,ORG3402 Organisasjonsatferd og ledelse,1454517657,2016-02-03 17:40:57,1454517723,66
5698dc382fb0de2600f2314c,25487,ORG3402 Organisasjonsatferd og ledelse,1454528006,2016-02-03 20:33:26,1454528016,10
5698dc382fb0de2600f2314d,59685,ORG3402 Organisasjonsatferd og ledelse,1454081097,2016-01-29 16:24:57,1454081272,175
5698dc382fb0de2600f2314d,55726,ORG3402 Organisasjonsatferd og ledelse,1455389290,2016-02-13 19:48:10,1455389290,0
5698dc382fb0de2600f2314e,45638,ORG3402 Organisasjonsatferd og ledelse,1454506068,2016-02-03 14:27:48,1454506203,135
5698dc382fb0de2600f2314e,21571,ORG3402 Organisasjonsatferd og ledelse,1455291847,2016-02-12 16:44:07,1455292356,509
5698dc382fb0de2600f2314e,84683,ORG3402 Organisasjonsatferd og ledelse,1455319639,2016-02-13 00:27:19,1455319639,0
5698dc382fb0de2600f23151,32625,ORG3402 Organisasjonsatferd og ledelse,1452981790,2016-01-16 23:03:10,1452982208,418
5698dc382fb0de2600f23151,71806,ORG3402 Organisasjonsatferd og ledelse,1453124492,2016-01-18 14:41:32,1453124746,254
5698dc382fb0de2600f23151,98421,ORG3402 Organisasjonsatferd og ledelse,1453127126,2016-01-18 15:25:26,1453127129,3
5698dc382fb0de2600f23151,36483,ORG3402 Organisasjonsatferd og ledelse,1454674403,2016-02-05 13:13:23,1454674628,225
5698dc382fb0de2600f23152,94685,ORG3402 Organisasjonsatferd og ledelse,1453300804,2016-01-20 15:40:04,1453300865,61
5698dc382fb0de2600f23152,42246,ORG3402 Organisasjonsatferd og ledelse,1453892969,2016-01-27 12:09:29,1453893037,68
5698dc382fb0de2600f23152,3728,ORG3402 Organisasjonsatferd og ledelse,1453894933,2016-01-27 12:42:13,1453895731,798
5698dc382fb0de2600f23152,66671,ORG3402 Organisasjonsatferd og ledelse,1453901987,2016-01-27 14:39:47,1453901987,0
5698dc382fb0de2600f23152,94753,ORG3402 Organisasjonsatferd og ledelse,1453941838,2016-01-28 01:43:58,1453941840,2
5698dc382fb0de2600f23152,16984,ORG3402 Organisasjonsatferd og ledelse,1453946416,2016-01-28 03:00:16,1453946418,2
5698dc382fb0de2600f23152,32310,ORG3402 Organisasjonsatferd og ledelse,1454066143,2016-01-29 12:15:43,1454066154,11
5698dc382fb0de2600f23152,73139,ORG3402 Organisasjonsatferd og ledelse,1454070072,2016-01-29 13:21:12,1454070072,0
5698dc382fb0de2600f23152,24291,ORG3402 Organisasjonsatferd og ledelse,1454073339,2016-01-29 14:15:39,1454073596,257
5698dc382fb0de2600f23152,36439,ORG3402 Organisasjonsatferd og ledelse,1454359121,2016-02-01 21:38:41,1454359122,1
5698dc382fb0de2600f23152,83892,ORG3402 Organisasjonsatferd og ledelse,1454378084,2016-02-02 02:54:44,1454378567,483
5698dc382fb0de2600f23152,68444,ORG3402 Organisasjonsatferd og ledelse,1454458402,2016-02-03 01:13:22,1454458815,413
5698dc382fb0de2600f23152,63350,ORG3402 Organisasjonsatferd og ledelse,1455102841,2016-02-10 12:14:01,1455102884,43
5698dc382fb0de2600f23157,4313,ORG3402 Organisasjonsatferd og ledelse,1452948442,2016-01-16 13:47:22,1452948511,69
5698dc382fb0de2600f23157,91820,ORG3402 Organisasjonsatferd og ledelse,1453220196,2016-01-19 17:16:36,1453220262,66
5698dc382fb0de2600f23157,73275,ORG3402 Organisasjonsatferd og ledelse,1453230124,2016-01-19 20:02:04,1453230134,10
5698dc382fb0de2600f23157,54171,ORG3402 Organisasjonsatferd og ledelse,1453476305,2016-01-22 16:25:05,1453476439,134
5698dc382fb0de2600f23157,37963,ORG3402 Organisasjonsatferd og ledelse,1453892679,2016-01-27 12:04:39,1453893349,670
5698dc382fb0de2600f23157,20676,ORG3402 Organisasjonsatferd og ledelse,1453896439,2016-01-27 13:07:19,1453896470,31
5698dc382fb0de2600f23157,6678,ORG3402 Organisasjonsatferd og ledelse,1454499196,2016-02-03 12:33:16,1454499216,20
5698dc382fb0de2600f23157,33822,ORG3402 Organisasjonsatferd og ledelse,1454506530,2016-02-03 14:35:30,1454506546,16
5698dc382fb0de2600f23157,95384,ORG3402 Organisasjonsatferd og ledelse,1455106189,2016-02-10 13:09:49,1455106233,44
5698dc3841a9d72100240f9e,33479,ORG3402 Organisasjonsatferd og ledelse,1455109378,2016-02-10 14:02:58,1455109603,225
5698dc3841a9d72100240f9e,94803,ORG3402 Organisasjonsatferd og ledelse,1455112541,2016-02-10 14:55:41,1455112568,27
5698dc3841a9d72100240f9e,29717,ORG3402 Organisasjonsatferd og ledelse,1455185242,2016-02-11 11:07:22,1455185572,330
5698dc3841a9d72100240f9e,99875,ORG3402 Organisasjonsatferd og ledelse,1455273687,2016-02-12 11:41:27,1455273687,0
5698dc3841a9d72100240f9f,50826,ORG3402 Organisasjonsatferd og ledelse,1453911723,2016-01-27 17:22:03,1453912442,719
5698dc3841a9d72100240f9f,64075,ORG3402 Organisasjonsatferd og ledelse,1455026253,2016-02-09 14:57:33,1455026373,120
5698dc3841a9d72100240f9f,82174,ORG3402 Organisasjonsatferd og ledelse,1455028336,2016-02-09 15:32:16,1455028336,0
5698dc3841a9d72100240fa0,50861,ORG3402 Organisasjonsatferd og ledelse,1454762984,2016-02-06 13:49:44,1454763033,49
5698dc392fb0de2600f23159,26489,ORG3402 Organisasjonsatferd og ledelse,1453895516,2016-01-27 12:51:56,1453895622,106
5698dc392fb0de2600f23159,31327,ORG3402 Organisasjonsatferd og ledelse,1453989385,2016-01-28 14:56:25,1453989385,0
5698dc392fb0de2600f23159,80778,ORG3402 Organisasjonsatferd og ledelse,1454026183,2016-01-29 01:09:43,1454026183,0
5698dc392fb0de2600f23159,6445,ORG3402 Organisasjonsatferd og ledelse,1454053595,2016-01-29 08:46:35,1454053595,0
5698dc392fb0de2600f23173,86736,ORG3402 Organisasjonsatferd og ledelse,1453825290,2016-01-26 17:21:30,1453825541,251
5698dc392fb0de2600f23173,44588,ORG3402 Organisasjonsatferd og ledelse,1454534308,2016-02-03 22:18:28,1454534323,15
5698dc392fb0de2600f23173,28349,ORG3402 Organisasjonsatferd og ledelse,1454898390,2016-02-08 03:26:30,1454898468,78
5698dc392fb0de2600f23173,72014,ORG3402 Organisasjonsatferd og ledelse,1454936485,2016-02-08 14:01:25,1454936485,0
5698dc392fb0de2600f23174,20845,ORG3402 Organisasjonsatferd og ledelse,1452903550,2016-01-16 01:19:10,1452903608,58
5698dc392fb0de2600f23174,23042,ORG3402 Organisasjonsatferd og ledelse,1452905167,2016-01-16 01:46:07,1452905181,14
5698dc392fb0de2600f23174,76376,ORG3402 Organisasjonsatferd og ledelse,1452953380,2016-01-16 15:09:40,1452953400,20
5698dc392fb0de2600f23174,71221,ORG3402 Organisasjonsatferd og ledelse,1453052004,2016-01-17 18:33:24,1453052220,216
5698dc392fb0de2600f23174,23463,ORG3402 Organisasjonsatferd og ledelse,1453060599,2016-01-17 20:56:39,1453060622,23
5698dc392fb0de2600f23174,62607,ORG3402 Organisasjonsatferd og ledelse,1453063936,2016-01-17 21:52:16,1453063972,36
5698dc392fb0de2600f23174,33514,ORG3402 Organisasjonsatferd og ledelse,1453140345,2016-01-18 19:05:45,1453140362,17
5698dc392fb0de2600f23174,39831,ORG3402 Organisasjonsatferd og ledelse,1453412380,2016-01-21 22:39:40,1453412403,23
5698dc392fb0de2600f23174,28648,ORG3402 Organisasjonsatferd og ledelse,1453689106,2016-01-25 03:31:46,1453689135,29
5698dc392fb0de2600f23174,56790,ORG3402 Organisasjonsatferd og ledelse,1454087417,2016-01-29 18:10:17,1454087527,110
5698dc3941a9d72100240fc0,36697,ORG3402 Organisasjonsatferd og ledelse,1454489897,2016-02-03 09:58:17,1454490032,135
5698dc3941a9d72100240fc0,28542,ORG3402 Organisasjonsatferd og ledelse,1455016296,2016-02-09 12:11:36,1455016403,107
5698dc3a2fb0de2600f23175,91091,ORG3402 Organisasjonsatferd og ledelse,1452865820,2016-01-15 14:50:20,1452865899,79
5698dc3a2fb0de2600f23175,61864,ORG3402 Organisasjonsatferd og ledelse,1452895048,2016-01-15 22:57:28,1452895070,22
5698dc3a2fb0de2600f23175,31729,ORG3402 Organisasjonsatferd og ledelse,1452951006,2016-01-16 14:30:06,1452951007,1
5698dc3a2fb0de2600f23175,47003,ORG3402 Organisasjonsatferd og ledelse,1452953355,2016-01-16 15:09:15,1452953356,1
5698dc3a2fb0de2600f23175,26491,ORG3402 Organisasjonsatferd og ledelse,1453049990,2016-01-17 17:59:50,1453051350,1360
5698dc3a2fb0de2600f23175,33862,ORG3402 Organisasjonsatferd og ledelse,1453056893,2016-01-17 19:54:53,1453056901,8
5698dc3a2fb0de2600f23175,29799,ORG3402 Organisasjonsatferd og ledelse,1453224922,2016-01-19 18:35:22,1453226107,1185
5698dc3a2fb0de2600f23175,92326,ORG3402 Organisasjonsatferd og ledelse,1453381948,2016-01-21 14:12:28,1453381948,0
5698dc3a2fb0de2600f23175,60243,ORG3402 Organisasjonsatferd og ledelse,1453515639,2016-01-23 03:20:39,1453515639,0
5698dc3a2fb0de2600f23175,82269,ORG3402 Organisasjonsatferd og ledelse,1453668591,2016-01-24 21:49:51,1453668596,5
5698dc3a2fb0de2600f23175,42423,ORG3402 Organisasjonsatferd og ledelse,1453670930,2016-01-24 22:28:50,1453670931,1
5698dc3a2fb0de2600f23175,9937,ORG3402 Organisasjonsatferd og ledelse,1453822332,2016-01-26 16:32:12,1453822342,10
5698dc3a2fb0de2600f23175,61790,ORG3402 Organisasjonsatferd og ledelse,1453892643,2016-01-27 12:04:03,1453892877,234
5698dc3a2fb0de2600f23175,72656,ORG3402 Organisasjonsatferd og ledelse,1453936339,2016-01-28 00:12:19,1453936481,142
5698dc3a2fb0de2600f23175,29334,ORG3402 Organisasjonsatferd og ledelse,1454003966,2016-01-28 18:59:26,1454003967,1
5698dc3a2fb0de2600f23175,14336,ORG3402 Organisasjonsatferd og ledelse,1454015142,2016-01-28 22:05:42,1454015186,44
5698dc3a2fb0de2600f23175,58298,ORG3402 Organisasjonsatferd og ledelse,1454065322,2016-01-29 12:02:02,1454065323,1
5698dc3a2fb0de2600f23175,39166,ORG3402 Organisasjonsatferd og ledelse,1454073997,2016-01-29 14:26:37,1454073997,0
5698dc3a2fb0de2600f23175,54241,ORG3402 Organisasjonsatferd og ledelse,1454436920,2016-02-02 19:15:20,1454437064,144
5698dc3a2fb0de2600f23175,17886,ORG3402 Organisasjonsatferd og ledelse,1454466756,2016-02-03 03:32:36,1454466797,41
5698dc3a2fb0de2600f23175,49760,ORG3402 Organisasjonsatferd og ledelse,1454504976,2016-02-03 14:09:36,1454505010,34
5698dc3a2fb0de2600f23175,77925,ORG3402 Organisasjonsatferd og ledelse,1454965536,2016-02-08 22:05:36,1454965562,26
5698dc3a2fb0de2600f23175,97880,ORG3402 Organisasjonsatferd og ledelse,1455008820,2016-02-09 10:07:00,1455009007,187
5698dc3a2fb0de2600f23175,8797,ORG3402 Organisasjonsatferd og ledelse,1455037573,2016-02-09 18:06:13,1455038282,709
5698dc3a2fb0de2600f23175,31293,ORG3402 Organisasjonsatferd og ledelse,1455104360,2016-02-10 12:39:20,1455104360,0
5698dc3a2fb0de2600f23175,64775,ORG3402 Organisasjonsatferd og ledelse,1455128674,2016-02-10 19:24:34,1455128675,1
5698dc3a2fb0de2600f23175,19604,ORG3402 Organisasjonsatferd og ledelse,1455241560,2016-02-12 02:46:00,1455241560,0
5698dc3a2fb0de2600f23175,32679,ORG3402 Organisasjonsatferd og ledelse,1455449442,2016-02-14 12:30:42,1455449442,0
5698dc3a2fb0de2600f23177,11658,ORG3402 Organisasjonsatferd og ledelse,1453041104,2016-01-17 15:31:44,1453041138,34
5698dc3a2fb0de2600f23177,84657,ORG3402 Organisasjonsatferd og ledelse,1453058456,2016-01-17 20:20:56,1453058480,24
5698dc3a2fb0de2600f23177,67394,ORG3402 Organisasjonsatferd og ledelse,1453902447,2016-01-27 14:47:27,1453902482,35
5698dc3a41a9d72100240fc1,61110,ORG3402 Organisasjonsatferd og ledelse,1452862094,2016-01-15 13:48:14,1452862111,17
5698dc3a41a9d72100240fc1,43355,ORG3402 Organisasjonsatferd og ledelse,1453060127,2016-01-17 20:48:47,1453060223,96
5698dc3a41a9d72100240fc1,79007,ORG3402 Organisasjonsatferd og ledelse,1453804715,2016-01-26 11:38:35,1453804744,29
5698dc3a41a9d72100240fc1,10826,ORG3402 Organisasjonsatferd og ledelse,1453808413,2016-01-26 12:40:13,1453808413,0
5698dc3a41a9d72100240fc1,25195,ORG3402 Organisasjonsatferd og ledelse,1454341313,2016-02-01 16:41:53,1454341682,369
5698dc3a41a9d72100240fc2,20236,ORG3402 Organisasjonsatferd og ledelse,1453107756,2016-01-18 10:02:36,1453107892,136
5698dc3a41a9d72100240fc2,39455,ORG3402 Organisasjonsatferd og ledelse,1453480501,2016-01-22 17:35:01,1453480501,0
5698dc3a41a9d72100240fc2,48859,ORG3402 Organisasjonsatferd og ledelse,1453556382,2016-01-23 14:39:42,1453556387,5
5698dc3a41a9d72100240fc2,16590,ORG3402 Organisasjonsatferd og ledelse,1453639548,2016-01-24 13:45:48,1453639551,3
5698dc3a41a9d72100240fc2,44493,ORG3402 Organisasjonsatferd og ledelse,1453731617,2016-01-25 15:20:17,1453731617,0
5698dc3a41a9d72100240fc2,41327,ORG3402 Organisasjonsatferd og ledelse,1453733886,2016-01-25 15:58:06,1453734300,414
5698dc3a41a9d72100240fc2,64708,ORG3402 Organisasjonsatferd og ledelse,1453738965,2016-01-25 17:22:45,1453738965,0
5698dc3a41a9d72100240fc2,53908,ORG3402 Organisasjonsatferd og ledelse,1453895950,2016-01-27 12:59:10,1453895950,0
5698dc3a41a9d72100240fc7,67754,ORG3402 Organisasjonsatferd og ledelse,1453319522,2016-01-20 20:52:02,1453319522,0
5698dc3a41a9d72100240fc7,74245,ORG3402 Organisasjonsatferd og ledelse,1453550281,2016-01-23 12:58:01,1453550293,12
5698dc3a41a9d72100240fc7,29270,ORG3402 Organisasjonsatferd og ledelse,1453749175,2016-01-25 20:12:55,1453749179,4
5698dc3a41a9d72100240fc7,16497,ORG3402 Organisasjonsatferd og ledelse,1453825130,2016-01-26 17:18:50,1453825145,15
5698dc3a41a9d72100240fc7,31834,ORG3402 Organisasjonsatferd og ledelse,1453892898,2016-01-27 12:08:18,1453892903,5
5698dc3a41a9d72100240fc7,15859,ORG3402 Organisasjonsatferd og ledelse,1454246424,2016-01-31 14:20:24,1454246446,22
5698dc3a41a9d72100240fc7,49234,ORG3402 Organisasjonsatferd og ledelse,1454248894,2016-01-31 15:01:34,1454248897,3
5698dc3a41a9d72100240fc7,90891,ORG3402 Organisasjonsatferd og ledelse,1454503708,2016-02-03 13:48:28,1454503736,28
5698dc3a41a9d72100240fc7,19287,ORG3402 Organisasjonsatferd og ledelse,1454857877,2016-02-07 16:11:17,1454858645,768
5698dc3a41a9d72100240fc7,25856,ORG3402 Organisasjonsatferd og ledelse,1454940175,2016-02-08 15:02:55,1454940192,17
5698dc3a41a9d72100240fc7,55599,ORG3402 Organisasjonsatferd og ledelse,1455036603,2016-02-09 17:50:03,1455036603,0
5698dc3a41a9d72100240fc7,57676,ORG3402 Organisasjonsatferd og ledelse,1455104537,2016-02-10 12:42:17,1455104613,76
5698dc3a41a9d72100240fc7,18872,ORG3402 Organisasjonsatferd og ledelse,1455105866,2016-02-10 13:04:26,1455105873,7
5698dc3a41a9d72100240fc7,46385,ORG3402 Organisasjonsatferd og ledelse,1455467447,2016-02-14 17:30:47,1455467447,0
5698dc3a41a9d72100240fc7,33786,ORG3402 Organisasjonsatferd og ledelse,1455469389,2016-02-14 18:03:09,1455469394,5
5698dc3a41a9d72100240fc8,22320,ORG3402 Organisasjonsatferd og ledelse,1453893189,2016-01-27 12:13:09,1453893262,73
5698dc3b2fb0de2600f2317e,80259,ORG3402 Organisasjonsatferd og ledelse,1454076570,2016-01-29 15:09:30,1454076723,153
5698dc3b2fb0de2600f2317e,66101,ORG3402 Organisasjonsatferd og ledelse,1454244134,2016-01-31 13:42:14,1454244632,498
5698dc3b2fb0de2600f2317e,93199,ORG3402 Organisasjonsatferd og ledelse,1454451908,2016-02-02 23:25:08,1454452177,269
5698dc3b2fb0de2600f2317f,55378,ORG3402 Organisasjonsatferd og ledelse,1454969988,2016-02-08 23:19:48,1454970075,87
5698dc3b2fb0de2600f2317f,42616,ORG3402 Organisasjonsatferd og ledelse,1455133271,2016-02-10 20:41:11,1455134224,953
5698dc3b2fb0de2600f2317f,75924,ORG3402 Organisasjonsatferd og ledelse,1455458980,2016-02-14 15:09:40,1455458980,0
5698dc3b2fb0de2600f23183,73988,ORG3402 Organisasjonsatferd og ledelse,1454361833,2016-02-01 22:23:53,1454362378,545
5698dc3b41a9d72100240fca,62604,ORG3402 Organisasjonsatferd og ledelse,1452894832,2016-01-15 22:53:52,1452894849,17
5698dc3b41a9d72100240fca,44958,ORG3402 Organisasjonsatferd og ledelse,1452942844,2016-01-16 12:14:04,1452942847,3
5698dc3b41a9d72100240fca,99318,ORG3402 Organisasjonsatferd og ledelse,1453084616,2016-01-18 03:36:56,1453084616,0
5698dc3b41a9d72100240fca,76219,ORG3402 Organisasjonsatferd og ledelse,1453670364,2016-01-24 22:19:24,1453670434,70
5698dc3b41a9d72100240fca,30539,ORG3402 Organisasjonsatferd og ledelse,1455094569,2016-02-10 09:56:09,1455094694,125
5698dc3b41a9d72100240fcc,75926,ORG3402 Organisasjonsatferd og ledelse,1453124298,2016-01-18 14:38:18,1453124333,35
5698dc3b41a9d72100240fcc,89589,ORG3402 Organisasjonsatferd og ledelse,1453286023,2016-01-20 11:33:43,1453286088,65
5698dc3b41a9d72100240fcc,26643,ORG3402 Organisasjonsatferd og ledelse,1453739347,2016-01-25 17:29:07,1453739362,15
5698dc3b41a9d72100240fcc,91823,ORG3402 Organisasjonsatferd og ledelse,1453902843,2016-01-27 14:54:03,1453902897,54
5698dc3b41a9d72100240fcf,47213,ORG3402 Organisasjonsatferd og ledelse,1455187844,2016-02-11 11:50:44,1455187844,0
5698dc3c41a9d72100240fd1,81237,ORG3402 Organisasjonsatferd og ledelse,1454498663,2016-02-03 12:24:23,1454499887,1224
5698dc3c41a9d72100240fd1,59588,ORG3402 Organisasjonsatferd og ledelse,1454501503,2016-02-03 13:11:43,1454502620,1117
5698dc3c41a9d72100240fd1,4533,ORG3402 Organisasjonsatferd og ledelse,1454505827,2016-02-03 14:23:47,1454505828,1
5698dc3c41a9d72100240fd2,50746,ORG3402 Organisasjonsatferd og ledelse,1454504139,2016-02-03 13:55:39,1454504139,0
5698dc3c41a9d72100240fd2,62680,ORG3402 Organisasjonsatferd og ledelse,1454587401,2016-02-04 13:03:21,1454587440,39
5698dc3c41a9d72100240fd2,25577,ORG3402 Organisasjonsatferd og ledelse,1454680791,2016-02-05 14:59:51,1454680977,186
5698dc3c41a9d72100240fd2,56446,ORG3402 Organisasjonsatferd og ledelse,1455031362,2016-02-09 16:22:42,1455032434,1072
5698dc3c41a9d72100240fe8,30007,ORG3402 Organisasjonsatferd og ledelse,1455100552,2016-02-10 11:35:52,1455100552,0
5698dc3d2fb0de2600f2319d,19796,ORG3402 Organisasjonsatferd og ledelse,1453070335,2016-01-17 23:38:55,1453070335,0
5698dc3d2fb0de2600f2319d,91860,ORG3402 Organisasjonsatferd og ledelse,1453071830,2016-01-18 00:03:50,1453071831,1
5698dc3d2fb0de2600f2319d,88721,ORG3402 Organisasjonsatferd og ledelse,1453933876,2016-01-27 23:31:16,1453933882,6
5698dc3d2fb0de2600f2319d,1442,ORG3402 Organisasjonsatferd og ledelse,1453984596,2016-01-28 13:36:36,1453985213,617
5698dc3d2fb0de2600f2319f,52732,ORG3402 Organisasjonsatferd og ledelse,1454528719,2016-02-03 20:45:19,1454528719,0
5698dc3d2fb0de2600f2319f,43833,ORG3402 Organisasjonsatferd og ledelse,1454933809,2016-02-08 13:16:49,1454933841,32
5698dc3d2fb0de2600f231a1,28520,ORG3402 Organisasjonsatferd og ledelse,1453895094,2016-01-27 12:44:54,1453897093,1999
5698dc3d2fb0de2600f231a1,95059,ORG3402 Organisasjonsatferd og ledelse,1453924853,2016-01-27 21:00:53,1453925099,246
5698dc3d41a9d72100240fec,2772,ORG3402 Organisasjonsatferd og ledelse,1453999606,2016-01-28 17:46:46,1453999791,185
5698dc3d41a9d72100240fec,15663,ORG3402 Organisasjonsatferd og ledelse,1455096070,2016-02-10 10:21:10,1455096479,409
5698dc3d41a9d72100240fec,37267,ORG3402 Organisasjonsatferd og ledelse,1455099230,2016-02-10 11:13:50,1455099336,106
5698dc3d41a9d72100240fec,63736,ORG3402 Organisasjonsatferd og ledelse,1455102321,2016-02-10 12:05:21,1455102330,9
5698dc3d41a9d72100240fec,21292,ORG3402 Organisasjonsatferd og ledelse,1455104355,2016-02-10 12:39:15,1455104355,0
5698dc3d41a9d72100240fed,99364,ORG3402 Organisasjonsatferd og ledelse,1453924600,2016-01-27 20:56:40,1453924639,39
5698dc3d41a9d72100240fee,31595,ORG3402 Organisasjonsatferd og ledelse,1453127778,2016-01-18 15:36:18,1453127986,208
5698dc3d41a9d72100240fee,27842,ORG3402 Organisasjonsatferd og ledelse,1453141990,2016-01-18 19:33:10,1453142006,16
5698dc3d41a9d72100240fee,95042,ORG3402 Organisasjonsatferd og ledelse,1453672103,2016-01-24 22:48:23,1453672115,12
5698dc3d41a9d72100240fee,37016,ORG3402 Organisasjonsatferd og ledelse,1453913012,2016-01-27 17:43:32,1453913012,0
5698dc3d41a9d72100240fee,83758,ORG3402 Organisasjonsatferd og ledelse,1453916257,2016-01-27 18:37:37,1453916265,8
5698dc3d41a9d72100240fee,23144,ORG3402 Organisasjonsatferd og ledelse,1454518232,2016-02-03 17:50:32,1454518420,188
5698dc3d41a9d72100240fee,97223,ORG3402 Organisasjonsatferd og ledelse,1454855409,2016-02-07 15:30:09,1454855440,31
5698dc3d41a9d72100240fee,28729,ORG3402 Organisasjonsatferd og ledelse,1454866204,2016-02-07 18:30:04,1454866889,685
5698dc3e41a9d72100240ff0,34727,ORG3402 Organisasjonsatferd og ledelse,1453323584,2016-01-20 21:59:44,1453324192,608
5698dc3e41a9d72100240ff7,92993,ORG3402 Organisasjonsatferd og ledelse,1453288273,2016-01-20 12:11:13,1453288374,101
5698dc3f2fb0de2600f231ae,86725,ORG3402 Organisasjonsatferd og ledelse,1453215786,2016-01-19 16:03:06,1453216436,650
5698dc3f2fb0de2600f231ae,2360,ORG3402 Organisasjonsatferd og ledelse,1453838920,2016-01-26 21:08:40,1453838921,1
5698dc3f2fb0de2600f231ae,21510,ORG3402 Organisasjonsatferd og ledelse,1453986801,2016-01-28 14:13:21,1453986801,0
5698dc3f2fb0de2600f231ae,90653,ORG3402 Organisasjonsatferd og ledelse,1454351854,2016-02-01 19:37:34,1454352587,733
5698dc3f2fb0de2600f231ae,1917,ORG3402 Organisasjonsatferd og ledelse,1454354250,2016-02-01 20:17:30,1454354259,9
5698dc3f2fb0de2600f231ae,40172,ORG3402 Organisasjonsatferd og ledelse,1454701490,2016-02-05 20:44:50,1454701765,275
5698dc3f2fb0de2600f231ae,88048,ORG3402 Organisasjonsatferd og ledelse,1455105300,2016-02-10 12:55:00,1455105300,0
5698dc3f2fb0de2600f231ae,46469,ORG3402 Organisasjonsatferd og ledelse,1455129381,2016-02-10 19:36:21,1455129388,7
5698dc3f2fb0de2600f231ae,17586,ORG3402 Organisasjonsatferd og ledelse,1455370954,2016-02-13 14:42:34,1455370954,0
5698dc3f41a9d72100240ff8,28732,ORG3402 Organisasjonsatferd og ledelse,1454075908,2016-01-29 14:58:28,1454076003,95
5698dc3f41a9d72100240ff8,766,ORG3402 Organisasjonsatferd og ledelse,1455016697,2016-02-09 12:18:17,1455016740,43
5698dc3f41a9d72100240ff8,42601,ORG3402 Organisasjonsatferd og ledelse,1455039319,2016-02-09 18:35:19,1455039319,0
5698dc3f41a9d72100240ff8,71561,ORG3402 Organisasjonsatferd og ledelse,1455049164,2016-02-09 21:19:24,1455049164,0
5698dc3f41a9d72100240ff8,63354,ORG3402 Organisasjonsatferd og ledelse,1455114557,2016-02-10 15:29:17,1455115065,508
5698dc3f41a9d72100240ff8,54755,ORG3402 Organisasjonsatferd og ledelse,1455488163,2016-02-14 23:16:03,1455488163,0
5698dc3f41a9d72100240ff9,69446,ORG3402 Organisasjonsatferd og ledelse,1452877410,2016-01-15 18:03:30,1452877460,50
5698dc3f41a9d72100240ff9,43311,ORG3402 Organisasjonsatferd og ledelse,1453067221,2016-01-17 22:47:01,1453067268,47
5698dc3f41a9d72100240ff9,22429,ORG3402 Organisasjonsatferd og ledelse,1453130082,2016-01-18 16:14:42,1453130137,55
5698dc3f41a9d72100240ff9,52864,ORG3402 Organisasjonsatferd og ledelse,1453302969,2016-01-20 16:16:09,1453304093,1124
5698dc3f41a9d72100240ff9,7885,ORG3402 Organisasjonsatferd og ledelse,1453721721,2016-01-25 12:35:21,1453721809,88
5698dc3f41a9d72100240ff9,38563,ORG3402 Organisasjonsatferd og ledelse,1455281031,2016-02-12 13:43:51,1455281261,230
5698dc3f41a9d72100240ffa,96494,ORG3402 Organisasjonsatferd og ledelse,1452881914,2016-01-15 19:18:34,1452882079,165
5698dc3f41a9d72100240ffa,50363,ORG3402 Organisasjonsatferd og ledelse,1452885635,2016-01-15 20:20:35,1452886811,1176
5698dc3f41a9d72100240ffa,89110,ORG3402 Organisasjonsatferd og ledelse,1453053279,2016-01-17 18:54:39,1453053322,43
5698dc3f41a9d72100240ffa,877,ORG3402 Organisasjonsatferd og ledelse,1453142438,2016-01-18 19:40:38,1453142438,0
5698dc3f41a9d72100240ffa,82543,ORG3402 Organisasjonsatferd og ledelse,1453673013,2016-01-24 23:03:33,1453673149,136
5698dc3f41a9d72100240ffa,46280,ORG3402 Organisasjonsatferd og ledelse,1454347211,2016-02-01 18:20:11,1454347309,98
5698dc3f41a9d72100240ffa,88224,ORG3402 Organisasjonsatferd og ledelse,1454348951,2016-02-01 18:49:11,1454349132,181
5698dc3f41a9d72100240ffa,41359,ORG3402 Organisasjonsatferd og ledelse,1454939373,2016-02-08 14:49:33,1454939377,4
5698dc4041a9d72100241010,49142,ORG3402 Organisasjonsatferd og ledelse,1452869495,2016-01-15 15:51:35,1452869521,26
5698dc4041a9d72100241010,20972,ORG3402 Organisasjonsatferd og ledelse,1453288248,2016-01-20 12:10:48,1453288482,234
5698dc4041a9d72100241010,4709,ORG3402 Organisasjonsatferd og ledelse,1453382423,2016-01-21 14:20:23,1453383524,1101
5698dc4041a9d72100241010,54289,ORG3402 Organisasjonsatferd og ledelse,1453505776,2016-01-23 00:36:16,1453505778,2
5698dc4041a9d72100241012,43979,ORG3402 Organisasjonsatferd og ledelse,1453740795,2016-01-25 17:53:15,1453741350,555
5698dc4041a9d72100241012,38659,ORG3402 Organisasjonsatferd og ledelse,1454523929,2016-02-03 19:25:29,1454523930,1
5698dc4041a9d72100241012,93110,ORG3402 Organisasjonsatferd og ledelse,1455231000,2016-02-11 23:50:00,1455231000,0
5698dc4041a9d72100241013,78356,ORG3402 Organisasjonsatferd og ledelse,1452862148,2016-01-15 13:49:08,1452862253,105
5698dc4041a9d72100241013,7476,ORG3402 Organisasjonsatferd og ledelse,1453036522,2016-01-17 14:15:22,1453036525,3
5698dc4041a9d72100241013,85265,ORG3402 Organisasjonsatferd og ledelse,1453051334,2016-01-17 18:22:14,1453051359,25
5698dc4041a9d72100241013,20633,ORG3402 Organisasjonsatferd og ledelse,1453053727,2016-01-17 19:02:07,1453055790,2063
5698dc4041a9d72100241013,30112,ORG3402 Organisasjonsatferd og ledelse,1453058216,2016-01-17 20:16:56,1453058543,327
5698dc4041a9d72100241013,45229,ORG3402 Organisasjonsatferd og ledelse,1453122383,2016-01-18 14:06:23,1453122500,117
5698dc4041a9d72100241013,75067,ORG3402 Organisasjonsatferd og ledelse,1453150833,2016-01-18 22:00:33,1453150863,30
5698dc4041a9d72100241013,16605,ORG3402 Organisasjonsatferd og ledelse,1453205146,2016-01-19 13:05:46,1453205148,2
5698dc4041a9d72100241013,38929,ORG3402 Organisasjonsatferd og ledelse,1453220839,2016-01-19 17:27:19,1453220839,0
5698dc4041a9d72100241013,72847,ORG3402 Organisasjonsatferd og ledelse,1453260447,2016-01-20 04:27:27,1453260447,0
5698dc4041a9d72100241013,31074,ORG3402 Organisasjonsatferd og ledelse,1453299044,2016-01-20 15:10:44,1453299046,2
5698dc4041a9d72100241013,63395,ORG3402 Organisasjonsatferd og ledelse,1453471466,2016-01-22 15:04:26,1453471467,1
5698dc4041a9d72100241013,60252,ORG3402 Organisasjonsatferd og ledelse,1453672185,2016-01-24 22:49:45,1453672309,124
5698dc4041a9d72100241013,2298,ORG3402 Organisasjonsatferd og ledelse,1453727436,2016-01-25 14:10:36,1453727438,2
5698dc4041a9d72100241013,61166,ORG3402 Organisasjonsatferd og ledelse,1453743853,2016-01-25 18:44:13,1453743858,5
5698dc4041a9d72100241013,73513,ORG3402 Organisasjonsatferd og ledelse,1453749632,2016-01-25 20:20:32,1453749642,10
5698dc4041a9d72100241013,79997,ORG3402 Organisasjonsatferd og ledelse,1453829149,2016-01-26 18:25:49,1453829161,12
5698dc4041a9d72100241013,81263,ORG3402 Organisasjonsatferd og ledelse,1454267210,2016-01-31 20:06:50,1454267215,5
5698dc4041a9d72100241013,1379,ORG3402 Organisasjonsatferd og ledelse,1454415837,2016-02-02 13:23:57,1454416840,1003
5698dc4041a9d72100241013,57821,ORG3402 Organisasjonsatferd og ledelse,1454443013,2016-02-02 20:56:53,1454443014,1
5698dc4041a9d72100241013,49311,ORG3402 Organisasjonsatferd og ledelse,1454517508,2016-02-03 17:38:28,1454517556,48
5698dc4041a9d72100241013,32214,ORG3402 Organisasjonsatferd og ledelse,1454521834,2016-02-03 18:50:34,1454521835,1
5698dc4041a9d72100241013,96985,ORG3402 Organisasjonsatferd og ledelse,1454537127,2016-02-03 23:05:27,1454537128,1
5698dc4041a9d72100241013,34921,ORG3402 Organisasjonsatferd og ledelse,1454970892,2016-02-08 23:34:52,1454971531,639
5698dc4041a9d72100241013,29182,nan,1455033342,2016-02-09 16:55:42,1455033342,0
5698dc4041a9d72100241013,42475,ORG3402 Organisasjonsatferd og ledelse,1455039009,2016-02-09 18:30:09,1455039752,743
5698dc4041a9d72100241013,86715,ORG3402 Organisasjonsatferd og ledelse,1455058528,2016-02-09 23:55:28,1455058740,212
5698dc412fb0de2600f231c7,82893,ORG3402 Organisasjonsatferd og ledelse,1453724530,2016-01-25 13:22:10,1453724572,42
5698dc412fb0de2600f231c7,69613,ORG3402 Organisasjonsatferd og ledelse,1454490254,2016-02-03 10:04:14,1454490310,56
5698dc412fb0de2600f231c7,69404,ORG3402 Organisasjonsatferd og ledelse,1454492133,2016-02-03 10:35:33,1454492167,34
5698dc412fb0de2600f231c7,93624,ORG3402 Organisasjonsatferd og ledelse,1455488405,2016-02-14 23:20:05,1455488405,0
5698dc412fb0de2600f231c8,75512,ORG3402 Organisasjonsatferd og ledelse,1452862563,2016-01-15 13:56:03,1452862585,22
5698dc412fb0de2600f231c8,37143,ORG3402 Organisasjonsatferd og ledelse,1453050022,2016-01-17 18:00:22,1453050171,149
5698dc412fb0de2600f231c8,50444,ORG3402 Organisasjonsatferd og ledelse,1453058522,2016-01-17 20:22:02,1453058522,0
5698dc412fb0de2600f231c8,56274,ORG3402 Organisasjonsatferd og ledelse,1453062502,2016-01-17 21:28:22,1453062600,98
5698dc412fb0de2600f231c8,32715,ORG3402 Organisasjonsatferd og ledelse,1453064478,2016-01-17 22:01:18,1453064492,14
5698dc412fb0de2600f231c9,19660,ORG3402 Organisasjonsatferd og ledelse,1453888277,2016-01-27 10:51:17,1453888347,70
5698dc412fb0de2600f231d4,33556,ORG3402 Organisasjonsatferd og ledelse,1453208959,2016-01-19 14:09:19,1453209013,54
5698dc412fb0de2600f231d4,19230,ORG3402 Organisasjonsatferd og ledelse,1454121264,2016-01-30 03:34:24,1454121344,80
5698dc412fb0de2600f231d4,47986,ORG3402 Organisasjonsatferd og ledelse,1454442796,2016-02-02 20:53:16,1454442859,63
5698dc412fb0de2600f231d5,16000,ORG3402 Organisasjonsatferd og ledelse,1454326725,2016-02-01 12:38:45,1454326797,72
5698dc412fb0de2600f231d5,58323,ORG3402 Organisasjonsatferd og ledelse,1454427609,2016-02-02 16:40:09,1454428059,450
5698dc4141a9d72100241016,76028,ORG3402 Organisasjonsatferd og ledelse,1453490976,2016-01-22 20:29:36,1453491307,331
5698dc4141a9d72100241016,83914,ORG3402 Organisasjonsatferd og ledelse,1453658757,2016-01-24 19:05:57,1453658897,140
5698dc4141a9d72100241016,67802,ORG3402 Organisasjonsatferd og ledelse,1453716638,2016-01-25 11:10:38,1453716646,8
5698dc4141a9d72100241016,88355,ORG3402 Organisasjonsatferd og ledelse,1453729631,2016-01-25 14:47:11,1453729878,247
5698dc4141a9d72100241016,76293,ORG3402 Organisasjonsatferd og ledelse,1453816561,2016-01-26 14:56:01,1453816783,222
5698dc4141a9d72100241016,11117,ORG3402 Organisasjonsatferd og ledelse,1453822751,2016-01-26 16:39:11,1453822751,0
5698dc4141a9d72100241016,91794,ORG3402 Organisasjonsatferd og ledelse,1453892657,2016-01-27 12:04:17,1453894393,1736
5698dc4141a9d72100241016,61964,ORG3402 Organisasjonsatferd og ledelse,1453896497,2016-01-27 13:08:17,1453896534,37
5698dc4141a9d72100241016,40112,ORG3402 Organisasjonsatferd og ledelse,1453900208,2016-01-27 14:10:08,1453900321,113
5698dc4141a9d72100241016,43166,ORG3402 Organisasjonsatferd og ledelse,1454065124,2016-01-29 11:58:44,1454065325,201
5698dc4141a9d72100241016,16462,ORG3402 Organisasjonsatferd og ledelse,1454423520,2016-02-02 15:32:00,1454423878,358
5698dc4141a9d72100241016,38235,ORG3402 Organisasjonsatferd og ledelse,1454427009,2016-02-02 16:30:09,1454427228,219
5698dc4141a9d72100241016,275,ORG3402 Organisasjonsatferd og ledelse,1454496752,2016-02-03 11:52:32,1454497697,945
5698dc4141a9d72100241016,77794,ORG3402 Organisasjonsatferd og ledelse,1454506562,2016-02-03 14:36:02,1454506562,0
5698dc4141a9d72100241016,26895,ORG3402 Organisasjonsatferd og ledelse,1454883487,2016-02-07 23:18:07,1454883740,253
5698dc4141a9d72100241016,5385,ORG3402 Organisasjonsatferd og ledelse,1455033155,2016-02-09 16:52:35,1455033197,42
5698dc4141a9d72100241016,26233,ORG3402 Organisasjonsatferd og ledelse,1455058837,2016-02-10 00:00:37,1455058912,75
5698dc4141a9d72100241016,12911,ORG3402 Organisasjonsatferd og ledelse,1455118993,2016-02-10 16:43:13,1455119499,506
5698dc4141a9d72100241017,91802,ORG3402 Organisasjonsatferd og ledelse,1454800290,2016-02-07 00:11:30,1454800442,152
5698dc4141a9d72100241017,97822,ORG3402 Organisasjonsatferd og ledelse,1455096437,2016-02-10 10:27:17,1455096437,0
5698dc4141a9d72100241017,67251,ORG3402 Organisasjonsatferd og ledelse,1455098067,2016-02-10 10:54:27,1455098452,385
5698dc4141a9d72100241017,25839,ORG3402 Organisasjonsatferd og ledelse,1455323484,2016-02-13 01:31:24,1455323608,124
5698dc4141a9d72100241017,46939,ORG3402 Organisasjonsatferd og ledelse,1455325554,2016-02-13 02:05:54,1455327673,2119
5698dc422fb0de2600f231d6,11687,ORG3402 Organisasjonsatferd og ledelse,1454066585,2016-01-29 12:23:05,1454066657,72
5698dc422fb0de2600f231d8,10398,ORG3402 Organisasjonsatferd og ledelse,1453058669,2016-01-17 20:24:29,1453059205,536
5698dc4241a9d72100241018,90702,ORG3402 Organisasjonsatferd og ledelse,1453299244,2016-01-20 15:14:04,1453299934,690
5698dc4241a9d72100241018,36364,ORG3402 Organisasjonsatferd og ledelse,1454498916,2016-02-03 12:28:36,1454498964,48
5698dc4241a9d72100241018,17403,ORG3402 Organisasjonsatferd og ledelse,1454504974,2016-02-03 14:09:34,1454505124,150
5698dc4241a9d72100241018,63251,ORG3402 Organisasjonsatferd og ledelse,1455102197,2016-02-10 12:03:17,1455102776,579
5698dc4241a9d72100241018,63302,ORG3402 Organisasjonsatferd og ledelse,1455104419,2016-02-10 12:40:19,1455104423,4
5698dc4241a9d72100241018,47833,ORG3402 Organisasjonsatferd og ledelse,1455105892,2016-02-10 13:04:52,1455105962,70
5698dc4241a9d7210024101b,61972,ORG3402 Organisasjonsatferd og ledelse,1453903526,2016-01-27 15:05:26,1453903540,14
5698dc4241a9d7210024101b,9777,ORG3402 Organisasjonsatferd og ledelse,1454121945,2016-01-30 03:45:45,1454121945,0
5698dc4241a9d7210024101b,4917,ORG3402 Organisasjonsatferd og ledelse,1454455937,2016-02-03 00:32:17,1454456134,197
5698dc4241a9d7210024101b,57371,ORG3402 Organisasjonsatferd og ledelse,1455198712,2016-02-11 14:51:52,1455198712,0
5698dc4241a9d7210024101b,4912,ORG3402 Organisasjonsatferd og ledelse,1455471737,2016-02-14 18:42:17,1455472179,442
5698dc4341a9d72100241038,10888,ORG3402 Organisasjonsatferd og ledelse,1453203818,2016-01-19 12:43:38,1453203869,51
5698dc4341a9d72100241039,20690,ORG3402 Organisasjonsatferd og ledelse,1452870093,2016-01-15 16:01:33,1452870297,204
5698dc4341a9d72100241039,2593,ORG3402 Organisasjonsatferd og ledelse,1452891444,2016-01-15 21:57:24,1452891509,65
5698dc4341a9d72100241039,84358,ORG3402 Organisasjonsatferd og ledelse,1452952467,2016-01-16 14:54:27,1452952467,0
5698dc4341a9d72100241039,7343,ORG3402 Organisasjonsatferd og ledelse,1453120467,2016-01-18 13:34:27,1453121039,572
5698dc4341a9d72100241039,76161,ORG3402 Organisasjonsatferd og ledelse,1453128062,2016-01-18 15:41:02,1453128143,81
5698dc4341a9d72100241039,88240,ORG3402 Organisasjonsatferd og ledelse,1453144396,2016-01-18 20:13:16,1453144463,67
5698dc4341a9d72100241039,46883,ORG3402 Organisasjonsatferd og ledelse,1453222882,2016-01-19 18:01:22,1453222882,0
5698dc4341a9d72100241039,56447,ORG3402 Organisasjonsatferd og ledelse,1453388086,2016-01-21 15:54:46,1453388086,0
5698dc4341a9d72100241039,4042,ORG3402 Organisasjonsatferd og ledelse,1453557401,2016-01-23 14:56:41,1453557423,22
5698dc4341a9d72100241039,30606,ORG3402 Organisasjonsatferd og ledelse,1453591296,2016-01-24 00:21:36,1453591296,0
5698dc4341a9d72100241039,19393,ORG3402 Organisasjonsatferd og ledelse,1453729833,2016-01-25 14:50:33,1453730160,327
5698dc4341a9d72100241039,91913,ORG3402 Organisasjonsatferd og ledelse,1453831918,2016-01-26 19:11:58,1453831964,46
5698dc4341a9d72100241039,20714,ORG3402 Organisasjonsatferd og ledelse,1453892681,2016-01-27 12:04:41,1453893232,551
5698dc4341a9d72100241039,94630,ORG3402 Organisasjonsatferd og ledelse,1453972460,2016-01-28 10:14:20,1453972460,0
5698dc4341a9d72100241039,83369,ORG3402 Organisasjonsatferd og ledelse,1453980029,2016-01-28 12:20:29,1453980038,9
5698dc4341a9d72100241039,27917,ORG3402 Organisasjonsatferd og ledelse,1453981445,2016-01-28 12:44:05,1453981446,1
5698dc4341a9d72100241039,73931,ORG3402 Organisasjonsatferd og ledelse,1454437899,2016-02-02 19:31:39,1454437979,80
5698dc4341a9d72100241039,23693,ORG3402 Organisasjonsatferd og ledelse,1454490608,2016-02-03 10:10:08,1454490907,299
5698dc4341a9d72100241039,74025,ORG3402 Organisasjonsatferd og ledelse,1454494299,2016-02-03 11:11:39,1454494303,4
5698dc4341a9d72100241039,31980,ORG3402 Organisasjonsatferd og ledelse,1454497124,2016-02-03 11:58:44,1454497130,6
5698dc4341a9d72100241039,40209,ORG3402 Organisasjonsatferd og ledelse,1454580451,2016-02-04 11:07:31,1454580451,0
5698dc4341a9d72100241039,61919,ORG3402 Organisasjonsatferd og ledelse,1454923509,2016-02-08 10:25:09,1454923519,10
5698dc4341a9d72100241039,72453,ORG3402 Organisasjonsatferd og ledelse,1455037694,2016-02-09 18:08:14,1455037694,0
5698dc4341a9d72100241039,32885,ORG3402 Organisasjonsatferd og ledelse,1455103238,2016-02-10 12:20:38,1455103238,0
5698dc442fb0de2600f231ee,981,ORG3402 Organisasjonsatferd og ledelse,1453827293,2016-01-26 17:54:53,1453828027,734
5698dc442fb0de2600f231ee,90543,ORG3402 Organisasjonsatferd og ledelse,1453893019,2016-01-27 12:10:19,1453893599,580
5698dc442fb0de2600f231ef,43622,ORG3402 Organisasjonsatferd og ledelse,1453905117,2016-01-27 15:31:57,1453905473,356
5698dc442fb0de2600f231ef,92724,ORG3402 Organisasjonsatferd og ledelse,1455368077,2016-02-13 13:54:37,1455368083,6
5698dc442fb0de2600f231f0,93596,ORG3402 Organisasjonsatferd og ledelse,1453224524,2016-01-19 18:28:44,1453224580,56
5698dc442fb0de2600f231f0,77516,ORG3402 Organisasjonsatferd og ledelse,1453247730,2016-01-20 00:55:30,1453247806,76
5698dc442fb0de2600f231f0,80262,ORG3402 Organisasjonsatferd og ledelse,1453908367,2016-01-27 16:26:07,1453908440,73
5698dc442fb0de2600f231f1,13885,ORG3402 Organisasjonsatferd og ledelse,1453299716,2016-01-20 15:21:56,1453300682,966
5698dc442fb0de2600f231f1,15935,ORG3402 Organisasjonsatferd og ledelse,1453819480,2016-01-26 15:44:40,1453819537,57
5698dc442fb0de2600f231f1,2028,ORG3402 Organisasjonsatferd og ledelse,1453832640,2016-01-26 19:24:00,1453832644,4
5698dc442fb0de2600f231fa,50557,ORG3402 Organisasjonsatferd og ledelse,1452902302,2016-01-16 00:58:22,1452902666,364
5698dc442fb0de2600f231fa,15410,ORG3402 Organisasjonsatferd og ledelse,1453709880,2016-01-25 09:18:00,1453709895,15
5698dc442fb0de2600f231fa,51897,ORG3402 Organisasjonsatferd og ledelse,1454326931,2016-02-01 12:42:11,1454326972,41
5698dc442fb0de2600f231fa,13977,ORG3402 Organisasjonsatferd og ledelse,1454495723,2016-02-03 11:35:23,1454496699,976
5698dc442fb0de2600f231fc,64995,ORG3402 Organisasjonsatferd og ledelse,1452895619,2016-01-15 23:06:59,1452895670,51
5698dc442fb0de2600f231fc,19652,ORG3402 Organisasjonsatferd og ledelse,1453130069,2016-01-18 16:14:29,1453130177,108
5698dc442fb0de2600f231fc,14515,ORG3402 Organisasjonsatferd og ledelse,1453204986,2016-01-19 13:03:06,1453204988,2
5698dc442fb0de2600f231fc,67979,ORG3402 Organisasjonsatferd og ledelse,1453741368,2016-01-25 18:02:48,1453741383,15
5698dc442fb0de2600f231fc,12746,ORG3402 Organisasjonsatferd og ledelse,1453892630,2016-01-27 12:03:50,1453892630,0
5698dc442fb0de2600f231fc,28287,ORG3402 Organisasjonsatferd og ledelse,1453899131,2016-01-27 13:52:11,1453899132,1
5698dc442fb0de2600f231fc,72411,ORG3402 Organisasjonsatferd og ledelse,1454069492,2016-01-29 13:11:32,1454070230,738
5698dc442fb0de2600f231fc,18493,ORG3402 Organisasjonsatferd og ledelse,1454313835,2016-02-01 09:03:55,1454313836,1
5698dc442fb0de2600f231fc,70109,ORG3402 Organisasjonsatferd og ledelse,1454497059,2016-02-03 11:57:39,1454497060,1
5698dc442fb0de2600f231fc,88868,ORG3402 Organisasjonsatferd og ledelse,1454518327,2016-02-03 17:52:07,1454518327,0
5698dc442fb0de2600f231fc,96205,ORG3402 Organisasjonsatferd og ledelse,1455053960,2016-02-09 22:39:20,1455054019,59
5698dc442fb0de2600f231fc,40689,ORG3402 Organisasjonsatferd og ledelse,1455104940,2016-02-10 12:49:00,1455104943,3
5698dc452fb0de2600f231ff,68091,ORG3402 Organisasjonsatferd og ledelse,1452995725,2016-01-17 02:55:25,1452996155,430
5698dc452fb0de2600f231ff,81015,ORG3402 Organisasjonsatferd og ledelse,1453065890,2016-01-17 22:24:50,1453065903,13
5698dc452fb0de2600f231ff,19781,ORG3402 Organisasjonsatferd og ledelse,1453107950,2016-01-18 10:05:50,1453107953,3
5698dc452fb0de2600f231ff,20441,ORG3402 Organisasjonsatferd og ledelse,1453226086,2016-01-19 18:54:46,1453226087,1
5698dc452fb0de2600f231ff,27349,ORG3402 Organisasjonsatferd og ledelse,1453892726,2016-01-27 12:05:26,1453892968,242
5698dc452fb0de2600f231ff,30977,ORG3402 Organisasjonsatferd og ledelse,1453914039,2016-01-27 18:00:39,1453914039,0
5698dc452fb0de2600f23212,28425,ORG3402 Organisasjonsatferd og ledelse,1452866462,2016-01-15 15:01:02,1452866534,72
5698dc452fb0de2600f23212,45074,ORG3402 Organisasjonsatferd og ledelse,1453072299,2016-01-18 00:11:39,1453072392,93
5698dc452fb0de2600f23212,54905,ORG3402 Organisasjonsatferd og ledelse,1453154984,2016-01-18 23:09:44,1453155088,104
5698dc452fb0de2600f23212,94478,ORG3402 Organisasjonsatferd og ledelse,1453676609,2016-01-25 00:03:29,1453676843,234
5698dc452fb0de2600f23212,42842,ORG3402 Organisasjonsatferd og ledelse,1453728455,2016-01-25 14:27:35,1453728489,34
5698dc452fb0de2600f23212,48007,ORG3402 Organisasjonsatferd og ledelse,1453892639,2016-01-27 12:03:59,1453892642,3
5698dc452fb0de2600f23212,27123,ORG3402 Organisasjonsatferd og ledelse,1453901716,2016-01-27 14:35:16,1453901718,2
5698dc452fb0de2600f23212,63939,ORG3402 Organisasjonsatferd og ledelse,1454433436,2016-02-02 18:17:16,1454433476,40
5698dc452fb0de2600f23212,50632,ORG3402 Organisasjonsatferd og ledelse,1454498661,2016-02-03 12:24:21,1454498673,12
5698dc452fb0de2600f23212,67023,ORG3402 Organisasjonsatferd og ledelse,1454949926,2016-02-08 17:45:26,1454949926,0
5698dc452fb0de2600f23212,14851,ORG3402 Organisasjonsatferd og ledelse,1454957850,2016-02-08 19:57:30,1454957850,0
5698dc452fb0de2600f23212,1799,ORG3402 Organisasjonsatferd og ledelse,1455104372,2016-02-10 12:39:32,1455104467,95
5698dc452fb0de2600f23212,19640,ORG3402 Organisasjonsatferd og ledelse,1455138718,2016-02-10 22:11:58,1455138718,0
5698dc4541a9d7210024103f,79496,ORG3402 Organisasjonsatferd og ledelse,1455186157,2016-02-11 11:22:37,1455186234,77
5698dc4541a9d72100241040,45721,ORG3402 Organisasjonsatferd og ledelse,1453310080,2016-01-20 18:14:40,1453311514,1434
5698dc4541a9d72100241040,55097,ORG3402 Organisasjonsatferd og ledelse,1454525164,2016-02-03 19:46:04,1454525221,57
5698dc4541a9d72100241041,39248,ORG3402 Organisasjonsatferd og ledelse,1452954190,2016-01-16 15:23:10,1452954289,99
5698dc4541a9d72100241041,58712,ORG3402 Organisasjonsatferd og ledelse,1453291468,2016-01-20 13:04:28,1453291660,192
5698dc4541a9d72100241041,39991,ORG3402 Organisasjonsatferd og ledelse,1453808259,2016-01-26 12:37:39,1453808277,18
5698dc4541a9d72100241041,99156,ORG3402 Organisasjonsatferd og ledelse,1453815974,2016-01-26 14:46:14,1453815993,19
5698dc4541a9d72100241041,93457,ORG3402 Organisasjonsatferd og ledelse,1454018614,2016-01-28 23:03:34,1454018657,43
5698dc4541a9d72100241041,74004,ORG3402 Organisasjonsatferd og ledelse,1454857078,2016-02-07 15:57:58,1454857343,265
5698dc4541a9d72100241041,86791,ORG3402 Organisasjonsatferd og ledelse,1455187487,2016-02-11 11:44:47,1455187487,0
5698dc4541a9d72100241043,61275,ORG3402 Organisasjonsatferd og ledelse,1453055583,2016-01-17 19:33:03,1453057709,2126
5698dc4541a9d72100241043,15665,ORG3402 Organisasjonsatferd og ledelse,1453060876,2016-01-17 21:01:16,1453060893,17
5698dc4541a9d72100241043,34808,ORG3402 Organisasjonsatferd og ledelse,1453127213,2016-01-18 15:26:53,1453127385,172
5698dc4541a9d72100241043,18723,ORG3402 Organisasjonsatferd og ledelse,1454015285,2016-01-28 22:08:05,1454015335,50
5698dc4541a9d72100241043,94224,ORG3402 Organisasjonsatferd og ledelse,1454249135,2016-01-31 15:05:35,1454249169,34
5698dc4541a9d72100241043,19217,ORG3402 Organisasjonsatferd og ledelse,1454438246,2016-02-02 19:37:26,1454438254,8
5698dc462fb0de2600f23215,72355,ORG3402 Organisasjonsatferd og ledelse,1453141896,2016-01-18 19:31:36,1453141896,0
5698dc462fb0de2600f23215,47386,ORG3402 Organisasjonsatferd og ledelse,1453144474,2016-01-18 20:14:34,1453145062,588
5698dc462fb0de2600f23215,74152,ORG3402 Organisasjonsatferd og ledelse,1453838542,2016-01-26 21:02:22,1453839107,565
5698dc462fb0de2600f23215,68034,ORG3402 Organisasjonsatferd og ledelse,1453892551,2016-01-27 12:02:31,1453893176,625
5698dc462fb0de2600f23215,21761,ORG3402 Organisasjonsatferd og ledelse,1453900396,2016-01-27 14:13:16,1453900556,160
5698dc462fb0de2600f23215,800,ORG3402 Organisasjonsatferd og ledelse,1454441930,2016-02-02 20:38:50,1454442305,375
5698dc462fb0de2600f23215,82903,ORG3402 Organisasjonsatferd og ledelse,1454500617,2016-02-03 12:56:57,1454500617,0
5698dc462fb0de2600f23215,61772,ORG3402 Organisasjonsatferd og ledelse,1455039186,2016-02-09 18:33:06,1455039186,0
5698dc462fb0de2600f23215,32975,ORG3402 Organisasjonsatferd og ledelse,1455488094,2016-02-14 23:14:54,1455488094,0
5698dc4641a9d72100241060,45644,ORG3402 Organisasjonsatferd og ledelse,1453892928,2016-01-27 12:08:48,1453893280,352
5698dc4641a9d72100241060,7043,ORG3402 Organisasjonsatferd og ledelse,1454427916,2016-02-02 16:45:16,1454427944,28
5698dc4641a9d72100241060,23938,ORG3402 Organisasjonsatferd og ledelse,1454543813,2016-02-04 00:56:53,1454543814,1
5698dc4641a9d72100241060,62723,ORG3402 Organisasjonsatferd og ledelse,1455103746,2016-02-10 12:29:06,1455104533,787
5698dc4641a9d72100241060,87773,ORG3402 Organisasjonsatferd og ledelse,1455111488,2016-02-10 14:38:08,1455111489,1
5698dc4641a9d72100241061,58605,ORG3402 Organisasjonsatferd og ledelse,1454676112,2016-02-05 13:41:52,1454676112,0
5698dc4641a9d72100241061,95930,ORG3402 Organisasjonsatferd og ledelse,1455191952,2016-02-11 12:59:12,1455191957,5
5698dc472fb0de2600f23219,40455,ORG3402 Organisasjonsatferd og ledelse,1452895124,2016-01-15 22:58:44,1452895592,468
5698dc472fb0de2600f23219,67069,ORG3402 Organisasjonsatferd og ledelse,1453407021,2016-01-21 21:10:21,1453407225,204
5698dc472fb0de2600f23219,16906,ORG3402 Organisasjonsatferd og ledelse,1453985523,2016-01-28 13:52:03,1453985951,428
5698dc472fb0de2600f23219,30964,ORG3402 Organisasjonsatferd og ledelse,1454366524,2016-02-01 23:42:04,1454367634,1110
5698dc472fb0de2600f2321b,42969,ORG3402 Organisasjonsatferd og ledelse,1454493247,2016-02-03 10:54:07,1454493568,321
5698dc472fb0de2600f2321b,31383,ORG3402 Organisasjonsatferd og ledelse,1454959273,2016-02-08 20:21:13,1454959882,609
5698dc472fb0de2600f2321c,34675,ORG3402 Organisasjonsatferd og ledelse,1454432890,2016-02-02 18:08:10,1454433042,152
5698dc472fb0de2600f2321c,91255,ORG3402 Organisasjonsatferd og ledelse,1454491956,2016-02-03 10:32:36,1454492712,756
5698dc472fb0de2600f2321c,17081,ORG3402 Organisasjonsatferd og ledelse,1455210767,2016-02-11 18:12:47,1455211373,606
5698dc4741a9d72100241064,74580,ORG3402 Organisasjonsatferd og ledelse,1453901915,2016-01-27 14:38:35,1453901916,1
5698dc4741a9d72100241064,90901,ORG3402 Organisasjonsatferd og ledelse,1454425936,2016-02-02 16:12:16,1454427043,1107
5698dc4741a9d72100241064,67855,ORG3402 Organisasjonsatferd og ledelse,1455102384,2016-02-10 12:06:24,1455102386,2
5698dc4741a9d72100241064,75442,ORG3402 Organisasjonsatferd og ledelse,1455104341,2016-02-10 12:39:01,1455104413,72
5698dc4741a9d72100241065,33042,ORG3402 Organisasjonsatferd og ledelse,1452950403,2016-01-16 14:20:03,1452950497,94
5698dc4741a9d72100241067,98559,ORG3402 Organisasjonsatferd og ledelse,1453921087,2016-01-27 19:58:07,1453921412,325
5698dc4741a9d72100241067,97015,ORG3402 Organisasjonsatferd og ledelse,1454511667,2016-02-03 16:01:07,1454512510,843
5698dc4741a9d72100241068,21702,ORG3402 Organisasjonsatferd og ledelse,1453067619,2016-01-17 22:53:39,1453067979,360
5698dc4741a9d72100241068,50859,ORG3402 Organisasjonsatferd og ledelse,1453073405,2016-01-18 00:30:05,1453073528,123
5698dc4741a9d72100241068,42679,ORG3402 Organisasjonsatferd og ledelse,1454933228,2016-02-08 13:07:08,1454933249,21
5698dc4741a9d72100241068,21923,ORG3402 Organisasjonsatferd og ledelse,1454947291,2016-02-08 17:01:31,1454947291,0
5698dc482fb0de2600f2321e,67965,ORG3402 Organisasjonsatferd og ledelse,1453892893,2016-01-27 12:08:13,1453893314,421
5698dc482fb0de2600f2321e,20343,ORG3402 Organisasjonsatferd og ledelse,1453936464,2016-01-28 00:14:24,1453936464,0
5698dc482fb0de2600f2321e,20123,ORG3402 Organisasjonsatferd og ledelse,1454497528,2016-02-03 12:05:28,1454497528,0
5698dc482fb0de2600f2321e,46381,ORG3402 Organisasjonsatferd og ledelse,1454498867,2016-02-03 12:27:47,1454498906,39
5698dc482fb0de2600f2321e,87568,ORG3402 Organisasjonsatferd og ledelse,1454501574,2016-02-03 13:12:54,1454501574,0
5698dc482fb0de2600f2321e,49560,ORG3402 Organisasjonsatferd og ledelse,1454504902,2016-02-03 14:08:22,1454505118,216
5698dc482fb0de2600f2321e,83525,ORG3402 Organisasjonsatferd og ledelse,1455103050,2016-02-10 12:17:30,1455104477,1427
5698dc482fb0de2600f2321f,9893,ORG3402 Organisasjonsatferd og ledelse,1453033773,2016-01-17 13:29:33,1453035035,1262
5698dc482fb0de2600f2321f,25005,ORG3402 Organisasjonsatferd og ledelse,1453378896,2016-01-21 13:21:36,1453378965,69
5698dc482fb0de2600f2321f,64180,ORG3402 Organisasjonsatferd og ledelse,1453855656,2016-01-27 01:47:36,1453855857,201
5698dc482fb0de2600f2321f,21233,ORG3402 Organisasjonsatferd og ledelse,1454355694,2016-02-01 20:41:34,1454355694,0
5698dc482fb0de2600f23220,20058,ORG3402 Organisasjonsatferd og ledelse,1453892815,2016-01-27 12:06:55,1453893092,277
5698dc482fb0de2600f23220,61453,ORG3402 Organisasjonsatferd og ledelse,1453907732,2016-01-27 16:15:32,1453908046,314
5698dc482fb0de2600f23220,83124,ORG3402 Organisasjonsatferd og ledelse,1454098691,2016-01-29 21:18:11,1454098691,0
5698dc482fb0de2600f23220,24219,ORG3402 Organisasjonsatferd og ledelse,1454286395,2016-02-01 01:26:35,1454286395,0
5698dc482fb0de2600f23220,21562,ORG3402 Organisasjonsatferd og ledelse,1454688212,2016-02-05 17:03:32,1454688281,69
5698dc482fb0de2600f23231,12059,ORG3402 Organisasjonsatferd og ledelse,1453233537,2016-01-19 20:58:57,1453233593,56
5698dc482fb0de2600f23231,33148,ORG3402 Organisasjonsatferd og ledelse,1453292049,2016-01-20 13:14:09,1453292156,107
5698dc482fb0de2600f23231,58691,ORG3402 Organisasjonsatferd og ledelse,1453892788,2016-01-27 12:06:28,1453892996,208
5698dc482fb0de2600f23231,33570,ORG3402 Organisasjonsatferd og ledelse,1455046525,2016-02-09 20:35:25,1455046601,76
5698dc4841a9d72100241069,18198,ORG3402 Organisasjonsatferd og ledelse,1454065469,2016-01-29 12:04:29,1454066093,624
5698dc4841a9d72100241069,46373,ORG3402 Organisasjonsatferd og ledelse,1454073950,2016-01-29 14:25:50,1454073957,7
5698dc4841a9d7210024106a,74799,ORG3402 Organisasjonsatferd og ledelse,1453985616,2016-01-28 13:53:36,1453986404,788
5698dc4841a9d7210024106a,93215,ORG3402 Organisasjonsatferd og ledelse,1454373833,2016-02-02 01:43:53,1454373837,4
5698dc4841a9d7210024106b,97247,ORG3402 Organisasjonsatferd og ledelse,1454616803,2016-02-04 21:13:23,1454617136,333
5698dc4841a9d7210024106b,24941,ORG3402 Organisasjonsatferd og ledelse,1454618523,2016-02-04 21:42:03,1454618523,0
5698dc492fb0de2600f2323e,79349,ORG3402 Organisasjonsatferd og ledelse,1453673184,2016-01-24 23:06:24,1453673184,0
5698dc492fb0de2600f2323e,67517,ORG3402 Organisasjonsatferd og ledelse,1454443514,2016-02-02 21:05:14,1454443514,0
5698dc492fb0de2600f2323e,35468,ORG3402 Organisasjonsatferd og ledelse,1454497462,2016-02-03 12:04:22,1454497462,0
5698dc492fb0de2600f2323e,34605,ORG3402 Organisasjonsatferd og ledelse,1454506643,2016-02-03 14:37:23,1454506647,4
5698dc492fb0de2600f2323e,97337,ORG3402 Organisasjonsatferd og ledelse,1455110870,2016-02-10 14:27:50,1455110893,23
5698dc492fb0de2600f2323e,71043,ORG3402 Organisasjonsatferd og ledelse,1455183959,2016-02-11 10:45:59,1455183975,16
5698dc492fb0de2600f23240,28627,ORG3402 Organisasjonsatferd og ledelse,1452862614,2016-01-15 13:56:54,1452862664,50
5698dc492fb0de2600f23240,8092,ORG3402 Organisasjonsatferd og ledelse,1452875958,2016-01-15 17:39:18,1452876166,208
5698dc492fb0de2600f23240,22738,ORG3402 Organisasjonsatferd og ledelse,1452975859,2016-01-16 21:24:19,1452976282,423
5698dc492fb0de2600f23240,13281,ORG3402 Organisasjonsatferd og ledelse,1453052753,2016-01-17 18:45:53,1453052886,133
5698dc492fb0de2600f23240,383,ORG3402 Organisasjonsatferd og ledelse,1453149276,2016-01-18 21:34:36,1453149302,26
5698dc492fb0de2600f23240,26078,ORG3402 Organisasjonsatferd og ledelse,1453375637,2016-01-21 12:27:17,1453377709,2072
5698dc492fb0de2600f23240,96865,ORG3402 Organisasjonsatferd og ledelse,1453575642,2016-01-23 20:00:42,1453575647,5
5698dc492fb0de2600f23240,60868,ORG3402 Organisasjonsatferd og ledelse,1453675005,2016-01-24 23:36:45,1453675157,152
5698dc492fb0de2600f23240,38749,ORG3402 Organisasjonsatferd og ledelse,1453827306,2016-01-26 17:55:06,1453827385,79
5698dc492fb0de2600f23240,23776,ORG3402 Organisasjonsatferd og ledelse,1453924352,2016-01-27 20:52:32,1453924697,345
5698dc492fb0de2600f23240,82657,ORG3402 Organisasjonsatferd og ledelse,1454098423,2016-01-29 21:13:43,1454098594,171
5698dc492fb0de2600f23240,28739,ORG3402 Organisasjonsatferd og ledelse,1454331693,2016-02-01 14:01:33,1454331694,1
5698dc492fb0de2600f23240,35660,ORG3402 Organisasjonsatferd og ledelse,1454598386,2016-02-04 16:06:26,1454598483,97
5698dc492fb0de2600f23240,34,ORG3402 Organisasjonsatferd og ledelse,1454600003,2016-02-04 16:33:23,1454600018,15
5698dc492fb0de2600f23240,63772,ORG3402 Organisasjonsatferd og ledelse,1454879197,2016-02-07 22:06:37,1454879207,10
5698dc492fb0de2600f23240,58916,ORG3402 Organisasjonsatferd og ledelse,1454965754,2016-02-08 22:09:14,1454965925,171
5698dc492fb0de2600f23240,51225,ORG3402 Organisasjonsatferd og ledelse,1454976690,2016-02-09 01:11:30,1454976737,47
5698dc492fb0de2600f23240,57372,ORG3402 Organisasjonsatferd og ledelse,1455109485,2016-02-10 14:04:45,1455109529,44
5698dc492fb0de2600f23240,95293,ORG3402 Organisasjonsatferd og ledelse,1455121065,2016-02-10 17:17:45,1455121065,0
5698dc492fb0de2600f23241,14107,ORG3402 Organisasjonsatferd og ledelse,1453280433,2016-01-20 10:00:33,1453280604,171
5698dc492fb0de2600f23241,73117,ORG3402 Organisasjonsatferd og ledelse,1453288387,2016-01-20 12:13:07,1453288390,3
5698dc492fb0de2600f23241,9220,ORG3402 Organisasjonsatferd og ledelse,1453544407,2016-01-23 11:20:07,1453544433,26
5698dc492fb0de2600f23241,99866,ORG3402 Organisasjonsatferd og ledelse,1455100717,2016-02-10 11:38:37,1455100770,53
5698dc492fb0de2600f23242,89618,ORG3402 Organisasjonsatferd og ledelse,1453028399,2016-01-17 11:59:59,1453028485,86
5698dc492fb0de2600f23242,15388,ORG3402 Organisasjonsatferd og ledelse,1453054561,2016-01-17 19:16:01,1453054617,56
5698dc492fb0de2600f23242,17996,ORG3402 Organisasjonsatferd og ledelse,1453060320,2016-01-17 20:52:00,1453060321,1
5698dc492fb0de2600f23242,94722,ORG3402 Organisasjonsatferd og ledelse,1453065017,2016-01-17 22:10:17,1453065033,16
5698dc492fb0de2600f23242,58970,ORG3402 Organisasjonsatferd og ledelse,1453190239,2016-01-19 08:57:19,1453190683,444
5698dc492fb0de2600f23242,27501,ORG3402 Organisasjonsatferd og ledelse,1453196749,2016-01-19 10:45:49,1453196821,72
5698dc492fb0de2600f23242,31614,ORG3402 Organisasjonsatferd og ledelse,1453668640,2016-01-24 21:50:40,1453668671,31
5698dc492fb0de2600f23242,63836,ORG3402 Organisasjonsatferd og ledelse,1455318457,2016-02-13 00:07:37,1455318459,2
5698dc492fb0de2600f23242,35531,ORG3402 Organisasjonsatferd og ledelse,1455398860,2016-02-13 22:27:40,1455398860,0
5698dc4941a9d72100241088,6227,ORG3402 Organisasjonsatferd og ledelse,1453197622,2016-01-19 11:00:22,1453197661,39
5698dc4941a9d7210024108a,77903,ORG3402 Organisasjonsatferd og ledelse,1452863598,2016-01-15 14:13:18,1452864336,738
5698dc4941a9d7210024108a,47282,ORG3402 Organisasjonsatferd og ledelse,1452869333,2016-01-15 15:48:53,1452869415,82
5698dc4941a9d7210024108a,50565,ORG3402 Organisasjonsatferd og ledelse,1453068111,2016-01-17 23:01:51,1453068537,426
5698dc4941a9d7210024108a,48185,ORG3402 Organisasjonsatferd og ledelse,1453109199,2016-01-18 10:26:39,1453109293,94
5698dc4941a9d7210024108a,37684,ORG3402 Organisasjonsatferd og ledelse,1453131436,2016-01-18 16:37:16,1453131490,54
5698dc4941a9d7210024108a,35205,ORG3402 Organisasjonsatferd og ledelse,1453151924,2016-01-18 22:18:44,1453151924,0
5698dc4941a9d7210024108a,49478,ORG3402 Organisasjonsatferd og ledelse,1453288529,2016-01-20 12:15:29,1453288620,91
5698dc4941a9d7210024108a,18048,ORG3402 Organisasjonsatferd og ledelse,1453710584,2016-01-25 09:29:44,1453710591,7
5698dc4941a9d7210024108a,84174,ORG3402 Organisasjonsatferd og ledelse,1453817406,2016-01-26 15:10:06,1453818467,1061
5698dc4941a9d7210024108a,25755,ORG3402 Organisasjonsatferd og ledelse,1453884764,2016-01-27 09:52:44,1453884792,28
5698dc4941a9d7210024108a,22523,ORG3402 Organisasjonsatferd og ledelse,1453889032,2016-01-27 11:03:52,1453889152,120
5698dc4941a9d7210024108a,73374,ORG3402 Organisasjonsatferd og ledelse,1453927194,2016-01-27 21:39:54,1453927194,0
5698dc4941a9d7210024108a,77963,ORG3402 Organisasjonsatferd og ledelse,1453930291,2016-01-27 22:31:31,1453930291,0
5698dc4941a9d7210024108a,36503,ORG3402 Organisasjonsatferd og ledelse,1454102478,2016-01-29 22:21:18,1454102494,16
5698dc4941a9d7210024108a,83809,ORG3402 Organisasjonsatferd og ledelse,1454170944,2016-01-30 17:22:24,1454170979,35
5698dc4941a9d7210024108a,93904,ORG3402 Organisasjonsatferd og ledelse,1454341986,2016-02-01 16:53:06,1454342222,236
5698dc4941a9d7210024108a,15479,ORG3402 Organisasjonsatferd og ledelse,1454361998,2016-02-01 22:26:38,1454361999,1
5698dc4941a9d7210024108a,68387,ORG3402 Organisasjonsatferd og ledelse,1454404988,2016-02-02 10:23:08,1454405443,455
5698dc4941a9d7210024108a,82757,ORG3402 Organisasjonsatferd og ledelse,1454436194,2016-02-02 19:03:14,1454436203,9
5698dc4941a9d7210024108a,74096,ORG3402 Organisasjonsatferd og ledelse,1454488234,2016-02-03 09:30:34,1454488276,42
5698dc4941a9d7210024108a,6832,ORG3402 Organisasjonsatferd og ledelse,1454535503,2016-02-03 22:38:23,1454535503,0
5698dc4941a9d7210024108a,13462,ORG3402 Organisasjonsatferd og ledelse,1454537988,2016-02-03 23:19:48,1454538208,220
5698dc4941a9d7210024108a,98588,ORG3402 Organisasjonsatferd og ledelse,1454618940,2016-02-04 21:49:00,1454618947,7
5698dc4941a9d7210024108a,53982,ORG3402 Organisasjonsatferd og ledelse,1454690945,2016-02-05 17:49:05,1454690986,41
5698dc4941a9d7210024108a,39750,ORG3402 Organisasjonsatferd og ledelse,1454948837,2016-02-08 17:27:17,1454948837,0
5698dc4941a9d7210024108a,36983,ORG3402 Organisasjonsatferd og ledelse,1455008930,2016-02-09 10:08:50,1455008990,60
5698dc4941a9d7210024108a,1982,ORG3402 Organisasjonsatferd og ledelse,1455010854,2016-02-09 10:40:54,1455010914,60
5698dc4941a9d7210024108a,52749,ORG3402 Organisasjonsatferd og ledelse,1455027196,2016-02-09 15:13:16,1455027618,422
5698dc4941a9d7210024108a,8323,ORG3402 Organisasjonsatferd og ledelse,1455031423,2016-02-09 16:23:43,1455031489,66
5698dc4941a9d7210024108a,26296,ORG3402 Organisasjonsatferd og ledelse,1455056520,2016-02-09 23:22:00,1455056520,0
5698dc4941a9d7210024108a,45726,ORG3402 Organisasjonsatferd og ledelse,1455369626,2016-02-13 14:20:26,1455369626,0
5698dc4941a9d7210024108b,10116,ORG3402 Organisasjonsatferd og ledelse,1454338373,2016-02-01 15:52:53,1454338512,139
5698dc4941a9d7210024108b,77473,ORG3402 Organisasjonsatferd og ledelse,1455109509,2016-02-10 14:05:09,1455109524,15
5698dc4a2fb0de2600f23243,65668,ORG3402 Organisasjonsatferd og ledelse,1453124088,2016-01-18 14:34:48,1453124464,376
5698dc4a2fb0de2600f23243,39240,ORG3402 Organisasjonsatferd og ledelse,1453303822,2016-01-20 16:30:22,1453304231,409
5698dc4a2fb0de2600f23243,7635,ORG3402 Organisasjonsatferd og ledelse,1453305604,2016-01-20 17:00:04,1453305773,169
5698dc4a2fb0de2600f23243,51591,ORG3402 Organisasjonsatferd og ledelse,1453732228,2016-01-25 15:30:28,1453732915,687
5698dc4a2fb0de2600f23243,43911,ORG3402 Organisasjonsatferd og ledelse,1453746104,2016-01-25 19:21:44,1453746107,3
5698dc4a2fb0de2600f23243,31091,ORG3402 Organisasjonsatferd og ledelse,1453893019,2016-01-27 12:10:19,1453893104,85
5698dc4a2fb0de2600f23243,42661,ORG3402 Organisasjonsatferd og ledelse,1454073401,2016-01-29 14:16:41,1454073494,93
5698dc4a2fb0de2600f23243,52247,ORG3402 Organisasjonsatferd og ledelse,1454331659,2016-02-01 14:00:59,1454331675,16
5698dc4a2fb0de2600f23243,34980,ORG3402 Organisasjonsatferd og ledelse,1454528491,2016-02-03 20:41:31,1454528733,242
5698dc4a2fb0de2600f23243,27693,ORG3402 Organisasjonsatferd og ledelse,1454590233,2016-02-04 13:50:33,1454590270,37
5698dc4a2fb0de2600f23243,60098,ORG3402 Organisasjonsatferd og ledelse,1454854245,2016-02-07 15:10:45,1454854268,23
5698dc4a2fb0de2600f23243,9523,ORG3402 Organisasjonsatferd og ledelse,1454931106,2016-02-08 12:31:46,1454931116,10
5698dc4a2fb0de2600f23243,85839,ORG3402 Organisasjonsatferd og ledelse,1455104370,2016-02-10 12:39:30,1455104496,126
5698dc4a2fb0de2600f23243,83303,ORG3402 Organisasjonsatferd og ledelse,1455109255,2016-02-10 14:00:55,1455109256,1
5698dc4a2fb0de2600f23243,87334,ORG3402 Organisasjonsatferd og ledelse,1455116326,2016-02-10 15:58:46,1455116338,12
5698dc4a2fb0de2600f23244,80531,ORG3402 Organisasjonsatferd og ledelse,1454423335,2016-02-02 15:28:55,1454423431,96
5698dc4a2fb0de2600f23246,51249,ORG3402 Organisasjonsatferd og ledelse,1453051452,2016-01-17 18:24:12,1453051579,127
5698dc4a2fb0de2600f23246,58918,ORG3402 Organisasjonsatferd og ledelse,1453216205,2016-01-19 16:10:05,1453216271,66
5698dc4a2fb0de2600f23246,72052,ORG3402 Organisasjonsatferd og ledelse,1453296049,2016-01-20 14:20:49,1453296095,46
5698dc4a2fb0de2600f23246,74975,ORG3402 Organisasjonsatferd og ledelse,1453388988,2016-01-21 16:09:48,1453388997,9
5698dc4a2fb0de2600f23246,19427,ORG3402 Organisasjonsatferd og ledelse,1453472576,2016-01-22 15:22:56,1453472585,9
5698dc4a2fb0de2600f23246,2567,ORG3402 Organisasjonsatferd og ledelse,1453662917,2016-01-24 20:15:17,1453662917,0
5698dc4a2fb0de2600f23246,97826,ORG3402 Organisasjonsatferd og ledelse,1453990303,2016-01-28 15:11:43,1453990339,36
5698dc4a2fb0de2600f23246,42247,ORG3402 Organisasjonsatferd og ledelse,1454970565,2016-02-08 23:29:25,1454970576,11
5698dc4a41a9d7210024108d,82337,ORG3402 Organisasjonsatferd og ledelse,1452876271,2016-01-15 17:44:31,1452876514,243
5698dc4a41a9d7210024108f,1116,ORG3402 Organisasjonsatferd og ledelse,1452862682,2016-01-15 13:58:02,1452862802,120
5698dc4a41a9d7210024108f,42855,ORG3402 Organisasjonsatferd og ledelse,1453060345,2016-01-17 20:52:25,1453060382,37
5698dc4a41a9d7210024108f,47717,ORG3402 Organisasjonsatferd og ledelse,1453062016,2016-01-17 21:20:16,1453062025,9
5698dc4a41a9d7210024108f,70561,ORG3402 Organisasjonsatferd og ledelse,1453674843,2016-01-24 23:34:03,1453674867,24
5698dc4a41a9d7210024108f,44166,ORG3402 Organisasjonsatferd og ledelse,1454516195,2016-02-03 17:16:35,1454516196,1
5698dc4a41a9d7210024108f,99604,ORG3402 Organisasjonsatferd og ledelse,1454518906,2016-02-03 18:01:46,1454518914,8
5698dc4a41a9d7210024108f,39829,ORG3402 Organisasjonsatferd og ledelse,1454850138,2016-02-07 14:02:18,1454850138,0
5698dc4a41a9d7210024108f,59912,ORG3402 Organisasjonsatferd og ledelse,1454852676,2016-02-07 14:44:36,1454852792,116
5698dc4a41a9d7210024108f,79679,ORG3402 Organisasjonsatferd og ledelse,1455037791,2016-02-09 18:09:51,1455037791,0
5698dc4b2fb0de2600f2324c,51245,ORG3402 Organisasjonsatferd og ledelse,1453320052,2016-01-20 21:00:52,1453320156,104
5698dc4b2fb0de2600f2324c,87295,ORG3402 Organisasjonsatferd og ledelse,1454847569,2016-02-07 13:19:29,1454847580,11
5698dc4b41a9d72100241094,2996,ORG3402 Organisasjonsatferd og ledelse,1452909689,2016-01-16 03:01:29,1452909870,181
5698dc4b41a9d72100241094,62712,ORG3402 Organisasjonsatferd og ledelse,1453060333,2016-01-17 20:52:13,1453060737,404
5698dc4b41a9d72100241094,33959,ORG3402 Organisasjonsatferd og ledelse,1453062094,2016-01-17 21:21:34,1453062149,55
5698dc4b41a9d72100241094,14102,ORG3402 Organisasjonsatferd og ledelse,1453668688,2016-01-24 21:51:28,1453668694,6
5698dc4b41a9d72100241094,22896,ORG3402 Organisasjonsatferd og ledelse,1453677875,2016-01-25 00:24:35,1453677905,30
5698dc4b41a9d72100241094,15987,ORG3402 Organisasjonsatferd og ledelse,1453893928,2016-01-27 12:25:28,1453893949,21
5698dc4b41a9d72100241094,35416,ORG3402 Organisasjonsatferd og ledelse,1453900505,2016-01-27 14:15:05,1453900506,1
5698dc4b41a9d72100241094,40800,ORG3402 Organisasjonsatferd og ledelse,1454592502,2016-02-04 14:28:22,1454593294,792
5698dc4b41a9d72100241094,65783,ORG3402 Organisasjonsatferd og ledelse,1454683898,2016-02-05 15:51:38,1454683940,42
5698dc4b41a9d72100241094,90793,ORG3402 Organisasjonsatferd og ledelse,1455047918,2016-02-09 20:58:38,1455048034,116
5698dc4c2fb0de2600f23268,33236,ORG3402 Organisasjonsatferd og ledelse,1452923175,2016-01-16 06:46:15,1452923175,0
5698dc4c2fb0de2600f23268,65121,ORG3402 Organisasjonsatferd og ledelse,1453539010,2016-01-23 09:50:10,1453539804,794
5698dc4c2fb0de2600f23268,40620,ORG3402 Organisasjonsatferd og ledelse,1453925113,2016-01-27 21:05:13,1453925171,58
5698dc4c2fb0de2600f23268,15023,ORG3402 Organisasjonsatferd og ledelse,1453991367,2016-01-28 15:29:27,1453991593,226
5698dc4c2fb0de2600f23268,66554,ORG3402 Organisasjonsatferd og ledelse,1454613373,2016-02-04 20:16:13,1454613419,46
5698dc4c41a9d721002410b0,35839,ORG3402 Organisasjonsatferd og ledelse,1452863094,2016-01-15 14:04:54,1452863284,190
5698dc4c41a9d721002410b0,72914,ORG3402 Organisasjonsatferd og ledelse,1452896694,2016-01-15 23:24:54,1452896796,102
5698dc4c41a9d721002410b0,73941,ORG3402 Organisasjonsatferd og ledelse,1452911379,2016-01-16 03:29:39,1452911394,15
5698dc4c41a9d721002410b0,29233,ORG3402 Organisasjonsatferd og ledelse,1453063104,2016-01-17 21:38:24,1453063274,170
5698dc4c41a9d721002410b0,10356,ORG3402 Organisasjonsatferd og ledelse,1453211812,2016-01-19 14:56:52,1453211970,158
5698dc4c41a9d721002410b0,85547,ORG3402 Organisasjonsatferd og ledelse,1453840545,2016-01-26 21:35:45,1453840670,125
5698dc4c41a9d721002410b0,36145,ORG3402 Organisasjonsatferd og ledelse,1453843477,2016-01-26 22:24:37,1453844882,1405
5698dc4c41a9d721002410b0,91826,ORG3402 Organisasjonsatferd og ledelse,1453914625,2016-01-27 18:10:25,1453914625,0
5698dc4c41a9d721002410b0,69601,ORG3402 Organisasjonsatferd og ledelse,1453918950,2016-01-27 19:22:30,1453918995,45
5698dc4c41a9d721002410b0,56640,ORG3402 Organisasjonsatferd og ledelse,1454514556,2016-02-03 16:49:16,1454514879,323
5698dc4c41a9d721002410b0,13117,ORG3402 Organisasjonsatferd og ledelse,1454885716,2016-02-07 23:55:16,1454886837,1121
5698dc4c41a9d721002410b0,37868,ORG3402 Organisasjonsatferd og ledelse,1455048761,2016-02-09 21:12:41,1455048762,1
5698dc4c41a9d721002410b0,34574,ORG3402 Organisasjonsatferd og ledelse,1455051361,2016-02-09 21:56:01,1455051362,1
5698dc4c41a9d721002410b0,52189,ORG3402 Organisasjonsatferd og ledelse,1455092801,2016-02-10 09:26:41,1455092812,11
5698dc4d2fb0de2600f2326b,39591,ORG3402 Organisasjonsatferd og ledelse,1453026051,2016-01-17 11:20:51,1453026293,242
5698dc4d2fb0de2600f2326b,80645,ORG3402 Organisasjonsatferd og ledelse,1453072261,2016-01-18 00:11:01,1453072505,244
5698dc4d2fb0de2600f2326b,88699,ORG3402 Organisasjonsatferd og ledelse,1453126714,2016-01-18 15:18:34,1453126715,1
5698dc4d2fb0de2600f2326b,85869,ORG3402 Organisasjonsatferd og ledelse,1453580757,2016-01-23 21:25:57,1453580803,46
5698dc4d2fb0de2600f2326b,62866,ORG3402 Organisasjonsatferd og ledelse,1454577871,2016-02-04 10:24:31,1454578268,397
5698dc4d2fb0de2600f2326b,60885,ORG3402 Organisasjonsatferd og ledelse,1454759749,2016-02-06 12:55:49,1454759909,160
5698dc4d2fb0de2600f2326b,12850,ORG3402 Organisasjonsatferd og ledelse,1454844513,2016-02-07 12:28:33,1454844513,0
5698dc4d2fb0de2600f2326b,60459,ORG3402 Organisasjonsatferd og ledelse,1455059740,2016-02-10 00:15:40,1455059740,0
5698dc4d2fb0de2600f2326d,27936,ORG3402 Organisasjonsatferd og ledelse,1453884949,2016-01-27 09:55:49,1453885060,111
5698dc4d2fb0de2600f2326d,58830,ORG3402 Organisasjonsatferd og ledelse,1453890244,2016-01-27 11:24:04,1453890248,4
5698dc4d2fb0de2600f2326d,99704,ORG3402 Organisasjonsatferd og ledelse,1454486027,2016-02-03 08:53:47,1454486028,1
5698dc4d2fb0de2600f2326d,64004,ORG3402 Organisasjonsatferd og ledelse,1455194642,2016-02-11 13:44:02,1455194643,1
5698dc4d2fb0de2600f23270,819,ORG3402 Organisasjonsatferd og ledelse,1453067685,2016-01-17 22:54:45,1453067946,261
5698dc4d2fb0de2600f23270,51330,ORG3402 Organisasjonsatferd og ledelse,1454065685,2016-01-29 12:08:05,1454065706,21
5698dc4d2fb0de2600f23270,97783,ORG3402 Organisasjonsatferd og ledelse,1454497952,2016-02-03 12:12:32,1454498025,73
5698dc4d2fb0de2600f23270,24749,ORG3402 Organisasjonsatferd og ledelse,1454506565,2016-02-03 14:36:05,1454506569,4
5698dc4d2fb0de2600f23270,13094,ORG3402 Organisasjonsatferd og ledelse,1454929381,2016-02-08 12:03:01,1454929412,31
5698dc4d2fb0de2600f23270,1222,ORG3402 Organisasjonsatferd og ledelse,1454931769,2016-02-08 12:42:49,1454931769,0
5698dc4d2fb0de2600f23270,164,ORG3402 Organisasjonsatferd og ledelse,1454937688,2016-02-08 14:21:28,1454938464,776
5698dc4d2fb0de2600f23270,96317,ORG3402 Organisasjonsatferd og ledelse,1455181937,2016-02-11 10:12:17,1455181938,1
5698dc4d2fb0de2600f23273,79468,ORG3402 Organisasjonsatferd og ledelse,1452876574,2016-01-15 17:49:34,1452876627,53
5698dc4d2fb0de2600f23273,90975,ORG3402 Organisasjonsatferd og ledelse,1453881379,2016-01-27 08:56:19,1453881487,108
5698dc4d2fb0de2600f23273,48337,ORG3402 Organisasjonsatferd og ledelse,1454012167,2016-01-28 21:16:07,1454012204,37
5698dc4d2fb0de2600f23273,78533,ORG3402 Organisasjonsatferd og ledelse,1454432638,2016-02-02 18:03:58,1454432639,1
5698dc4d2fb0de2600f23273,62983,ORG3402 Organisasjonsatferd og ledelse,1454962010,2016-02-08 21:06:50,1454962010,0
5698dc4d2fb0de2600f23273,70261,ORG3402 Organisasjonsatferd og ledelse,1455029500,2016-02-09 15:51:40,1455029501,1
5698dc4d2fb0de2600f23273,6023,ORG3402 Organisasjonsatferd og ledelse,1455218598,2016-02-11 20:23:18,1455218599,1
5698dc4d2fb0de2600f23273,71461,ORG3402 Organisasjonsatferd og ledelse,1455479598,2016-02-14 20:53:18,1455480230,632
5698dc4d41a9d721002410b3,60652,ORG3402 Organisasjonsatferd og ledelse,1452882338,2016-01-15 19:25:38,1452882338,0
5698dc4d41a9d721002410b3,86523,ORG3402 Organisasjonsatferd og ledelse,1453050067,2016-01-17 18:01:07,1453050068,1
5698dc4d41a9d721002410b3,44459,ORG3402 Organisasjonsatferd og ledelse,1453053652,2016-01-17 19:00:52,1453053653,1
5698dc4d41a9d721002410b3,20078,ORG3402 Organisasjonsatferd og ledelse,1453999847,2016-01-28 17:50:47,1454000282,435
5698dc4d41a9d721002410b3,43341,ORG3402 Organisasjonsatferd og ledelse,1454682760,2016-02-05 15:32:40,1454682798,38
5698dc4d41a9d721002410b3,65317,ORG3402 Organisasjonsatferd og ledelse,1454685320,2016-02-05 16:15:20,1454686637,1317
5698dc4d41a9d721002410b3,59129,ORG3402 Organisasjonsatferd og ledelse,1455102051,2016-02-10 12:00:51,1455102076,25
5698dc4d41a9d721002410b3,61083,ORG3402 Organisasjonsatferd og ledelse,1455122027,2016-02-10 17:33:47,1455122027,0
5698dc4d41a9d721002410b6,23094,ORG3402 Organisasjonsatferd og ledelse,1453826390,2016-01-26 17:39:50,1453826486,96
5698dc4d41a9d721002410b6,79537,ORG3402 Organisasjonsatferd og ledelse,1453892673,2016-01-27 12:04:33,1453893049,376
5698dc4d41a9d721002410b6,75976,ORG3402 Organisasjonsatferd og ledelse,1453920814,2016-01-27 19:53:34,1453920857,43
5698dc4d41a9d721002410b6,90697,ORG3402 Organisasjonsatferd og ledelse,1454073442,2016-01-29 14:17:22,1454073523,81
5698dc4d41a9d721002410b6,35179,ORG3402 Organisasjonsatferd og ledelse,1454153428,2016-01-30 12:30:28,1454153467,39
5698dc4d41a9d721002410b6,34773,ORG3402 Organisasjonsatferd og ledelse,1454499025,2016-02-03 12:30:25,1454499040,15
5698dc4d41a9d721002410b6,42402,ORG3402 Organisasjonsatferd og ledelse,1454505033,2016-02-03 14:10:33,1454505826,793
5698dc4d41a9d721002410b6,44994,ORG3402 Organisasjonsatferd og ledelse,1454600652,2016-02-04 16:44:12,1454600652,0
5698dc4d41a9d721002410b6,90255,ORG3402 Organisasjonsatferd og ledelse,1454671177,2016-02-05 12:19:37,1454671177,0
5698dc4d41a9d721002410b6,7591,ORG3402 Organisasjonsatferd og ledelse,1454968521,2016-02-08 22:55:21,1454968546,25
5698dc4d41a9d721002410b6,9184,ORG3402 Organisasjonsatferd og ledelse,1455011289,2016-02-09 10:48:09,1455011551,262
5698dc4d41a9d721002410b6,83811,ORG3402 Organisasjonsatferd og ledelse,1455188762,2016-02-11 12:06:02,1455188762,0
5698dc4d41a9d721002410b6,30544,ORG3402 Organisasjonsatferd og ledelse,1455198274,2016-02-11 14:44:34,1455198570,296
5698dc4d41a9d721002410b7,94364,ORG3402 Organisasjonsatferd og ledelse,1453892900,2016-01-27 12:08:20,1453892901,1
5698dc4e2fb0de2600f23276,3793,ORG3402 Organisasjonsatferd og ledelse,1453305664,2016-01-20 17:01:04,1453305762,98
5698dc4e2fb0de2600f23276,67408,ORG3402 Organisasjonsatferd og ledelse,1453811079,2016-01-26 13:24:39,1453811179,100
5698dc4e2fb0de2600f23276,75794,ORG3402 Organisasjonsatferd og ledelse,1453825552,2016-01-26 17:25:52,1453825600,48
5698dc4e2fb0de2600f23276,11148,ORG3402 Organisasjonsatferd og ledelse,1454413621,2016-02-02 12:47:01,1454413718,97
5698dc4e2fb0de2600f23276,11324,ORG3402 Organisasjonsatferd og ledelse,1454420873,2016-02-02 14:47:53,1454421844,971
5698dc4e2fb0de2600f23276,23090,ORG3402 Organisasjonsatferd og ledelse,1454501657,2016-02-03 13:14:17,1454501933,276
5698dc4e2fb0de2600f23276,25936,ORG3402 Organisasjonsatferd og ledelse,1454513428,2016-02-03 16:30:28,1454513435,7
5698dc4e2fb0de2600f23276,61871,ORG3402 Organisasjonsatferd og ledelse,1454935662,2016-02-08 13:47:42,1454935663,1
5698dc4e2fb0de2600f23276,32205,ORG3402 Organisasjonsatferd og ledelse,1454938098,2016-02-08 14:28:18,1454938373,275
5698dc4e2fb0de2600f23276,81998,ORG3402 Organisasjonsatferd og ledelse,1455096152,2016-02-10 10:22:32,1455096475,323
5698dc4e2fb0de2600f23277,30875,ORG3402 Organisasjonsatferd og ledelse,1453203181,2016-01-19 12:33:01,1453203483,302
5698dc4e2fb0de2600f23277,21430,ORG3402 Organisasjonsatferd og ledelse,1453885797,2016-01-27 10:09:57,1453886048,251
5698dc4e2fb0de2600f23277,33118,ORG3402 Organisasjonsatferd og ledelse,1455189632,2016-02-11 12:20:32,1455191386,1754
5698dc4e2fb0de2600f23278,10223,ORG3402 Organisasjonsatferd og ledelse,1454068014,2016-01-29 12:46:54,1454068388,374
5698dc4e2fb0de2600f23278,37549,ORG3402 Organisasjonsatferd og ledelse,1455109168,2016-02-10 13:59:28,1455109168,0
5698dc4e2fb0de2600f23278,26652,ORG3402 Organisasjonsatferd og ledelse,1455113264,2016-02-10 15:07:44,1455113264,0
5698dc4e41a9d721002410b8,79961,ORG3402 Organisasjonsatferd og ledelse,1454493963,2016-02-03 11:06:03,1454494261,298
5698dc4e41a9d721002410b8,55135,ORG3402 Organisasjonsatferd og ledelse,1454495559,2016-02-03 11:32:39,1454495593,34
5698dc4e41a9d721002410b9,63347,ORG3402 Organisasjonsatferd og ledelse,1452897714,2016-01-15 23:41:54,1452897840,126
5698dc4e41a9d721002410b9,9035,ORG3402 Organisasjonsatferd og ledelse,1452900766,2016-01-16 00:32:46,1452900769,3
5698dc4e41a9d721002410b9,19787,ORG3402 Organisasjonsatferd og ledelse,1453073584,2016-01-18 00:33:04,1453073691,107
5698dc4e41a9d721002410b9,11251,ORG3402 Organisasjonsatferd og ledelse,1453196961,2016-01-19 10:49:21,1453196962,1
5698dc4e41a9d721002410b9,1450,ORG3402 Organisasjonsatferd og ledelse,1453678989,2016-01-25 00:43:09,1453679030,41
5698dc4e41a9d721002410b9,43146,ORG3402 Organisasjonsatferd og ledelse,1454410210,2016-02-02 11:50:10,1454410221,11
5698dc4e41a9d721002410b9,78971,ORG3402 Organisasjonsatferd og ledelse,1454498902,2016-02-03 12:28:22,1454498929,27
5698dc4e41a9d721002410b9,79211,ORG3402 Organisasjonsatferd og ledelse,1454504954,2016-02-03 14:09:14,1454505019,65
5698dc4e41a9d721002410b9,74909,ORG3402 Organisasjonsatferd og ledelse,1454688984,2016-02-05 17:16:24,1454689021,37
5698dc4e41a9d721002410b9,12523,ORG3402 Organisasjonsatferd og ledelse,1455370409,2016-02-13 14:33:29,1455370461,52
5698dc4e41a9d721002410b9,31079,ORG3402 Organisasjonsatferd og ledelse,1455386615,2016-02-13 19:03:35,1455386618,3
5698dc4e41a9d721002410b9,96878,ORG3402 Organisasjonsatferd og ledelse,1455398095,2016-02-13 22:14:55,1455398095,0
5698dc4e41a9d721002410b9,43392,ORG3402 Organisasjonsatferd og ledelse,1455472136,2016-02-14 18:48:56,1455472137,1
5698dc4e41a9d721002410b9,64596,ORG3402 Organisasjonsatferd og ledelse,1455490879,2016-02-15 00:01:19,1455490880,1
5698dc4e41a9d721002410be,82135,ORG3402 Organisasjonsatferd og ledelse,1452875526,2016-01-15 17:32:06,1452875570,44
5698dc4e41a9d721002410be,24055,ORG3402 Organisasjonsatferd og ledelse,1453064385,2016-01-17 21:59:45,1453064424,39
5698dc4e41a9d721002410be,68265,ORG3402 Organisasjonsatferd og ledelse,1453247665,2016-01-20 00:54:25,1453248016,351
5698dc4e41a9d721002410be,64860,ORG3402 Organisasjonsatferd og ledelse,1453892662,2016-01-27 12:04:22,1453893215,553
5698dc4e41a9d721002410be,89565,ORG3402 Organisasjonsatferd og ledelse,1455063975,2016-02-10 01:26:15,1455064281,306
5698dc4e41a9d721002410bf,71660,ORG3402 Organisasjonsatferd og ledelse,1454424921,2016-02-02 15:55:21,1454425023,102
5698dc4f2fb0de2600f23290,27532,ORG3402 Organisasjonsatferd og ledelse,1453327982,2016-01-20 23:13:02,1453328016,34
5698dc4f2fb0de2600f23293,59687,ORG3402 Organisasjonsatferd og ledelse,1454106718,2016-01-29 23:31:58,1454106738,20
5698dc4f41a9d721002410d9,17204,ORG3402 Organisasjonsatferd og ledelse,1452862419,2016-01-15 13:53:39,1452862432,13
5698dc4f41a9d721002410d9,37490,ORG3402 Organisasjonsatferd og ledelse,1453050137,2016-01-17 18:02:17,1453051337,1200
5698dc4f41a9d721002410d9,85150,ORG3402 Organisasjonsatferd og ledelse,1453831307,2016-01-26 19:01:47,1453831647,340
5698dc502fb0de2600f23297,23493,ORG3402 Organisasjonsatferd og ledelse,1453294898,2016-01-20 14:01:38,1453294996,98
5698dc502fb0de2600f23297,39985,ORG3402 Organisasjonsatferd og ledelse,1453822681,2016-01-26 16:38:01,1453822701,20
5698dc502fb0de2600f23297,82567,ORG3402 Organisasjonsatferd og ledelse,1455040589,2016-02-09 18:56:29,1455040790,201
5698dc502fb0de2600f23297,95271,ORG3402 Organisasjonsatferd og ledelse,1455101801,2016-02-10 11:56:41,1455101801,0
5698dc502fb0de2600f23297,45999,ORG3402 Organisasjonsatferd og ledelse,1455104385,2016-02-10 12:39:45,1455104532,147
5698dc502fb0de2600f23298,64448,ORG3402 Organisasjonsatferd og ledelse,1452862889,2016-01-15 14:01:29,1452862978,89
5698dc502fb0de2600f23298,49119,ORG3402 Organisasjonsatferd og ledelse,1453061187,2016-01-17 21:06:27,1453061213,26
5698dc502fb0de2600f23298,4879,ORG3402 Organisasjonsatferd og ledelse,1453152793,2016-01-18 22:33:13,1453152824,31
5698dc502fb0de2600f23298,32434,ORG3402 Organisasjonsatferd og ledelse,1453700414,2016-01-25 06:40:14,1453700500,86
5698dc5041a9d721002410df,60118,ORG3402 Organisasjonsatferd og ledelse,1453892927,2016-01-27 12:08:47,1453893580,653
5698dc5041a9d721002410df,94533,ORG3402 Organisasjonsatferd og ledelse,1453894817,2016-01-27 12:40:17,1453894818,1
5698dc5041a9d721002410df,85689,ORG3402 Organisasjonsatferd og ledelse,1453896939,2016-01-27 13:15:39,1453896977,38
5698dc5041a9d721002410df,65164,ORG3402 Organisasjonsatferd og ledelse,1453900393,2016-01-27 14:13:13,1453900511,118
5698dc5041a9d721002410e0,7104,ORG3402 Organisasjonsatferd og ledelse,1454441691,2016-02-02 20:34:51,1454441870,179
5698dc5041a9d721002410e0,38496,ORG3402 Organisasjonsatferd og ledelse,1454517046,2016-02-03 17:30:46,1454517136,90
5698dc512fb0de2600f232af,29990,ORG3402 Organisasjonsatferd og ledelse,1454499360,2016-02-03 12:36:00,1454499360,0
5698dc5141a9d721002410e1,5618,ORG3402 Organisasjonsatferd og ledelse,1455102470,2016-02-10 12:07:50,1455103338,868
5698dc5141a9d721002410e2,78711,ORG3402 Organisasjonsatferd og ledelse,1453124446,2016-01-18 14:40:46,1453125706,1260
5698dc5141a9d721002410e2,48676,ORG3402 Organisasjonsatferd og ledelse,1453308282,2016-01-20 17:44:42,1453308282,0
5698dc5141a9d721002410e2,7899,ORG3402 Organisasjonsatferd og ledelse,1453381134,2016-01-21 13:58:54,1453381171,37
5698dc5141a9d721002410e2,41453,ORG3402 Organisasjonsatferd og ledelse,1453813734,2016-01-26 14:08:54,1453813734,0
5698dc5141a9d721002410e3,58417,ORG3402 Organisasjonsatferd og ledelse,1453467643,2016-01-22 14:00:43,1453467921,278
5698dc5141a9d721002410e3,42418,ORG3402 Organisasjonsatferd og ledelse,1455228845,2016-02-11 23:14:05,1455228917,72
5698dc5141a9d721002410e3,60085,ORG3402 Organisasjonsatferd og ledelse,1455233268,2016-02-12 00:27:48,1455233268,0
5698dc5141a9d721002410e4,71627,ORG3402 Organisasjonsatferd og ledelse,1453892325,2016-01-27 11:58:45,1453892876,551
5698dc5141a9d721002410e4,22193,ORG3402 Organisasjonsatferd og ledelse,1453894275,2016-01-27 12:31:15,1453894288,13
5698dc5141a9d721002410e4,86567,ORG3402 Organisasjonsatferd og ledelse,1454006253,2016-01-28 19:37:33,1454006253,0
5698dc5141a9d721002410e4,33347,ORG3402 Organisasjonsatferd og ledelse,1454065932,2016-01-29 12:12:12,1454065943,11
5698dc5141a9d721002410e4,64065,ORG3402 Organisasjonsatferd og ledelse,1454074112,2016-01-29 14:28:32,1454074122,10
5698dc5141a9d721002410e4,8978,ORG3402 Organisasjonsatferd og ledelse,1454497692,2016-02-03 12:08:12,1454497827,135
5698dc5141a9d721002410e4,14193,ORG3402 Organisasjonsatferd og ledelse,1454506558,2016-02-03 14:35:58,1454506563,5
5698dc5141a9d721002410e4,8410,ORG3402 Organisasjonsatferd og ledelse,1454683616,2016-02-05 15:46:56,1454683616,0
5698dc5141a9d721002410e4,92566,ORG3402 Organisasjonsatferd og ledelse,1454685536,2016-02-05 16:18:56,1454685558,22
5698dc5141a9d721002410e4,2716,ORG3402 Organisasjonsatferd og ledelse,1455454506,2016-02-14 13:55:06,1455454506,0
5698dc5141a9d721002410e4,57,ORG3402 Organisasjonsatferd og ledelse,1455464780,2016-02-14 16:46:20,1455464780,0
5698dc5141a9d721002410f3,94605,ORG3402 Organisasjonsatferd og ledelse,1454953878,2016-02-08 18:51:18,1454954009,131
5698dc5141a9d721002410f3,74601,ORG3402 Organisasjonsatferd og ledelse,1454972080,2016-02-08 23:54:40,1454972081,1
5698dc5141a9d721002410f3,68892,ORG3402 Organisasjonsatferd og ledelse,1455314589,2016-02-12 23:03:09,1455314752,163
5698dc5141a9d721002410f3,15237,ORG3402 Organisasjonsatferd og ledelse,1455479288,2016-02-14 20:48:08,1455479289,1
5698dc522fb0de2600f232b9,81732,ORG3402 Organisasjonsatferd og ledelse,1455038974,2016-02-09 18:29:34,1455039069,95
5698dc5241a9d72100241100,29574,ORG3402 Organisasjonsatferd og ledelse,1453745484,2016-01-25 19:11:24,1453745523,39
5698dc5241a9d72100241100,75448,ORG3402 Organisasjonsatferd og ledelse,1453899771,2016-01-27 14:02:51,1453899801,30
5698dc5241a9d72100241100,72140,ORG3402 Organisasjonsatferd og ledelse,1455104413,2016-02-10 12:40:13,1455104414,1
5698dc5241a9d72100241103,32907,ORG3402 Organisasjonsatferd og ledelse,1452866024,2016-01-15 14:53:44,1452866091,67
5698dc5241a9d72100241103,12710,ORG3402 Organisasjonsatferd og ledelse,1452870448,2016-01-15 16:07:28,1452870448,0
5698dc5241a9d72100241103,54949,ORG3402 Organisasjonsatferd og ledelse,1454509079,2016-02-03 15:17:59,1454509989,910
5698dc5241a9d72100241103,43265,ORG3402 Organisasjonsatferd og ledelse,1454535842,2016-02-03 22:44:02,1454535842,0
5698dc5241a9d72100241103,1466,ORG3402 Organisasjonsatferd og ledelse,1454954754,2016-02-08 19:05:54,1454954757,3
5698dc5241a9d72100241103,86054,ORG3402 Organisasjonsatferd og ledelse,1455217435,2016-02-11 20:03:55,1455217435,0
5698dc532fb0de2600f232bf,35779,ORG3402 Organisasjonsatferd og ledelse,1452877797,2016-01-15 18:09:57,1452878780,983
5698dc532fb0de2600f232bf,81983,ORG3402 Organisasjonsatferd og ledelse,1452881556,2016-01-15 19:12:36,1452881786,230
5698dc532fb0de2600f232bf,5275,ORG3402 Organisasjonsatferd og ledelse,1452974798,2016-01-16 21:06:38,1452975135,337
5698dc532fb0de2600f232bf,91290,ORG3402 Organisasjonsatferd og ledelse,1453050333,2016-01-17 18:05:33,1453050354,21
5698dc532fb0de2600f232bf,69051,ORG3402 Organisasjonsatferd og ledelse,1453051954,2016-01-17 18:32:34,1453051996,42
5698dc532fb0de2600f232bf,5114,ORG3402 Organisasjonsatferd og ledelse,1453060600,2016-01-17 20:56:40,1453060663,63
5698dc532fb0de2600f232bf,18106,ORG3402 Organisasjonsatferd og ledelse,1453127316,2016-01-18 15:28:36,1453127325,9
5698dc532fb0de2600f232bf,55603,ORG3402 Organisasjonsatferd og ledelse,1453670713,2016-01-24 22:25:13,1453670905,192
5698dc532fb0de2600f232bf,48943,ORG3402 Organisasjonsatferd og ledelse,1453716575,2016-01-25 11:09:35,1453717036,461
5698dc532fb0de2600f232bf,16472,ORG3402 Organisasjonsatferd og ledelse,1453719175,2016-01-25 11:52:55,1453719205,30
5698dc532fb0de2600f232bf,83765,ORG3402 Organisasjonsatferd og ledelse,1453735610,2016-01-25 16:26:50,1453735611,1
5698dc532fb0de2600f232bf,86321,ORG3402 Organisasjonsatferd og ledelse,1454849872,2016-02-07 13:57:52,1454850007,135
5698dc532fb0de2600f232bf,60365,ORG3402 Organisasjonsatferd og ledelse,1455276885,2016-02-12 12:34:45,1455277772,887
5698dc5341a9d72100241104,6506,ORG3402 Organisasjonsatferd og ledelse,1452879650,2016-01-15 18:40:50,1452879997,347
5698dc5341a9d72100241104,61045,ORG3402 Organisasjonsatferd og ledelse,1452991237,2016-01-17 01:40:37,1452991445,208
5698dc5341a9d72100241104,93046,ORG3402 Organisasjonsatferd og ledelse,1453055062,2016-01-17 19:24:22,1453055367,305
5698dc5341a9d72100241104,16108,ORG3402 Organisasjonsatferd og ledelse,1453137218,2016-01-18 18:13:38,1453137343,125
5698dc5341a9d72100241104,70436,ORG3402 Organisasjonsatferd og ledelse,1455151274,2016-02-11 01:41:14,1455151397,123
5698dc5341a9d72100241106,30125,ORG3402 Organisasjonsatferd og ledelse,1452864986,2016-01-15 14:36:26,1452864987,1
5698dc5341a9d72100241106,87202,ORG3402 Organisasjonsatferd og ledelse,1453210089,2016-01-19 14:28:09,1453210131,42
5698dc5341a9d72100241106,90005,ORG3402 Organisasjonsatferd og ledelse,1453214496,2016-01-19 15:41:36,1453214500,4
5698dc5341a9d72100241106,86656,ORG3402 Organisasjonsatferd og ledelse,1453822308,2016-01-26 16:31:48,1453822427,119
5698dc5341a9d72100241106,42906,ORG3402 Organisasjonsatferd og ledelse,1453895750,2016-01-27 12:55:50,1453896043,293
5698dc5341a9d72100241106,71256,ORG3402 Organisasjonsatferd og ledelse,1453900484,2016-01-27 14:14:44,1453900816,332
5698dc5341a9d72100241106,81017,ORG3402 Organisasjonsatferd og ledelse,1455037891,2016-02-09 18:11:31,1455037891,0
5698dc542fb0de2600f232c2,33696,ORG3402 Organisasjonsatferd og ledelse,1453212836,2016-01-19 15:13:56,1453212964,128
5698dc542fb0de2600f232c2,83595,ORG3402 Organisasjonsatferd og ledelse,1454489270,2016-02-03 09:47:50,1454489357,87
5698dc542fb0de2600f232c3,34999,ORG3402 Organisasjonsatferd og ledelse,1452866414,2016-01-15 15:00:14,1452866415,1
5698dc542fb0de2600f232c3,80227,ORG3402 Organisasjonsatferd og ledelse,1453148561,2016-01-18 21:22:41,1453148589,28
5698dc542fb0de2600f232c3,21940,ORG3402 Organisasjonsatferd og ledelse,1453755700,2016-01-25 22:01:40,1453755749,49
5698dc542fb0de2600f232c5,41388,ORG3402 Organisasjonsatferd og ledelse,1453525619,2016-01-23 06:06:59,1453525932,313
5698dc542fb0de2600f232c5,65462,ORG3402 Organisasjonsatferd og ledelse,1453663361,2016-01-24 20:22:41,1453663361,0
5698dc542fb0de2600f232c5,57767,ORG3402 Organisasjonsatferd og ledelse,1455048787,2016-02-09 21:13:07,1455049185,398
5698dc542fb0de2600f232c6,69831,ORG3402 Organisasjonsatferd og ledelse,1453316190,2016-01-20 19:56:30,1453316190,0
5698dc542fb0de2600f232c6,96491,ORG3402 Organisasjonsatferd og ledelse,1453683931,2016-01-25 02:05:31,1453683950,19
5698dc542fb0de2600f232c6,93700,ORG3402 Organisasjonsatferd og ledelse,1453909037,2016-01-27 16:37:17,1453909038,1
5698dc542fb0de2600f232c6,44229,ORG3402 Organisasjonsatferd og ledelse,1453978284,2016-01-28 11:51:24,1453978286,2
5698dc542fb0de2600f232c6,14547,ORG3402 Organisasjonsatferd og ledelse,1454014414,2016-01-28 21:53:34,1454014415,1
5698dc542fb0de2600f232c6,49448,ORG3402 Organisasjonsatferd og ledelse,1454096829,2016-01-29 20:47:09,1454096829,0
5698dc542fb0de2600f232c6,13268,ORG3402 Organisasjonsatferd og ledelse,1454123264,2016-01-30 04:07:44,1454123265,1
5698dc542fb0de2600f232c6,94560,ORG3402 Organisasjonsatferd og ledelse,1454163279,2016-01-30 15:14:39,1454163279,0
5698dc542fb0de2600f232c6,10162,ORG3402 Organisasjonsatferd og ledelse,1454248793,2016-01-31 14:59:53,1454248793,0
5698dc542fb0de2600f232c6,56734,ORG3402 Organisasjonsatferd og ledelse,1454335608,2016-02-01 15:06:48,1454335609,1
5698dc542fb0de2600f232c6,58886,ORG3402 Organisasjonsatferd og ledelse,1454370961,2016-02-02 00:56:01,1454370975,14
5698dc542fb0de2600f232c6,51216,ORG3402 Organisasjonsatferd og ledelse,1454374662,2016-02-02 01:57:42,1454374784,122
5698dc542fb0de2600f232c6,43459,ORG3402 Organisasjonsatferd og ledelse,1454411684,2016-02-02 12:14:44,1454411685,1
5698dc542fb0de2600f232c6,29763,ORG3402 Organisasjonsatferd og ledelse,1454532603,2016-02-03 21:50:03,1454532604,1
5698dc542fb0de2600f232c6,22112,ORG3402 Organisasjonsatferd og ledelse,1454614225,2016-02-04 20:30:25,1454614227,2
5698dc542fb0de2600f232c6,93250,ORG3402 Organisasjonsatferd og ledelse,1454630351,2016-02-05 00:59:11,1454630351,0
5698dc542fb0de2600f232c6,29235,ORG3402 Organisasjonsatferd og ledelse,1454678665,2016-02-05 14:24:25,1454678665,0
5698dc542fb0de2600f232c6,41731,ORG3402 Organisasjonsatferd og ledelse,1454700993,2016-02-05 20:36:33,1454700993,0
5698dc542fb0de2600f232c6,69841,ORG3402 Organisasjonsatferd og ledelse,1454782397,2016-02-06 19:13:17,1454782398,1
5698dc542fb0de2600f232c6,27097,ORG3402 Organisasjonsatferd og ledelse,1454804673,2016-02-07 01:24:33,1454804673,0
5698dc542fb0de2600f232c6,9068,ORG3402 Organisasjonsatferd og ledelse,1454859914,2016-02-07 16:45:14,1454859915,1
5698dc542fb0de2600f232c6,67392,ORG3402 Organisasjonsatferd og ledelse,1454862678,2016-02-07 17:31:18,1454862679,1
5698dc542fb0de2600f232c6,55203,ORG3402 Organisasjonsatferd og ledelse,1454941363,2016-02-08 15:22:43,1454941364,1
5698dc542fb0de2600f232c6,76225,ORG3402 Organisasjonsatferd og ledelse,1455031200,2016-02-09 16:20:00,1455031201,1
5698dc542fb0de2600f232c6,88233,ORG3402 Organisasjonsatferd og ledelse,1455109912,2016-02-10 14:11:52,1455110712,800
5698dc542fb0de2600f232c6,23149,ORG3402 Organisasjonsatferd og ledelse,1455112994,2016-02-10 15:03:14,1455112994,0
5698dc542fb0de2600f232c6,12693,ORG3402 Organisasjonsatferd og ledelse,1455197159,2016-02-11 14:25:59,1455197207,48
5698dc542fb0de2600f232c6,52188,ORG3402 Organisasjonsatferd og ledelse,1455277585,2016-02-12 12:46:25,1455277625,40
5698dc542fb0de2600f232c6,34148,ORG3402 Organisasjonsatferd og ledelse,1455323448,2016-02-13 01:30:48,1455324176,728
5698dc542fb0de2600f232c6,44541,ORG3402 Organisasjonsatferd og ledelse,1455367904,2016-02-13 13:51:44,1455367905,1
5698dc542fb0de2600f232c6,5379,ORG3402 Organisasjonsatferd og ledelse,1455420304,2016-02-14 04:25:04,1455420304,0
5698dc542fb0de2600f232c6,47854,ORG3402 Organisasjonsatferd og ledelse,1455462294,2016-02-14 16:04:54,1455462295,1
5698dc542fb0de2600f232c9,47180,ORG3402 Organisasjonsatferd og ledelse,1454074715,2016-01-29 14:38:35,1454074797,82
5698dc542fb0de2600f232c9,84981,ORG3402 Organisasjonsatferd og ledelse,1454076035,2016-01-29 15:00:35,1454076036,1
5698dc542fb0de2600f232cd,23933,ORG3402 Organisasjonsatferd og ledelse,1452862153,2016-01-15 13:49:13,1452862190,37
5698dc542fb0de2600f232cd,69742,ORG3402 Organisasjonsatferd og ledelse,1453050807,2016-01-17 18:13:27,1453050808,1
5698dc542fb0de2600f232cd,86161,ORG3402 Organisasjonsatferd og ledelse,1453071072,2016-01-17 23:51:12,1453071073,1
5698dc542fb0de2600f232cd,76684,ORG3402 Organisasjonsatferd og ledelse,1453134035,2016-01-18 17:20:35,1453134035,0
5698dc542fb0de2600f232cd,2199,ORG3402 Organisasjonsatferd og ledelse,1453384405,2016-01-21 14:53:25,1453384504,99
5698dc542fb0de2600f232cd,28847,ORG3402 Organisasjonsatferd og ledelse,1453672531,2016-01-24 22:55:31,1453672540,9
5698dc542fb0de2600f232cd,76137,ORG3402 Organisasjonsatferd og ledelse,1454637330,2016-02-05 02:55:30,1454637331,1
5698dc5441a9d7210024110a,77204,ORG3402 Organisasjonsatferd og ledelse,1453891374,2016-01-27 11:42:54,1453891669,295
5698dc5441a9d7210024110a,56605,ORG3402 Organisasjonsatferd og ledelse,1454492920,2016-02-03 10:48:40,1454492959,39
5698dc5441a9d72100241118,39365,ORG3402 Organisasjonsatferd og ledelse,1453892943,2016-01-27 12:09:03,1453892943,0
5698dc552fb0de2600f232e8,22035,ORG3402 Organisasjonsatferd og ledelse,1454852861,2016-02-07 14:47:41,1454852990,129
5698dc552fb0de2600f232e8,1750,ORG3402 Organisasjonsatferd og ledelse,1455183066,2016-02-11 10:31:06,1455183086,20
5698dc5541a9d72100241124,29505,ORG3402 Organisasjonsatferd og ledelse,1452931599,2016-01-16 09:06:39,1452931628,29
5698dc5541a9d72100241124,56055,ORG3402 Organisasjonsatferd og ledelse,1452971471,2016-01-16 20:11:11,1452971489,18
5698dc5541a9d72100241124,74388,ORG3402 Organisasjonsatferd og ledelse,1453060759,2016-01-17 20:59:19,1453060981,222
5698dc5541a9d72100241124,83462,ORG3402 Organisasjonsatferd og ledelse,1453287770,2016-01-20 12:02:50,1453288161,391
5698dc5541a9d72100241124,41135,ORG3402 Organisasjonsatferd og ledelse,1453400687,2016-01-21 19:24:47,1453400687,0
5698dc5541a9d72100241124,62707,ORG3402 Organisasjonsatferd og ledelse,1453889919,2016-01-27 11:18:39,1453889944,25
5698dc5541a9d72100241124,9425,ORG3402 Organisasjonsatferd og ledelse,1453901168,2016-01-27 14:26:08,1453901175,7
5698dc5541a9d72100241124,8777,ORG3402 Organisasjonsatferd og ledelse,1454320583,2016-02-01 10:56:23,1454320922,339
5698dc5541a9d72100241124,68158,ORG3402 Organisasjonsatferd og ledelse,1454337256,2016-02-01 15:34:16,1454337380,124
5698dc5541a9d72100241124,69226,ORG3402 Organisasjonsatferd og ledelse,1454348009,2016-02-01 18:33:29,1454348023,14
5698dc5541a9d72100241124,57391,ORG3402 Organisasjonsatferd og ledelse,1454841410,2016-02-07 11:36:50,1454841412,2
5698dc5541a9d72100241124,74276,ORG3402 Organisasjonsatferd og ledelse,1454876369,2016-02-07 21:19:29,1454876369,0
5698dc5541a9d72100241127,48376,ORG3402 Organisasjonsatferd og ledelse,1452868005,2016-01-15 15:26:45,1452868005,0
5698dc5541a9d72100241127,61058,ORG3402 Organisasjonsatferd og ledelse,1452870447,2016-01-15 16:07:27,1452870449,2
5698dc5541a9d72100241127,11923,ORG3402 Organisasjonsatferd og ledelse,1452876851,2016-01-15 17:54:11,1452876915,64
5698dc5541a9d72100241127,80917,ORG3402 Organisasjonsatferd og ledelse,1452890238,2016-01-15 21:37:18,1452890241,3
5698dc5541a9d72100241127,57901,ORG3402 Organisasjonsatferd og ledelse,1453037183,2016-01-17 14:26:23,1453037206,23
5698dc5541a9d72100241127,99160,ORG3402 Organisasjonsatferd og ledelse,1453055775,2016-01-17 19:36:15,1453055798,23
5698dc5541a9d72100241127,21472,ORG3402 Organisasjonsatferd og ledelse,1453061542,2016-01-17 21:12:22,1453061614,72
5698dc5541a9d72100241127,76504,ORG3402 Organisasjonsatferd og ledelse,1453450866,2016-01-22 09:21:06,1453450940,74
5698dc5541a9d72100241127,25768,ORG3402 Organisasjonsatferd og ledelse,1453668882,2016-01-24 21:54:42,1453668884,2
5698dc5541a9d72100241127,55713,ORG3402 Organisasjonsatferd og ledelse,1453892762,2016-01-27 12:06:02,1453892885,123
5698dc5541a9d72100241127,99896,ORG3402 Organisasjonsatferd og ledelse,1453896886,2016-01-27 13:14:46,1453897010,124
5698dc5541a9d72100241127,38661,ORG3402 Organisasjonsatferd og ledelse,1453899114,2016-01-27 13:51:54,1453899114,0
5698dc5541a9d72100241127,97377,ORG3402 Organisasjonsatferd og ledelse,1454058457,2016-01-29 10:07:37,1454058523,66
5698dc5541a9d72100241127,73271,ORG3402 Organisasjonsatferd og ledelse,1454926224,2016-02-08 11:10:24,1454926317,93
5698dc5541a9d72100241127,35384,ORG3402 Organisasjonsatferd og ledelse,1455104488,2016-02-10 12:41:28,1455104535,47
5698dc5541a9d72100241128,68464,ORG3402 Organisasjonsatferd og ledelse,1452862175,2016-01-15 13:49:35,1452862175,0
5698dc5541a9d72100241128,5356,ORG3402 Organisasjonsatferd og ledelse,1455458616,2016-02-14 15:03:36,1455458913,297
5698dc5541a9d72100241128,56015,ORG3402 Organisasjonsatferd og ledelse,1455479410,2016-02-14 20:50:10,1455479790,380
5698dc5541a9d72100241128,16253,ORG3402 Organisasjonsatferd og ledelse,1455483416,2016-02-14 21:56:56,1455483416,0
5698dc562fb0de2600f232ea,76366,ORG3402 Organisasjonsatferd og ledelse,1454497392,2016-02-03 12:03:12,1454497665,273
5698dc562fb0de2600f232ea,86179,ORG3402 Organisasjonsatferd og ledelse,1454499145,2016-02-03 12:32:25,1454499279,134
5698dc562fb0de2600f232ea,79832,ORG3402 Organisasjonsatferd og ledelse,1454501852,2016-02-03 13:17:32,1454501857,5
5698dc562fb0de2600f232ea,39507,ORG3402 Organisasjonsatferd og ledelse,1454508804,2016-02-03 15:13:24,1454508816,12
5698dc562fb0de2600f232ea,4144,ORG3402 Organisasjonsatferd og ledelse,1454513025,2016-02-03 16:23:45,1454513446,421
5698dc562fb0de2600f232ea,6597,ORG3402 Organisasjonsatferd og ledelse,1455279947,2016-02-12 13:25:47,1455280140,193
5698dc562fb0de2600f232ec,39909,ORG3402 Organisasjonsatferd og ledelse,1452892835,2016-01-15 22:20:35,1452893775,940
5698dc562fb0de2600f232ec,70986,ORG3402 Organisasjonsatferd og ledelse,1453074786,2016-01-18 00:53:06,1453074855,69
5698dc562fb0de2600f232ec,16599,ORG3402 Organisasjonsatferd og ledelse,1453311574,2016-01-20 18:39:34,1453311588,14
5698dc562fb0de2600f232ec,42174,ORG3402 Organisasjonsatferd og ledelse,1453674070,2016-01-24 23:21:10,1453674078,8
5698dc562fb0de2600f232ec,91759,ORG3402 Organisasjonsatferd og ledelse,1454065670,2016-01-29 12:07:50,1454066145,475
5698dc562fb0de2600f232ec,63636,ORG3402 Organisasjonsatferd og ledelse,1454498066,2016-02-03 12:14:26,1454498068,2
5698dc562fb0de2600f232ec,60797,ORG3402 Organisasjonsatferd og ledelse,1454505010,2016-02-03 14:10:10,1454505075,65
5698dc562fb0de2600f232ec,53554,ORG3402 Organisasjonsatferd og ledelse,1454929062,2016-02-08 11:57:42,1454929403,341
5698dc562fb0de2600f232ec,68750,ORG3402 Organisasjonsatferd og ledelse,1454931543,2016-02-08 12:39:03,1454931619,76
5698dc562fb0de2600f232ec,34408,ORG3402 Organisasjonsatferd og ledelse,1455110829,2016-02-10 14:27:09,1455110829,0
5698dc572fb0de2600f232ee,44713,ORG3402 Organisasjonsatferd og ledelse,1454335061,2016-02-01 14:57:41,1454335092,31
5698dc572fb0de2600f232ee,10239,ORG3402 Organisasjonsatferd og ledelse,1455117837,2016-02-10 16:23:57,1455117857,20
5698dc572fb0de2600f232ee,29463,ORG3402 Organisasjonsatferd og ledelse,1455192009,2016-02-11 13:00:09,1455192046,37
5698dc572fb0de2600f232ee,38382,ORG3402 Organisasjonsatferd og ledelse,1455271985,2016-02-12 11:13:05,1455271987,2
5698dc572fb0de2600f232ef,79719,ORG3402 Organisasjonsatferd og ledelse,1453905298,2016-01-27 15:34:58,1453906418,1120
5698dc572fb0de2600f232f6,93456,ORG3402 Organisasjonsatferd og ledelse,1453817153,2016-01-26 15:05:53,1453817600,447
5698dc572fb0de2600f232f6,67981,ORG3402 Organisasjonsatferd og ledelse,1453823100,2016-01-26 16:45:00,1453823105,5
5698dc572fb0de2600f232f6,26121,ORG3402 Organisasjonsatferd og ledelse,1454195586,2016-01-31 00:13:06,1454195587,1
5698dc572fb0de2600f232f6,40737,ORG3402 Organisasjonsatferd og ledelse,1454418335,2016-02-02 14:05:35,1454418343,8
5698dc572fb0de2600f232f6,68812,ORG3402 Organisasjonsatferd og ledelse,1454451482,2016-02-02 23:18:02,1454451482,0
5698dc572fb0de2600f232f6,37663,ORG3402 Organisasjonsatferd og ledelse,1454455453,2016-02-03 00:24:13,1454455473,20
5698dc572fb0de2600f232f6,30159,ORG3402 Organisasjonsatferd og ledelse,1454592861,2016-02-04 14:34:21,1454592901,40
5698dc572fb0de2600f232f6,23100,ORG3402 Organisasjonsatferd og ledelse,1454602227,2016-02-04 17:10:27,1454602227,0
5698dc572fb0de2600f232f6,61363,ORG3402 Organisasjonsatferd og ledelse,1455026024,2016-02-09 14:53:44,1455026024,0
5698dc572fb0de2600f232f6,77813,ORG3402 Organisasjonsatferd og ledelse,1455058504,2016-02-09 23:55:04,1455058553,49
5698dc572fb0de2600f232f6,47296,ORG3402 Organisasjonsatferd og ledelse,1455109628,2016-02-10 14:07:08,1455109691,63
5698dc572fb0de2600f232f6,73071,ORG3402 Organisasjonsatferd og ledelse,1455114048,2016-02-10 15:20:48,1455114087,39
5698dc572fb0de2600f232f6,41187,ORG3402 Organisasjonsatferd og ledelse,1455120485,2016-02-10 17:08:05,1455120559,74
5698dc572fb0de2600f232f6,56194,ORG3402 Organisasjonsatferd og ledelse,1455457471,2016-02-14 14:44:31,1455457472,1
5698dc5741a9d7210024112b,57183,ORG3402 Organisasjonsatferd og ledelse,1453125559,2016-01-18 14:59:19,1453125665,106
5698dc5741a9d7210024112b,588,ORG3402 Organisasjonsatferd og ledelse,1453129169,2016-01-18 15:59:29,1453129169,0
5698dc5741a9d7210024112b,74682,ORG3402 Organisasjonsatferd og ledelse,1453551316,2016-01-23 13:15:16,1453551336,20
5698dc5741a9d7210024112b,66729,ORG3402 Organisasjonsatferd og ledelse,1453553465,2016-01-23 13:51:05,1453553471,6
5698dc5741a9d7210024112b,9936,ORG3402 Organisasjonsatferd og ledelse,1453669184,2016-01-24 21:59:44,1453669185,1
5698dc5741a9d7210024112b,5515,ORG3402 Organisasjonsatferd og ledelse,1453734851,2016-01-25 16:14:11,1453734902,51
5698dc5741a9d7210024112b,12560,ORG3402 Organisasjonsatferd og ledelse,1453892365,2016-01-27 11:59:25,1453893134,769
5698dc5741a9d7210024112b,79234,ORG3402 Organisasjonsatferd og ledelse,1454071259,2016-01-29 13:40:59,1454071267,8
5698dc5741a9d7210024112b,41981,ORG3402 Organisasjonsatferd og ledelse,1454073435,2016-01-29 14:17:15,1454073443,8
5698dc5741a9d7210024112b,89861,ORG3402 Organisasjonsatferd og ledelse,1454181075,2016-01-30 20:11:15,1454181076,1
5698dc5741a9d7210024112b,77404,ORG3402 Organisasjonsatferd og ledelse,1454504953,2016-02-03 14:09:13,1454506646,1693
5698dc5741a9d7210024112b,59566,ORG3402 Organisasjonsatferd og ledelse,1454516555,2016-02-03 17:22:35,1454516555,0
5698dc5741a9d7210024112b,91172,ORG3402 Organisasjonsatferd og ledelse,1454844147,2016-02-07 12:22:27,1454844165,18
5698dc5741a9d7210024112b,90577,ORG3402 Organisasjonsatferd og ledelse,1454895525,2016-02-08 02:38:45,1454895527,2
5698dc5741a9d7210024112b,40271,ORG3402 Organisasjonsatferd og ledelse,1455114730,2016-02-10 15:32:10,1455114807,77
5698dc5741a9d7210024112c,581,ORG3402 Organisasjonsatferd og ledelse,1453303545,2016-01-20 16:25:45,1453304863,1318
5698dc5741a9d7210024112c,65404,ORG3402 Organisasjonsatferd og ledelse,1455049280,2016-02-09 21:21:20,1455049953,673
5698dc5741a9d7210024112c,45440,ORG3402 Organisasjonsatferd og ledelse,1455377178,2016-02-13 16:26:18,1455377585,407
5698dc5741a9d7210024112c,97993,ORG3402 Organisasjonsatferd og ledelse,1455470614,2016-02-14 18:23:34,1455470630,16
5698dc5741a9d7210024112d,17650,ORG3402 Organisasjonsatferd og ledelse,1452868513,2016-01-15 15:35:13,1452868514,1
5698dc5741a9d7210024112d,87156,ORG3402 Organisasjonsatferd og ledelse,1452874605,2016-01-15 17:16:45,1452874607,2
5698dc5741a9d7210024112d,61670,ORG3402 Organisasjonsatferd og ledelse,1452977270,2016-01-16 21:47:50,1452977317,47
5698dc5741a9d7210024112d,98620,ORG3402 Organisasjonsatferd og ledelse,1453062577,2016-01-17 21:29:37,1453062611,34
5698dc5741a9d7210024112d,67976,ORG3402 Organisasjonsatferd og ledelse,1453127139,2016-01-18 15:25:39,1453127139,0
5698dc5741a9d7210024112d,73166,ORG3402 Organisasjonsatferd og ledelse,1453206256,2016-01-19 13:24:16,1453206329,73
5698dc5741a9d7210024112d,30725,ORG3402 Organisasjonsatferd og ledelse,1453681422,2016-01-25 01:23:42,1453681427,5
5698dc5741a9d7210024112d,86207,ORG3402 Organisasjonsatferd og ledelse,1454198951,2016-01-31 01:09:11,1454198997,46
5698dc5741a9d7210024112d,70873,ORG3402 Organisasjonsatferd og ledelse,1454539423,2016-02-03 23:43:43,1454539503,80
5698dc5741a9d7210024113e,58456,ORG3402 Organisasjonsatferd og ledelse,1454456980,2016-02-03 00:49:40,1454457031,51
5698dc5741a9d7210024113e,73902,ORG3402 Organisasjonsatferd og ledelse,1455097488,2016-02-10 10:44:48,1455097722,234
5698dc582fb0de2600f2330d,93237,ORG3402 Organisasjonsatferd og ledelse,1454510627,2016-02-03 15:43:47,1454510690,63
5698dc582fb0de2600f2330d,79403,ORG3402 Organisasjonsatferd og ledelse,1454512083,2016-02-03 16:08:03,1454512300,217
5698dc582fb0de2600f2330f,7459,ORG3402 Organisasjonsatferd og ledelse,1453222909,2016-01-19 18:01:49,1453224613,1704
5698dc582fb0de2600f2330f,71607,ORG3402 Organisasjonsatferd og ledelse,1453402046,2016-01-21 19:47:26,1453402057,11
5698dc582fb0de2600f2330f,88737,ORG3402 Organisasjonsatferd og ledelse,1453671549,2016-01-24 22:39:09,1453671622,73
5698dc582fb0de2600f2330f,67421,ORG3402 Organisasjonsatferd og ledelse,1453834373,2016-01-26 19:52:53,1453834376,3
5698dc582fb0de2600f2330f,58162,ORG3402 Organisasjonsatferd og ledelse,1453836349,2016-01-26 20:25:49,1453837178,829
5698dc582fb0de2600f2330f,62281,ORG3402 Organisasjonsatferd og ledelse,1453887470,2016-01-27 10:37:50,1453887470,0
5698dc582fb0de2600f2330f,59861,ORG3402 Organisasjonsatferd og ledelse,1453896898,2016-01-27 13:14:58,1453896922,24
5698dc582fb0de2600f2330f,89142,ORG3402 Organisasjonsatferd og ledelse,1454061425,2016-01-29 10:57:05,1454061602,177
5698dc582fb0de2600f2330f,46720,ORG3402 Organisasjonsatferd og ledelse,1454062808,2016-01-29 11:20:08,1454062808,0
5698dc582fb0de2600f2330f,93985,ORG3402 Organisasjonsatferd og ledelse,1454065444,2016-01-29 12:04:04,1454065445,1
5698dc582fb0de2600f2330f,40042,ORG3402 Organisasjonsatferd og ledelse,1454497285,2016-02-03 12:01:25,1454497402,117
5698dc582fb0de2600f2330f,91614,ORG3402 Organisasjonsatferd og ledelse,1455227565,2016-02-11 22:52:45,1455227568,3
5698dc592fb0de2600f23311,92378,ORG3402 Organisasjonsatferd og ledelse,1452863273,2016-01-15 14:07:53,1452863350,77
5698dc592fb0de2600f23311,77258,ORG3402 Organisasjonsatferd og ledelse,1452867935,2016-01-15 15:25:35,1452867936,1
5698dc592fb0de2600f23311,53606,ORG3402 Organisasjonsatferd og ledelse,1453051265,2016-01-17 18:21:05,1453051265,0
5698dc592fb0de2600f23311,91069,ORG3402 Organisasjonsatferd og ledelse,1453057598,2016-01-17 20:06:38,1453057599,1
5698dc592fb0de2600f23311,85691,ORG3402 Organisasjonsatferd og ledelse,1453220893,2016-01-19 17:28:13,1453221039,146
5698dc592fb0de2600f23311,51297,ORG3402 Organisasjonsatferd og ledelse,1453277698,2016-01-20 09:14:58,1453277698,0
5698dc592fb0de2600f23311,62824,ORG3402 Organisasjonsatferd og ledelse,1453718434,2016-01-25 11:40:34,1453718435,1
5698dc592fb0de2600f23311,9507,ORG3402 Organisasjonsatferd og ledelse,1453723090,2016-01-25 12:58:10,1453723148,58
5698dc592fb0de2600f23311,72340,ORG3402 Organisasjonsatferd og ledelse,1453762081,2016-01-25 23:48:01,1453762081,0
5698dc592fb0de2600f23311,80181,ORG3402 Organisasjonsatferd og ledelse,1453993386,2016-01-28 16:03:06,1453993502,116
5698dc592fb0de2600f23315,20956,ORG3402 Organisasjonsatferd og ledelse,1453064587,2016-01-17 22:03:07,1453064810,223
5698dc592fb0de2600f23315,51403,ORG3402 Organisasjonsatferd og ledelse,1453814400,2016-01-26 14:20:00,1453814463,63
5698dc592fb0de2600f23315,54874,ORG3402 Organisasjonsatferd og ledelse,1453900442,2016-01-27 14:14:02,1453900609,167
5698dc592fb0de2600f23315,17543,ORG3402 Organisasjonsatferd og ledelse,1453937565,2016-01-28 00:32:45,1453937567,2
5698dc592fb0de2600f23315,82217,ORG3402 Organisasjonsatferd og ledelse,1454030740,2016-01-29 02:25:40,1454030790,50
5698dc592fb0de2600f23315,59114,ORG3402 Organisasjonsatferd og ledelse,1454069282,2016-01-29 13:08:02,1454069314,32
5698dc592fb0de2600f23315,97299,ORG3402 Organisasjonsatferd og ledelse,1454156006,2016-01-30 13:13:26,1454156007,1
5698dc592fb0de2600f23315,70485,ORG3402 Organisasjonsatferd og ledelse,1454502106,2016-02-03 13:21:46,1454502195,89
5698dc592fb0de2600f23315,69406,ORG3402 Organisasjonsatferd og ledelse,1454509602,2016-02-03 15:26:42,1454509655,53
5698dc592fb0de2600f23315,53261,ORG3402 Organisasjonsatferd og ledelse,1454531600,2016-02-03 21:33:20,1454531900,300
5698dc592fb0de2600f23315,29669,ORG3402 Organisasjonsatferd og ledelse,1455137526,2016-02-10 21:52:06,1455138178,652
5698dc592fb0de2600f23315,75396,ORG3402 Organisasjonsatferd og ledelse,1455481639,2016-02-14 21:27:19,1455481761,122
5698dc5941a9d72100241152,97886,ORG3402 Organisasjonsatferd og ledelse,1454100449,2016-01-29 21:47:29,1454100450,1
5698dc5941a9d72100241152,94635,ORG3402 Organisasjonsatferd og ledelse,1454503576,2016-02-03 13:46:16,1454503592,16
5698dc5941a9d72100241152,32663,ORG3402 Organisasjonsatferd og ledelse,1454504973,2016-02-03 14:09:33,1454504986,13
5698dc5941a9d72100241152,72062,ORG3402 Organisasjonsatferd og ledelse,1454506574,2016-02-03 14:36:14,1454506586,12
5698dc5941a9d72100241152,98422,ORG3402 Organisasjonsatferd og ledelse,1454571644,2016-02-04 08:40:44,1454572012,368
5698dc5941a9d72100241152,47724,ORG3402 Organisasjonsatferd og ledelse,1455093562,2016-02-10 09:39:22,1455093632,70
5698dc5941a9d72100241152,46387,ORG3402 Organisasjonsatferd og ledelse,1455095549,2016-02-10 10:12:29,1455095549,0
5698dc5941a9d72100241152,94648,ORG3402 Organisasjonsatferd og ledelse,1455101594,2016-02-10 11:53:14,1455101605,11
5698dc5941a9d72100241152,55469,ORG3402 Organisasjonsatferd og ledelse,1455106062,2016-02-10 13:07:42,1455106076,14
5698dc5941a9d72100241153,59295,ORG3402 Organisasjonsatferd og ledelse,1452863303,2016-01-15 14:08:23,1452863369,66
5698dc5941a9d72100241153,65887,ORG3402 Organisasjonsatferd og ledelse,1453031215,2016-01-17 12:46:55,1453031220,5
5698dc5941a9d72100241153,96930,ORG3402 Organisasjonsatferd og ledelse,1453126074,2016-01-18 15:07:54,1453126107,33
5698dc5941a9d72100241153,42782,ORG3402 Organisasjonsatferd og ledelse,1453207208,2016-01-19 13:40:08,1453207450,242
5698dc5941a9d72100241153,4259,ORG3402 Organisasjonsatferd og ledelse,1453634606,2016-01-24 12:23:26,1453634783,177
5698dc5941a9d72100241153,60353,ORG3402 Organisasjonsatferd og ledelse,1454497107,2016-02-03 11:58:27,1454497336,229
5698dc5941a9d72100241153,73701,ORG3402 Organisasjonsatferd og ledelse,1455023574,2016-02-09 14:12:54,1455023600,26
5698dc5941a9d72100241153,4811,ORG3402 Organisasjonsatferd og ledelse,1455186584,2016-02-11 11:29:44,1455187191,607
5698dc5a2fb0de2600f23319,69000,ORG3402 Organisasjonsatferd og ledelse,1453849473,2016-01-27 00:04:33,1453849799,326
5698dc5a2fb0de2600f23319,95935,ORG3402 Organisasjonsatferd og ledelse,1453901584,2016-01-27 14:33:04,1453901701,117
5698dc5a2fb0de2600f23319,17916,ORG3402 Organisasjonsatferd og ledelse,1454065224,2016-01-29 12:00:24,1454065366,142
5698dc5a2fb0de2600f23319,93032,ORG3402 Organisasjonsatferd og ledelse,1454074407,2016-01-29 14:33:27,1454074407,0
5698dc5a2fb0de2600f23319,62221,ORG3402 Organisasjonsatferd og ledelse,1454927765,2016-02-08 11:36:05,1454927766,1
5698dc5a2fb0de2600f2331a,15068,ORG3402 Organisasjonsatferd og ledelse,1452884052,2016-01-15 19:54:12,1452884297,245
5698dc5a2fb0de2600f2331a,68745,ORG3402 Organisasjonsatferd og ledelse,1452907015,2016-01-16 02:16:55,1452907421,406
5698dc5a2fb0de2600f2331a,67522,ORG3402 Organisasjonsatferd og ledelse,1453136685,2016-01-18 18:04:45,1453137484,799
5698dc5a2fb0de2600f2331a,22488,ORG3402 Organisasjonsatferd og ledelse,1453140462,2016-01-18 19:07:42,1453140631,169
5698dc5a2fb0de2600f2331a,89796,ORG3402 Organisasjonsatferd og ledelse,1453143990,2016-01-18 20:06:30,1453145466,1476
5698dc5a2fb0de2600f2331a,17693,ORG3402 Organisasjonsatferd og ledelse,1453481180,2016-01-22 17:46:20,1453481415,235
5698dc5a2fb0de2600f2331a,24807,ORG3402 Organisasjonsatferd og ledelse,1453719521,2016-01-25 11:58:41,1453719577,56
5698dc5a2fb0de2600f2331a,84505,ORG3402 Organisasjonsatferd og ledelse,1454250547,2016-01-31 15:29:07,1454250752,205
5698dc5a2fb0de2600f2331a,73387,ORG3402 Organisasjonsatferd og ledelse,1454806583,2016-02-07 01:56:23,1454806599,16
5698dc5a2fb0de2600f2331b,55243,ORG3402 Organisasjonsatferd og ledelse,1454004785,2016-01-28 19:13:05,1454004893,108
5698dc5a2fb0de2600f2331b,18795,ORG3402 Organisasjonsatferd og ledelse,1455060145,2016-02-10 00:22:25,1455060145,0
5698dc5a2fb0de2600f2331b,97517,ORG3402 Organisasjonsatferd og ledelse,1455208744,2016-02-11 17:39:04,1455208744,0
5698dc5a2fb0de2600f2331e,80299,ORG3402 Organisasjonsatferd og ledelse,1453208945,2016-01-19 14:09:05,1453209023,78
5698dc5a2fb0de2600f2331e,85919,ORG3402 Organisasjonsatferd og ledelse,1453910674,2016-01-27 17:04:34,1453910803,129
5698dc5a2fb0de2600f2331e,96575,ORG3402 Organisasjonsatferd og ledelse,1455032599,2016-02-09 16:43:19,1455032599,0
5698dc5a41a9d72100241157,34387,ORG3402 Organisasjonsatferd og ledelse,1453137760,2016-01-18 18:22:40,1453138225,465
5698dc5a41a9d72100241157,98099,ORG3402 Organisasjonsatferd og ledelse,1453246717,2016-01-20 00:38:37,1453246717,0
5698dc5a41a9d72100241157,70666,ORG3402 Organisasjonsatferd og ledelse,1453333813,2016-01-21 00:50:13,1453333831,18
5698dc5a41a9d72100241157,61645,ORG3402 Organisasjonsatferd og ledelse,1453420629,2016-01-22 00:57:09,1453420630,1
5698dc5a41a9d72100241157,12046,ORG3402 Organisasjonsatferd og ledelse,1453674913,2016-01-24 23:35:13,1453674936,23
5698dc5a41a9d72100241157,54468,ORG3402 Organisasjonsatferd og ledelse,1453850672,2016-01-27 00:24:32,1453850672,0
5698dc5a41a9d72100241157,47113,ORG3402 Organisasjonsatferd og ledelse,1454315923,2016-02-01 09:38:43,1454315923,0
5698dc5a41a9d72100241157,48472,ORG3402 Organisasjonsatferd og ledelse,1454324217,2016-02-01 11:56:57,1454324228,11
5698dc5a41a9d72100241157,11492,ORG3402 Organisasjonsatferd og ledelse,1454328604,2016-02-01 13:10:04,1454328622,18
5698dc5a41a9d72100241157,34542,ORG3402 Organisasjonsatferd og ledelse,1454334941,2016-02-01 14:55:41,1454336745,1804
5698dc5a41a9d72100241157,49481,ORG3402 Organisasjonsatferd og ledelse,1454413638,2016-02-02 12:47:18,1454413901,263
5698dc5a41a9d72100241157,5223,ORG3402 Organisasjonsatferd og ledelse,1454421047,2016-02-02 14:50:47,1454423056,2009
5698dc5a41a9d72100241157,3841,ORG3402 Organisasjonsatferd og ledelse,1454486986,2016-02-03 09:09:46,1454486986,0
5698dc5a41a9d72100241157,30581,ORG3402 Organisasjonsatferd og ledelse,1454929067,2016-02-08 11:57:47,1454929096,29
5698dc5a41a9d72100241157,36831,ORG3402 Organisasjonsatferd og ledelse,1454932933,2016-02-08 13:02:13,1454932982,49
5698dc5a41a9d72100241157,63448,ORG3402 Organisasjonsatferd og ledelse,1454934428,2016-02-08 13:27:08,1454934428,0
5698dc5a41a9d72100241157,94452,ORG3402 Organisasjonsatferd og ledelse,1455060590,2016-02-10 00:29:50,1455060995,405
5698dc5a41a9d72100241157,65774,ORG3402 Organisasjonsatferd og ledelse,1455096353,2016-02-10 10:25:53,1455096555,202
5698dc5a41a9d72100241157,67369,ORG3402 Organisasjonsatferd og ledelse,1455100556,2016-02-10 11:35:56,1455101589,1033
5698dc5a41a9d72100241157,61560,ORG3402 Organisasjonsatferd og ledelse,1455103004,2016-02-10 12:16:44,1455103009,5
5698dc5a41a9d72100241157,36652,ORG3402 Organisasjonsatferd og ledelse,1455115305,2016-02-10 15:41:45,1455115422,117
5698dc5a41a9d72100241157,83268,ORG3402 Organisasjonsatferd og ledelse,1455118090,2016-02-10 16:28:10,1455118091,1
5698dc5a41a9d72100241157,36187,ORG3402 Organisasjonsatferd og ledelse,1455122207,2016-02-10 17:36:47,1455122208,1
5698dc5a41a9d72100241157,87117,ORG3402 Organisasjonsatferd og ledelse,1455184830,2016-02-11 11:00:30,1455184831,1
5698dc5a41a9d72100241157,39967,ORG3402 Organisasjonsatferd og ledelse,1455285107,2016-02-12 14:51:47,1455285118,11
5698dc5a41a9d72100241158,36737,ORG3402 Organisasjonsatferd og ledelse,1452868469,2016-01-15 15:34:29,1452868526,57
5698dc5a41a9d72100241158,76629,ORG3402 Organisasjonsatferd og ledelse,1452869788,2016-01-15 15:56:28,1452869788,0
5698dc5a41a9d72100241159,75089,ORG3402 Organisasjonsatferd og ledelse,1453800330,2016-01-26 10:25:30,1453800440,110
5698dc5a41a9d72100241159,52654,ORG3402 Organisasjonsatferd og ledelse,1453892708,2016-01-27 12:05:08,1453893306,598
5698dc5a41a9d72100241159,60659,ORG3402 Organisasjonsatferd og ledelse,1454065703,2016-01-29 12:08:23,1454065718,15
5698dc5a41a9d72100241159,50434,ORG3402 Organisasjonsatferd og ledelse,1454496871,2016-02-03 11:54:31,1454497305,434
5698dc5a41a9d72100241159,96118,ORG3402 Organisasjonsatferd og ledelse,1455104003,2016-02-10 12:33:23,1455104003,0
5698dc5a41a9d72100241159,33688,ORG3402 Organisasjonsatferd og ledelse,1455106194,2016-02-10 13:09:54,1455106205,11
5698dc5a41a9d72100241159,19405,ORG3402 Organisasjonsatferd og ledelse,1455112818,2016-02-10 15:00:18,1455113425,607
5698dc5a41a9d7210024115b,80158,ORG3402 Organisasjonsatferd og ledelse,1454325136,2016-02-01 12:12:16,1454325189,53
5698dc5a41a9d7210024115b,41371,ORG3402 Organisasjonsatferd og ledelse,1455187971,2016-02-11 11:52:51,1455188113,142
5698dc5a41a9d7210024116c,74920,ORG3402 Organisasjonsatferd og ledelse,1452867969,2016-01-15 15:26:09,1452867976,7
5698dc5a41a9d7210024116c,24103,ORG3402 Organisasjonsatferd og ledelse,1453066496,2016-01-17 22:34:56,1453066497,1
5698dc5a41a9d7210024116c,31610,ORG3402 Organisasjonsatferd og ledelse,1453915343,2016-01-27 18:22:23,1453915653,310
5698dc5a41a9d7210024116c,23103,ORG3402 Organisasjonsatferd og ledelse,1454510913,2016-02-03 15:48:33,1454511614,701
5698dc5a41a9d7210024116c,22500,ORG3402 Organisasjonsatferd og ledelse,1454572470,2016-02-04 08:54:30,1454572470,0
5698dc5b2fb0de2600f23335,19726,ORG3402 Organisasjonsatferd og ledelse,1453641457,2016-01-24 14:17:37,1453641619,162
5698dc5b2fb0de2600f23335,98501,ORG3402 Organisasjonsatferd og ledelse,1454532907,2016-02-03 21:55:07,1454533044,137
5698dc5b2fb0de2600f23335,1646,ORG3402 Organisasjonsatferd og ledelse,1455107547,2016-02-10 13:32:27,1455107548,1
5698dc5b41a9d72100241179,76724,ORG3402 Organisasjonsatferd og ledelse,1453288832,2016-01-20 12:20:32,1453288881,49
5698dc5b41a9d72100241179,48058,ORG3402 Organisasjonsatferd og ledelse,1453720599,2016-01-25 12:16:39,1453720719,120
5698dc5b41a9d72100241179,97179,ORG3402 Organisasjonsatferd og ledelse,1454333110,2016-02-01 14:25:10,1454333152,42
5698dc5b41a9d72100241179,19533,ORG3402 Organisasjonsatferd og ledelse,1454362184,2016-02-01 22:29:44,1454362204,20
5698dc5b41a9d72100241179,68315,ORG3402 Organisasjonsatferd og ledelse,1454495640,2016-02-03 11:34:00,1454495681,41
5698dc5b41a9d72100241179,85143,ORG3402 Organisasjonsatferd og ledelse,1455094108,2016-02-10 09:48:28,1455094848,740
5698dc5b41a9d72100241179,55131,ORG3402 Organisasjonsatferd og ledelse,1455096495,2016-02-10 10:28:15,1455096503,8
5698dc5c2fb0de2600f23338,12354,ORG3402 Organisasjonsatferd og ledelse,1452872993,2016-01-15 16:49:53,1452873305,312
5698dc5c2fb0de2600f23338,20729,ORG3402 Organisasjonsatferd og ledelse,1453153886,2016-01-18 22:51:26,1453154019,133
5698dc5c2fb0de2600f23338,80541,ORG3402 Organisasjonsatferd og ledelse,1453206812,2016-01-19 13:33:32,1453207238,426
5698dc5c2fb0de2600f23338,62519,ORG3402 Organisasjonsatferd og ledelse,1453883506,2016-01-27 09:31:46,1453883574,68
5698dc5c2fb0de2600f23338,81581,ORG3402 Organisasjonsatferd og ledelse,1453922906,2016-01-27 20:28:26,1453922940,34
5698dc5c2fb0de2600f23338,77748,ORG3402 Organisasjonsatferd og ledelse,1454333738,2016-02-01 14:35:38,1454334154,416
5698dc5c2fb0de2600f23338,62285,ORG3402 Organisasjonsatferd og ledelse,1454335444,2016-02-01 15:04:04,1454335455,11
5698dc5c2fb0de2600f23339,32270,ORG3402 Organisasjonsatferd og ledelse,1453835237,2016-01-26 20:07:17,1453835297,60
5698dc5c2fb0de2600f23339,10379,ORG3402 Organisasjonsatferd og ledelse,1454541684,2016-02-04 00:21:24,1454543437,1753
5698dc5d2fb0de2600f2333d,74426,ORG3402 Organisasjonsatferd og ledelse,1454951468,2016-02-08 18:11:08,1454951613,145
5698dc5d2fb0de2600f2333d,75932,ORG3402 Organisasjonsatferd og ledelse,1455061725,2016-02-10 00:48:45,1455061725,0
5698dc5d2fb0de2600f23341,69307,ORG3402 Organisasjonsatferd og ledelse,1455114208,2016-02-10 15:23:28,1455115982,1774
5698dc5d2fb0de2600f23342,66208,ORG3402 Organisasjonsatferd og ledelse,1453097111,2016-01-18 07:05:11,1453097195,84
5698dc5d2fb0de2600f23342,84109,ORG3402 Organisasjonsatferd og ledelse,1453432365,2016-01-22 04:12:45,1453432402,37
5698dc5d2fb0de2600f23342,12240,ORG3402 Organisasjonsatferd og ledelse,1454021619,2016-01-28 23:53:39,1454021619,0
5698dc5d2fb0de2600f23342,77959,ORG3402 Organisasjonsatferd og ledelse,1454432641,2016-02-02 18:04:01,1454432747,106
5698dc5d2fb0de2600f23342,58807,ORG3402 Organisasjonsatferd og ledelse,1455060695,2016-02-10 00:31:35,1455060703,8
5698dc5d2fb0de2600f23342,71862,ORG3402 Organisasjonsatferd og ledelse,1455203932,2016-02-11 16:18:52,1455203937,5
5698dc5d2fb0de2600f23344,63523,ORG3402 Organisasjonsatferd og ledelse,1453999472,2016-01-28 17:44:32,1454001463,1991
5698dc5d2fb0de2600f23344,31212,ORG3402 Organisasjonsatferd og ledelse,1454324931,2016-02-01 12:08:51,1454325375,444
5698dc5d41a9d7210024117b,37517,ORG3402 Organisasjonsatferd og ledelse,1452864359,2016-01-15 14:25:59,1452864404,45
5698dc5d41a9d7210024117b,87131,ORG3402 Organisasjonsatferd og ledelse,1453074915,2016-01-18 00:55:15,1453074917,2
5698dc5d41a9d7210024117b,32525,ORG3402 Organisasjonsatferd og ledelse,1453238167,2016-01-19 22:16:07,1453238170,3
5698dc5d41a9d7210024117b,76787,ORG3402 Organisasjonsatferd og ledelse,1453375472,2016-01-21 12:24:32,1453375475,3
5698dc5d41a9d7210024117c,56711,ORG3402 Organisasjonsatferd og ledelse,1453384072,2016-01-21 14:47:52,1453384683,611
5698dc5d41a9d7210024117c,59248,ORG3402 Organisasjonsatferd og ledelse,1455214006,2016-02-11 19:06:46,1455214121,115
5698dc5d41a9d7210024117f,32063,ORG3402 Organisasjonsatferd og ledelse,1453218164,2016-01-19 16:42:44,1453219101,937
5698dc5d41a9d7210024117f,34415,ORG3402 Organisasjonsatferd og ledelse,1453662980,2016-01-24 20:16:20,1453663020,40
5698dc5d41a9d7210024117f,23880,ORG3402 Organisasjonsatferd og ledelse,1455204624,2016-02-11 16:30:24,1455204625,1
5698dc5d41a9d72100241180,9662,ORG3402 Organisasjonsatferd og ledelse,1453026334,2016-01-17 11:25:34,1453026376,42
5698dc5d41a9d72100241180,53088,ORG3402 Organisasjonsatferd og ledelse,1453067892,2016-01-17 22:58:12,1453067904,12
5698dc5d41a9d72100241180,90029,ORG3402 Organisasjonsatferd og ledelse,1453377641,2016-01-21 13:00:41,1453379287,1646
5698dc5d41a9d72100241180,86361,ORG3402 Organisasjonsatferd og ledelse,1454003106,2016-01-28 18:45:06,1454003326,220
5698dc5e2fb0de2600f2335d,99973,ORG3402 Organisasjonsatferd og ledelse,1452885192,2016-01-15 20:13:12,1452885292,100
5698dc5e2fb0de2600f2335d,35239,ORG3402 Organisasjonsatferd og ledelse,1453131162,2016-01-18 16:32:42,1453131486,324
5698dc5e2fb0de2600f2335d,97050,ORG3402 Organisasjonsatferd og ledelse,1453207744,2016-01-19 13:49:04,1453207744,0
5698dc5e2fb0de2600f2335d,70090,ORG3402 Organisasjonsatferd og ledelse,1453209223,2016-01-19 14:13:43,1453209674,451
5698dc5e2fb0de2600f2335d,43755,ORG3402 Organisasjonsatferd og ledelse,1453212355,2016-01-19 15:05:55,1453212367,12
5698dc5e2fb0de2600f2335d,54196,ORG3402 Organisasjonsatferd og ledelse,1454939500,2016-02-08 14:51:40,1454939949,449
5698dc5e2fb0de2600f2335d,8143,ORG3402 Organisasjonsatferd og ledelse,1455284313,2016-02-12 14:38:33,1455284371,58
5698dc5e41a9d72100241182,88477,ORG3402 Organisasjonsatferd og ledelse,1453321526,2016-01-20 21:25:26,1453321570,44
5698dc5e41a9d72100241182,51123,ORG3402 Organisasjonsatferd og ledelse,1453739947,2016-01-25 17:39:07,1453739951,4
5698dc5e41a9d72100241182,85661,ORG3402 Organisasjonsatferd og ledelse,1454508326,2016-02-03 15:05:26,1454508398,72
5698dc5e41a9d72100241182,46705,ORG3402 Organisasjonsatferd og ledelse,1454514134,2016-02-03 16:42:14,1454514164,30
5698dc5e41a9d72100241182,46926,ORG3402 Organisasjonsatferd og ledelse,1454763109,2016-02-06 13:51:49,1454763109,0
5698dc5e41a9d72100241182,15208,ORG3402 Organisasjonsatferd og ledelse,1454765173,2016-02-06 14:26:13,1454765844,671
5698dc5e41a9d72100241182,54870,ORG3402 Organisasjonsatferd og ledelse,1455159559,2016-02-11 03:59:19,1455159559,0
5698dc5e41a9d72100241185,68331,ORG3402 Organisasjonsatferd og ledelse,1452862243,2016-01-15 13:50:43,1452862264,21
5698dc5e41a9d72100241185,74829,ORG3402 Organisasjonsatferd og ledelse,1453657130,2016-01-24 18:38:50,1453657425,295
5698dc5e41a9d72100241185,42952,ORG3402 Organisasjonsatferd og ledelse,1454065839,2016-01-29 12:10:39,1454065924,85
5698dc5e41a9d72100241185,82753,ORG3402 Organisasjonsatferd og ledelse,1454497073,2016-02-03 11:57:53,1454498183,1110
5698dc5e41a9d72100241185,15842,ORG3402 Organisasjonsatferd og ledelse,1454860572,2016-02-07 16:56:12,1454860578,6
5698dc5e41a9d72100241185,48597,ORG3402 Organisasjonsatferd og ledelse,1455104426,2016-02-10 12:40:26,1455104628,202
5698dc5e41a9d72100241185,4083,ORG3402 Organisasjonsatferd og ledelse,1455106068,2016-02-10 13:07:48,1455106090,22
5698dc5e41a9d721002411a1,22234,ORG3402 Organisasjonsatferd og ledelse,1455455082,2016-02-14 14:04:42,1455455174,92
5698dc5f2fb0de2600f23360,76587,ORG3402 Organisasjonsatferd og ledelse,1453188936,2016-01-19 08:35:36,1453189764,828
5698dc5f2fb0de2600f23360,19445,ORG3402 Organisasjonsatferd og ledelse,1453191443,2016-01-19 09:17:23,1453191443,0
5698dc5f2fb0de2600f23360,7469,ORG3402 Organisasjonsatferd og ledelse,1453742158,2016-01-25 18:15:58,1453742216,58
5698dc5f2fb0de2600f23360,12160,ORG3402 Organisasjonsatferd og ledelse,1453825762,2016-01-26 17:29:22,1453825830,68
5698dc5f41a9d721002411a4,89606,ORG3402 Organisasjonsatferd og ledelse,1455295681,2016-02-12 17:48:01,1455295786,105
5698dc5f41a9d721002411a4,61683,ORG3402 Organisasjonsatferd og ledelse,1455298444,2016-02-12 18:34:04,1455298482,38
569ca43ee62ae22300d1ca40,59601,ORG3402 Organisasjonsatferd og ledelse,1453202360,2016-01-19 12:19:20,1453202795,435
569ca43ee62ae22300d1ca40,87620,ORG3402 Organisasjonsatferd og ledelse,1453208179,2016-01-19 13:56:19,1453208224,45
569ca43ee62ae22300d1ca40,8149,ORG3402 Organisasjonsatferd og ledelse,1453285213,2016-01-20 11:20:13,1453286348,1135
569ca43ee62ae22300d1ca40,13900,ORG3402 Organisasjonsatferd og ledelse,1453323467,2016-01-20 21:57:47,1453323468,1
569ca43ee62ae22300d1ca40,91632,ORG3402 Organisasjonsatferd og ledelse,1453717083,2016-01-25 11:18:03,1453717127,44
569ca43ee62ae22300d1ca40,14852,ORG3402 Organisasjonsatferd og ledelse,1453718979,2016-01-25 11:49:39,1453718979,0
569ca43ee62ae22300d1ca40,57365,ORG3402 Organisasjonsatferd og ledelse,1454073858,2016-01-29 14:24:18,1454074283,425
569ca43ee62ae22300d1ca40,48088,ORG3402 Organisasjonsatferd og ledelse,1454256512,2016-01-31 17:08:32,1454256562,50
569ca43ee62ae22300d1ca40,41970,ORG3402 Organisasjonsatferd og ledelse,1454415949,2016-02-02 13:25:49,1454416902,953
569ca43ee62ae22300d1ca40,25664,ORG3402 Organisasjonsatferd og ledelse,1454490092,2016-02-03 10:01:32,1454490092,0
569ca43ee62ae22300d1ca40,76746,ORG3402 Organisasjonsatferd og ledelse,1455029071,2016-02-09 15:44:31,1455029071,0
569ca43ee62ae22300d1ca40,75491,ORG3402 Organisasjonsatferd og ledelse,1455100343,2016-02-10 11:32:23,1455100358,15
569ca43ee62ae22300d1ca40,23817,ORG3402 Organisasjonsatferd og ledelse,1455242500,2016-02-12 03:01:40,1455242500,0
569ca43ee62ae22300d1ca40,76681,ORG3402 Organisasjonsatferd og ledelse,1455279910,2016-02-12 13:25:10,1455279910,0
569f7ef4c9741c2500080e46,96482,ORG3402 Organisasjonsatferd og ledelse,1453729240,2016-01-25 14:40:40,1453729467,227
569f7ef4c9741c2500080e46,57542,ORG3402 Organisasjonsatferd og ledelse,1453797175,2016-01-26 09:32:55,1453797175,0
569f7ef4c9741c2500080e46,93634,ORG3402 Organisasjonsatferd og ledelse,1454332475,2016-02-01 14:14:35,1454332636,161
569f7ef4c9741c2500080e46,58245,ORG3402 Organisasjonsatferd og ledelse,1454929518,2016-02-08 12:05:18,1454929518,0
569f7ef4c9741c2500080e46,39311,ORG3402 Organisasjonsatferd og ledelse,1454931721,2016-02-08 12:42:01,1454931721,0
569f7f4835827027001cb85c,51026,ORG3402 Organisasjonsatferd og ledelse,1454325250,2016-02-01 12:14:10,1454326140,890
569f7f4835827027001cb85c,50103,ORG3402 Organisasjonsatferd og ledelse,1454333056,2016-02-01 14:24:16,1454333082,26
569f7f4835827027001cb85c,75068,ORG3402 Organisasjonsatferd og ledelse,1454881851,2016-02-07 22:50:51,1454881851,0
569f7f4835827027001cb85c,6148,ORG3402 Organisasjonsatferd og ledelse,1454929649,2016-02-08 12:07:29,1454929650,1
569f7f4835827027001cb85c,81358,ORG3402 Organisasjonsatferd og ledelse,1454931029,2016-02-08 12:30:29,1454931044,15
569f7f4835827027001cb85c,5724,ORG3402 Organisasjonsatferd og ledelse,1454933018,2016-02-08 13:03:38,1454933019,1
569f7f4835827027001cb85c,16935,ORG3402 Organisasjonsatferd og ledelse,1454937332,2016-02-08 14:15:32,1454938411,1079
569f7f4835827027001cb85c,83948,ORG3402 Organisasjonsatferd og ledelse,1455222205,2016-02-11 21:23:25,1455223427,1222
569f7f604d946d2400ad1da5,34093,ORG3402 Organisasjonsatferd og ledelse,1453667865,2016-01-24 21:37:45,1453668045,180
569f7f604d946d2400ad1da5,78629,ORG3402 Organisasjonsatferd og ledelse,1453723315,2016-01-25 13:01:55,1453723317,2
569f7f604d946d2400ad1da5,21003,ORG3402 Organisasjonsatferd og ledelse,1454325818,2016-02-01 12:23:38,1454325959,141
569f7f604d946d2400ad1da5,28081,ORG3402 Organisasjonsatferd og ledelse,1454332381,2016-02-01 14:13:01,1454332527,146
569f7f604d946d2400ad1da5,89148,ORG3402 Organisasjonsatferd og ledelse,1454497720,2016-02-03 12:08:40,1454497720,0
569f7f604d946d2400ad1da5,46773,ORG3402 Organisasjonsatferd og ledelse,1454930192,2016-02-08 12:16:32,1454931037,845
569f7f604d946d2400ad1da5,68297,ORG3402 Organisasjonsatferd og ledelse,1454938542,2016-02-08 14:35:42,1454938547,5
569f7f604d946d2400ad1da5,40189,ORG3402 Organisasjonsatferd og ledelse,1455053514,2016-02-09 22:31:54,1455053525,11
569f7f8635827027001cb860,55540,ORG3402 Organisasjonsatferd og ledelse,1453305282,2016-01-20 16:54:42,1453305282,0
569f7f8635827027001cb860,64963,ORG3402 Organisasjonsatferd og ledelse,1453392842,2016-01-21 17:14:02,1453392919,77
569f7f8635827027001cb860,24873,ORG3402 Organisasjonsatferd og ledelse,1453713535,2016-01-25 10:18:55,1453713561,26
569f7f8635827027001cb860,74986,ORG3402 Organisasjonsatferd og ledelse,1453806592,2016-01-26 12:09:52,1453807751,1159
569f7f8635827027001cb860,99675,ORG3402 Organisasjonsatferd og ledelse,1454931684,2016-02-08 12:41:24,1454931774,90
56a6b0275d52c7250022aa27,77750,MRK3480 Forbrukeratferd,1453816254,2016-01-26 14:50:54,1453816319,65
56a6b0275d52c7250022aa27,84245,MRK3480 Forbrukeratferd,1453842959,2016-01-26 22:15:59,1453843007,48
56a6b0275d52c7250022aa27,30933,MRK3480 Forbrukeratferd,1453932133,2016-01-27 23:02:13,1453932227,94
56a6b0275d52c7250022aa27,91126,MRK3480 Forbrukeratferd,1453989561,2016-01-28 14:59:21,1453989943,382
56a6b0275d52c7250022aa27,356,MRK3480 Forbrukeratferd,1454493409,2016-02-03 10:56:49,1454493409,0
56a6b0275d52c7250022aa27,38548,MRK3480 Forbrukeratferd,1454588417,2016-02-04 13:20:17,1454588417,0
56a6b0275d52c7250022aa27,81863,MRK3480 Forbrukeratferd,1454593376,2016-02-04 14:42:56,1454593376,0
56a6b0275d52c7250022aa27,32966,MRK3480 Forbrukeratferd,1454668901,2016-02-05 11:41:41,1454668918,17
56a6b0275d52c7250022aa27,3009,MRK3480 Forbrukeratferd,1454674501,2016-02-05 13:15:01,1454674502,1
56a6b0275d52c7250022aa27,68274,MRK3480 Forbrukeratferd,1454683138,2016-02-05 15:38:58,1454683139,1
56a6b0275d52c7250022aa27,9301,MRK3480 Forbrukeratferd,1454935958,2016-02-08 13:52:38,1454935959,1
56a6b09c37f619210097cc6a,47709,MRK3480 Forbrukeratferd,1453849878,2016-01-27 00:11:18,1453850196,318
56a6b09c37f619210097cc6a,30009,MRK3480 Forbrukeratferd,1455186408,2016-02-11 11:26:48,1455186536,128
56a8d93229028e260091301a,51064,ORG3402 Organisasjonsatferd og ledelse,1453985787,2016-01-28 13:56:27,1453985849,62
56a8d93229028e260091301a,37780,ORG3402 Organisasjonsatferd og ledelse,1453988745,2016-01-28 14:45:45,1453988746,1
56a8d93229028e260091301a,66893,ORG3402 Organisasjonsatferd og ledelse,1454406151,2016-02-02 10:42:31,1454406193,42
56a8ed7d29028e2600913141,58039,MRK3480 Forbrukeratferd,1453916201,2016-01-27 18:36:41,1453916433,232
56a8ed7d29028e2600913141,4101,MRK3480 Forbrukeratferd,1454413481,2016-02-02 12:44:41,1454413513,32
56a8ed7d29028e2600913141,37394,MRK3480 Forbrukeratferd,1454594480,2016-02-04 15:01:20,1454594480,0
56ab659e29028e2600913d57,72575,ORG3402 Organisasjonsatferd og ledelse,1454365578,2016-02-01 23:26:18,1454365656,78
56ab6d41a55f242200a2d713,10044,ORG3402 Organisasjonsatferd og ledelse,1454080055,2016-01-29 16:07:35,1454080056,1
56ab6d41a55f242200a2d713,22745,ORG3402 Organisasjonsatferd og ledelse,1454368089,2016-02-02 00:08:09,1454368227,138
56ab96eb29028e2600913e42,9855,ORG3402 Organisasjonsatferd og ledelse,1454369666,2016-02-02 00:34:26,1454370261,595
56af69874377f52300234db8,13826,ORG3402 Organisasjonsatferd og ledelse,1454340230,2016-02-01 16:23:50,1454340785,555
56af69874377f52300234db8,67401,ORG3402 Organisasjonsatferd og ledelse,1454666853,2016-02-05 11:07:33,1454666909,56
56af69874377f52300234db8,8821,ORG3402 Organisasjonsatferd og ledelse,1455274141,2016-02-12 11:49:01,1455274226,85
56b061be29028e260091487e,75844,ORG3402 Organisasjonsatferd og ledelse,1455175801,2016-02-11 08:30:01,1455176214,413
56b0c11fa55f242200a2e6f3,52212,ORG3402 Organisasjonsatferd og ledelse,1454872282,2016-02-07 20:11:22,1454872282,0
56b0c1f4a55f242200a2e702,44211,ORG3402 Organisasjonsatferd og ledelse,1454431684,2016-02-02 17:48:04,1454431685,1
56b0c1f4a55f242200a2e702,10093,ORG3402 Organisasjonsatferd og ledelse,1454929823,2016-02-08 12:10:23,1454930086,263
56b0c1f4a55f242200a2e702,4180,ORG3402 Organisasjonsatferd og ledelse,1454931891,2016-02-08 12:44:51,1454931892,1
56b0c1f4a55f242200a2e702,60553,ORG3402 Organisasjonsatferd og ledelse,1455137123,2016-02-10 21:45:23,1455137123,0
56b0c1f4a55f242200a2e702,11166,ORG3402 Organisasjonsatferd og ledelse,1455139030,2016-02-10 22:17:10,1455139030,0
56b0c1f4a55f242200a2e702,47716,ORG3402 Organisasjonsatferd og ledelse,1455205848,2016-02-11 16:50:48,1455205848,0
56b31a1bd4d43f260091a6c9,90263,MRK3480 Forbrukeratferd,1454939950,2016-02-08 14:59:10,1454939950,0
56b893de457365210022d06b,4058,ORG3402 Organisasjonsatferd og ledelse,1454942703,2016-02-08 15:45:03,1454942703,0
56b895097d442d26004a7a34,96187,ORG3402 Organisasjonsatferd og ledelse,1454951053,2016-02-08 18:04:13,1454951053,0
56b895097d442d26004a7a34,44906,ORG3402 Organisasjonsatferd og ledelse,1455022577,2016-02-09 13:56:17,1455022696,119
56b895097d442d26004a7a34,39132,ORG3402 Organisasjonsatferd og ledelse,1455125586,2016-02-10 18:33:06,1455125658,72
56b8b74f457365210022d1ff,78892,ORG3402 Organisasjonsatferd og ledelse,1455027629,2016-02-09 15:20:29,1455027651,22
56b9f76bb1682626003620b9,90919,ORG3402 Organisasjonsatferd og ledelse,1455044515,2016-02-09 20:01:55,1455044582,67
56b9f76bb1682626003620b9,17501,ORG3402 Organisasjonsatferd og ledelse,1455091989,2016-02-10 09:13:09,1455092063,74
56b9f76bb1682626003620b9,40650,ORG3402 Organisasjonsatferd og ledelse,1455104364,2016-02-10 12:39:24,1455104364,0
56b9f76bb1682626003620b9,6934,ORG3402 Organisasjonsatferd og ledelse,1455105770,2016-02-10 13:02:50,1455105881,111
56b9f76bb1682626003620b9,42022,ORG3402 Organisasjonsatferd og ledelse,1455474597,2016-02-14 19:29:57,1455475065,468
56b9f7fcb1682626003620bf,88358,ORG3402 Organisasjonsatferd og ledelse,1455036957,2016-02-09 17:55:57,1455036957,0
56ba51c4ca1c45220067890f,19312,ORG3402 Organisasjonsatferd og ledelse,1455095942,2016-02-10 10:19:02,1455096688,746
56ba51c4ca1c45220067890f,97028,ORG3402 Organisasjonsatferd og ledelse,1455102099,2016-02-10 12:01:39,1455102099,0
56ba51c4ca1c45220067890f,982,ORG3402 Organisasjonsatferd og ledelse,1455105680,2016-02-10 13:01:20,1455106363,683
56ba51c4ca1c45220067890f,16757,ORG3402 Organisasjonsatferd og ledelse,1455114027,2016-02-10 15:20:27,1455114027,0
56ba51c4ca1c45220067890f,88454,ORG3402 Organisasjonsatferd og ledelse,1455115376,2016-02-10 15:42:56,1455115377,1
56ba51c4ca1c45220067890f,82512,ORG3402 Organisasjonsatferd og ledelse,1455218354,2016-02-11 20:19:14,1455218405,51
56ba51c4ca1c45220067890f,80503,ORG3402 Organisasjonsatferd og ledelse,1455297706,2016-02-12 18:21:46,1455298571,865
56bc4c2bca1c45220067964e,1770,ORG3402 Organisasjonsatferd og ledelse,1455198354,2016-02-11 14:45:54,1455198491,137
56bc6166ca1c4522006796ed,43346,ORG3402 Organisasjonsatferd og ledelse,1455190666,2016-02-11 12:37:46,1455190716,50
